,cf_score_0,cf_score_1,geoid,midpoint,num_votes_0,num_votes_1,tot_votes
0,-0.645953270361,0.929241202634,001-AAA,0.141643966136,87,369,456
1,-0.645953270361,0.929241202634,001-AAB,0.141643966136,26,116,142
2,-0.645953270361,0.929241202634,001-AAC,0.141643966136,62,158,220
3,-0.645953270361,0.929241202634,001-AAD,0.141643966136,107,301,408
4,-0.645953270361,0.929241202634,001-AAE,0.141643966136,55,99,154
5,-0.645953270361,0.929241202634,001-AAF,0.141643966136,26,7,33
6,-0.645953270361,0.929241202634,001-AAG,0.141643966136,34,73,107
7,-0.645953270361,0.929241202634,001-AAH,0.141643966136,35,107,142
8,-0.645953270361,0.929241202634,001-AAI,0.141643966136,83,277,360
9,-0.645953270361,0.929241202634,001-AAJ,0.141643966136,8,7,15
10,-0.645953270361,0.929241202634,001-AAK,0.141643966136,52,63,115
11,-0.645953270361,0.929241202634,001-AAL,0.141643966136,54,91,145
12,-0.645953270361,0.929241202634,001-AAM,0.141643966136,51,118,169
13,-0.645953270361,0.929241202634,001-AAN,0.141643966136,100,398,498
14,-0.645953270361,0.929241202634,001-AAO,0.141643966136,37,123,160
15,-0.645953270361,0.929241202634,001-AAP,0.141643966136,57,183,240
16,-0.645953270361,0.929241202634,001-AAQ,0.141643966136,57,139,196
17,-0.645953270361,0.929241202634,001-AAR,0.141643966136,73,137,210
18,-0.645953270361,0.929241202634,001-AAS,0.141643966136,67,224,291
19,-0.645953270361,0.929241202634,001-AAT,0.141643966136,25,113,138
20,-0.645953270361,0.929241202634,001-AAU,0.141643966136,56,223,279
21,-0.645953270361,0.929241202634,001-AAV,0.141643966136,33,205,238
22,-0.645953270361,0.929241202634,001-AAW,0.141643966136,76,251,327
23,-0.645953270361,0.929241202634,001-AAX,0.141643966136,42,143,185
24,-0.645953270361,0.929241202634,001-AAY,0.141643966136,103,294,397
25,-0.645953270361,0.929241202634,001-AAZ,0.141643966136,99,287,386
26,-0.645953270361,0.929241202634,001-ABA,0.141643966136,68,175,243
27,-0.645953270361,0.929241202634,001-ABB,0.141643966136,52,99,151
28,-0.645953270361,0.929241202634,001-ABC,0.141643966136,71,126,197
29,-0.645953270361,0.929241202634,001-ABD,0.141643966136,46,130,176
30,-0.645953270361,0.929241202634,001-ABE,0.141643966136,10,24,34
31,-0.645953270361,0.929241202634,001-ABF,0.141643966136,69,288,357
32,-0.645953270361,0.929241202634,001-ABG,0.141643966136,80,329,409
33,-0.645953270361,0.929241202634,001-ABH,0.141643966136,47,240,287
34,-0.645953270361,0.929241202634,001-ABI,0.141643966136,55,199,254
35,-0.645953270361,0.929241202634,002-AAA,0.141643966136,152,303,455
36,-0.645953270361,0.929241202634,002-AAC,0.141643966136,92,331,423
37,-0.645953270361,0.929241202634,002-AAE,0.141643966136,91,261,352
38,-0.645953270361,0.929241202634,002-AAG,0.141643966136,38,131,169
39,-0.645953270361,0.929241202634,002-AAH,0.141643966136,128,121,249
40,-0.645953270361,0.929241202634,002-AAJ,0.141643966136,43,78,121
41,-0.645953270361,0.929241202634,002-AAK,0.141643966136,57,108,165
42,-0.645953270361,0.929241202634,002-AAL,0.141643966136,93,122,215
43,-0.645953270361,0.929241202634,002-AAN,0.141643966136,60,87,147
44,-0.645953270361,0.929241202634,002-AAO,0.141643966136,35,80,115
45,-0.645953270361,0.929241202634,002-AAP,0.141643966136,72,108,180
46,-0.645953270361,0.929241202634,002-AAQ,0.141643966136,82,71,153
47,-0.645953270361,0.929241202634,002-AAR,0.141643966136,46,91,137
48,-0.645953270361,0.929241202634,002-AAS,0.141643966136,77,97,174
49,-0.645953270361,0.929241202634,002-AAT,0.141643966136,86,171,257
50,-0.645953270361,0.929241202634,002-AAV,0.141643966136,77,154,231
51,-0.645953270361,0.929241202634,002-AAW,0.141643966136,144,128,272
52,-0.645953270361,0.929241202634,002-AAX,0.141643966136,124,168,292
53,-0.645953270361,0.929241202634,002-AAY,0.141643966136,62,40,102
54,-0.645953270361,0.929241202634,002-ABE,0.141643966136,111,263,374
55,-0.645953270361,0.929241202634,002-ABF,0.141643966136,98,142,240
56,-0.645953270361,0.929241202634,002-ABH,0.141643966136,58,112,170
57,-0.645953270361,0.929241202634,002-ABI,0.141643966136,53,97,150
58,-0.645953270361,0.929241202634,002-ABJ,0.141643966136,58,88,146
59,-0.645953270361,0.929241202634,002-ABK,0.141643966136,111,66,177
60,-0.645953270361,0.929241202634,002-ABM,0.141643966136,108,142,250
61,-0.645953270361,0.929241202634,002-ABP,0.141643966136,133,21,154
62,-0.645953270361,0.929241202634,002-ABQ,0.141643966136,106,10,116
63,-0.645953270361,0.929241202634,002-ABR,0.141643966136,108,80,188
64,-0.645953270361,0.929241202634,002-ABT,0.141643966136,116,68,184
65,-0.645953270361,0.929241202634,002-ABW,0.141643966136,100,2,102
66,-0.645953270361,0.929241202634,002-ABX,0.141643966136,119,6,125
67,-0.645953270361,0.929241202634,002-ABZ,0.141643966136,113,9,122
68,-0.645953270361,0.929241202634,002-ACA,0.141643966136,51,42,93
69,-0.645953270361,0.929241202634,002-ACB,0.141643966136,59,34,93
70,-0.645953270361,0.929241202634,002-ACC,0.141643966136,94,53,147
71,-0.645953270361,0.929241202634,002-ACD,0.141643966136,134,184,318
72,-0.645953270361,0.929241202634,002-ACE,0.141643966136,116,246,362
73,-0.645953270361,0.929241202634,002-ACG,0.141643966136,52,91,143
74,-0.645953270361,0.929241202634,002-ACH,0.141643966136,112,112,224
75,-0.645953270361,0.929241202634,002-ACI,0.141643966136,79,131,210
76,-0.645953270361,0.929241202634,002-ACK,0.141643966136,58,101,159
77,-0.645953270361,0.929241202634,002-ACM,0.141643966136,130,52,182
78,-0.645953270361,0.929241202634,002-ACN,0.141643966136,130,124,254
79,-0.645953270361,0.929241202634,002-ACO,0.141643966136,193,173,366
80,-0.645953270361,0.929241202634,002-ACT,0.141643966136,105,435,540
81,-0.645953270361,0.929241202634,002-ACU,0.141643966136,51,261,312
82,-0.645953270361,0.929241202634,002-ACW,0.141643966136,73,168,241
83,-0.645953270361,0.929241202634,002-ACY,0.141643966136,50,117,167
84,-0.645953270361,0.929241202634,002-ACZ,0.141643966136,25,79,104
85,-0.645953270361,0.929241202634,002-ADA,0.141643966136,43,215,258
86,-0.645953270361,0.929241202634,002-ADB,0.141643966136,93,169,262
87,-0.645953270361,0.929241202634,002-ADC,0.141643966136,50,91,141
88,-0.645953270361,0.929241202634,002-ADD,0.141643966136,93,219,312
89,-0.645953270361,0.929241202634,002-ADE,0.141643966136,113,262,375
90,-0.645953270361,0.929241202634,002-ADF,0.141643966136,62,118,180
91,-0.645953270361,0.929241202634,002-ADG,0.141643966136,117,535,652
92,-0.645953270361,0.929241202634,002-ADI,0.141643966136,106,411,517
93,-0.645953270361,0.929241202634,002-ADJ,0.141643966136,60,276,336
94,-0.645953270361,0.929241202634,002-ADK,0.141643966136,75,87,162
95,-0.645953270361,0.929241202634,002-ADL,0.141643966136,49,194,243
96,-0.645953270361,0.929241202634,002-ADO,0.141643966136,46,181,227
97,-0.645953270361,0.929241202634,002-ADP,0.141643966136,92,167,259
98,-0.645953270361,0.929241202634,002-ADQ,0.141643966136,87,287,374
99,-0.645953270361,0.929241202634,002-ADR,0.141643966136,104,306,410
100,-0.645953270361,0.929241202634,002-ADT,0.141643966136,74,275,349
101,-0.645953270361,0.929241202634,002-ADU,0.141643966136,18,93,111
102,-0.645953270361,0.929241202634,002-ADW,0.141643966136,122,352,474
103,-0.645953270361,0.929241202634,002-ADY,0.141643966136,67,189,256
104,-0.645953270361,0.929241202634,002-ADZ,0.141643966136,76,150,226
105,-0.645953270361,0.929241202634,002-AEA,0.141643966136,69,137,206
106,-0.645953270361,0.929241202634,002-AEB,0.141643966136,44,121,165
107,-0.645953270361,0.929241202634,002-AEC,0.141643966136,119,278,397
108,-0.645953270361,0.929241202634,002-AED,0.141643966136,68,273,341
109,-0.645953270361,0.929241202634,002-AEE,0.141643966136,81,222,303
110,-0.645953270361,0.929241202634,002-AEF,0.141643966136,53,204,257
111,-0.645953270361,0.929241202634,002-AEG,0.141643966136,47,239,286
112,-0.645953270361,0.929241202634,002-AEI,0.141643966136,68,273,341
113,-0.645953270361,0.929241202634,002-AEJ,0.141643966136,87,306,393
114,-0.645953270361,0.929241202634,002-AEK,0.141643966136,68,44,112
115,-0.645953270361,0.929241202634,002-AEN,0.141643966136,94,431,525
116,-0.645953270361,0.929241202634,002-AEO,0.141643966136,29,103,132
117,-0.645953270361,0.929241202634,002-AEQ,0.141643966136,85,392,477
118,-0.645953270361,0.929241202634,002-AES,0.141643966136,89,464,553
119,-0.645953270361,0.929241202634,002-AET,0.141643966136,128,474,602
120,-0.645953270361,0.929241202634,002-AEW,0.141643966136,55,115,170
121,-0.645953270361,0.929241202634,002-AEX,0.141643966136,31,319,350
122,-0.645953270361,0.929241202634,002-AEY,0.141643966136,57,247,304
123,-0.645953270361,0.929241202634,002-AEZ,0.141643966136,62,229,291
124,-0.645953270361,0.929241202634,002-AFA,0.141643966136,95,189,284
125,-0.645953270361,0.929241202634,002-AFB,0.141643966136,83,209,292
126,-0.645953270361,0.929241202634,002-AFC,0.141643966136,71,89,160
127,-0.645953270361,0.929241202634,002-AFE,0.141643966136,25,67,92
128,-0.645953270361,0.929241202634,002-AFF,0.141643966136,73,298,371
129,-0.645953270361,0.929241202634,002-AFG,0.141643966136,88,331,419
130,-0.645953270361,0.929241202634,002-AFI,0.141643966136,100,96,196
131,-0.645953270361,0.929241202634,002-AFJ,0.141643966136,89,136,225
132,-0.645953270361,0.929241202634,002-AFK,0.141643966136,72,231,303
133,-0.645953270361,0.929241202634,002-AFL,0.141643966136,45,163,208
134,-0.645953270361,0.929241202634,002-AFM,0.141643966136,125,247,372
135,-0.645953270361,0.929241202634,002-AFN,0.141643966136,87,167,254
136,-0.645953270361,0.929241202634,002-AFO,0.141643966136,46,166,212
137,-0.645953270361,0.929241202634,002-AFP,0.141643966136,48,117,165
138,-0.645953270361,0.929241202634,002-AFQ,0.141643966136,60,240,300
139,-0.645953270361,0.929241202634,002-AFR,0.141643966136,69,257,326
140,-0.645953270361,0.929241202634,002-AFS,0.141643966136,67,222,289
141,-0.645953270361,0.929241202634,002-AFT,0.141643966136,68,178,246
142,-0.645953270361,0.929241202634,002-AFU,0.141643966136,54,225,279
143,-0.645953270361,0.929241202634,002-AFV,0.141643966136,53,260,313
144,-0.645953270361,0.929241202634,002-AFW,0.141643966136,43,165,208
145,-0.645953270361,0.929241202634,002-AFX,0.141643966136,36,182,218
146,-0.645953270361,0.929241202634,002-AFY,0.141643966136,54,219,273
147,-0.645953270361,0.929241202634,002-AFZ,0.141643966136,60,208,268
148,-0.645953270361,0.929241202634,002-AGA,0.141643966136,60,314,374
149,-0.645953270361,0.929241202634,002-AGB,0.141643966136,95,379,474
150,-0.645953270361,0.929241202634,002-AGC,0.141643966136,117,317,434
151,-0.645953270361,0.929241202634,002-AGD,0.141643966136,93,257,350
152,-0.645953270361,0.929241202634,002-AGI,0.141643966136,71,247,318
153,-0.645953270361,0.929241202634,002-AGK,0.141643966136,48,218,266
154,-0.645953270361,0.929241202634,002-AGL,0.141643966136,60,209,269
155,-0.645953270361,0.929241202634,002-AGN,0.141643966136,81,402,483
156,-0.645953270361,0.929241202634,003-AAA,0.141643966136,120,392,512
157,-0.645953270361,0.929241202634,003-AAB,0.141643966136,70,159,229
158,-0.645953270361,0.929241202634,003-AAC,0.141643966136,59,273,332
159,-0.645953270361,0.929241202634,003-AAD,0.141643966136,131,456,587
160,-0.645953270361,0.929241202634,003-AAF,0.141643966136,59,317,376
161,-0.645953270361,0.929241202634,003-AAG,0.141643966136,95,323,418
162,-0.645953270361,0.929241202634,003-AAH,0.141643966136,70,166,236
163,-0.645953270361,0.929241202634,003-AAI,0.141643966136,76,168,244
164,-0.645953270361,0.929241202634,003-AAJ,0.141643966136,111,352,463
165,-0.645953270361,0.929241202634,003-AAQ,0.141643966136,97,229,326
166,-0.645953270361,0.929241202634,003-AAS,0.141643966136,144,348,492
167,-0.645953270361,0.929241202634,003-AAU,0.141643966136,117,358,475
168,-0.645953270361,0.929241202634,003-AAV,0.141643966136,54,118,172
169,-0.645953270361,0.929241202634,003-AAZ,0.141643966136,81,194,275
170,-0.645953270361,0.929241202634,003-ABB,0.141643966136,62,112,174
171,-0.645953270361,0.929241202634,003-ABC,0.141643966136,70,127,197
172,-0.645953270361,0.929241202634,003-ABD,0.141643966136,46,72,118
173,-0.645953270361,0.929241202634,003-ABG,0.141643966136,62,209,271
174,-0.645953270361,0.929241202634,003-ABI,0.141643966136,109,241,350
175,-0.645953270361,0.929241202634,003-ABJ,0.141643966136,87,236,323
176,-0.645953270361,0.929241202634,003-ABK,0.141643966136,57,109,166
177,-0.645953270361,0.929241202634,003-ABN,0.141643966136,106,219,325
178,-0.645953270361,0.929241202634,003-ABO,0.141643966136,102,242,344
179,-0.645953270361,0.929241202634,003-ABP,0.141643966136,55,158,213
180,-0.645953270361,0.929241202634,003-ABQ,0.141643966136,74,208,282
181,-0.645953270361,0.929241202634,003-ABS,0.141643966136,153,341,494
182,-0.645953270361,0.929241202634,003-ABT,0.141643966136,122,365,487
183,-0.645953270361,0.929241202634,003-ABU,0.141643966136,39,68,107
184,-0.645953270361,0.929241202634,003-ABV,0.141643966136,56,161,217
185,-0.645953270361,0.929241202634,003-ABY,0.141643966136,59,185,244
186,-0.645953270361,0.929241202634,003-ABZ,0.141643966136,62,273,335
187,-0.645953270361,0.929241202634,003-ACA,0.141643966136,48,226,274
188,-0.645953270361,0.929241202634,003-ACB,0.141643966136,45,108,153
189,-0.645953270361,0.929241202634,003-ACC,0.141643966136,122,422,544
190,-0.645953270361,0.929241202634,003-ACE,0.141643966136,56,273,329
191,-0.645953270361,0.929241202634,003-ACF,0.141643966136,103,352,455
192,-0.645953270361,0.929241202634,003-ACH,0.141643966136,49,256,305
193,-0.645953270361,0.929241202634,003-ACI,0.141643966136,56,221,277
194,-0.645953270361,0.929241202634,003-ACJ,0.141643966136,73,224,297
195,-0.645953270361,0.929241202634,003-ACK,0.141643966136,82,212,294
196,-0.645953270361,0.929241202634,003-ACL,0.141643966136,66,235,301
197,-0.645953270361,0.929241202634,003-ACM,0.141643966136,80,256,336
198,-0.645953270361,0.929241202634,003-ACN,0.141643966136,61,239,300
199,-0.645953270361,0.929241202634,003-ACO,0.141643966136,114,269,383
200,-0.645953270361,0.929241202634,003-ACP,0.141643966136,106,174,280
201,-0.645953270361,0.929241202634,003-ACQ,0.141643966136,132,280,412
202,-0.645953270361,0.929241202634,003-ACR,0.141643966136,33,112,145
203,-0.645953270361,0.929241202634,003-ACS,0.141643966136,67,212,279
204,-0.645953270361,0.929241202634,003-ACT,0.141643966136,63,203,266
205,-0.645953270361,0.929241202634,003-ACU,0.141643966136,50,215,265
206,-0.645953270361,0.929241202634,003-ACV,0.141643966136,112,325,437
207,-0.645953270361,0.929241202634,003-ACX,0.141643966136,75,223,298
208,-0.645953270361,0.929241202634,004-AAA,0.141643966136,140,109,249
209,-0.645953270361,0.929241202634,004-AAB,0.141643966136,112,72,184
210,-0.645953270361,0.929241202634,004-AAC,0.141643966136,76,43,119
211,-0.645953270361,0.929241202634,004-AAD,0.141643966136,109,63,172
212,-0.645953270361,0.929241202634,004-AAE,0.141643966136,143,102,245
213,-0.645953270361,0.929241202634,004-AAF,0.141643966136,117,83,200
214,-0.645953270361,0.929241202634,004-AAG,0.141643966136,87,79,166
215,-0.645953270361,0.929241202634,004-AAH,0.141643966136,85,48,133
216,-0.645953270361,0.929241202634,004-AAI,0.141643966136,111,59,170
217,-0.645953270361,0.929241202634,004-AAJ,0.141643966136,130,61,191
218,-0.645953270361,0.929241202634,004-AAK,0.141643966136,105,53,158
219,-0.645953270361,0.929241202634,004-AAL,0.141643966136,93,62,155
220,-0.645953270361,0.929241202634,004-AAM,0.141643966136,97,48,145
221,-0.645953270361,0.929241202634,004-AAN,0.141643966136,44,19,63
222,-0.645953270361,0.929241202634,004-AAO,0.141643966136,68,43,111
223,-0.645953270361,0.929241202634,004-AAP,0.141643966136,88,45,133
224,-0.645953270361,0.929241202634,004-AAQ,0.141643966136,122,16,138
225,-0.645953270361,0.929241202634,004-AAR,0.141643966136,66,39,105
226,-0.645953270361,0.929241202634,004-AAS,0.141643966136,82,53,135
227,-0.645953270361,0.929241202634,004-AAT,0.141643966136,94,89,183
228,-0.645953270361,0.929241202634,004-AAU,0.141643966136,81,64,145
229,-0.645953270361,0.929241202634,004-AAV,0.141643966136,64,66,130
230,-0.645953270361,0.929241202634,004-AAW,0.141643966136,75,50,125
231,-0.645953270361,0.929241202634,004-AAX,0.141643966136,67,43,110
232,-0.645953270361,0.929241202634,004-AAY,0.141643966136,60,57,117
233,-0.645953270361,0.929241202634,004-AAZ,0.141643966136,81,92,173
234,-0.645953270361,0.929241202634,004-ABA,0.141643966136,95,65,160
235,-0.645953270361,0.929241202634,004-ABB,0.141643966136,89,76,165
236,-0.645953270361,0.929241202634,004-ABC,0.141643966136,91,93,184
237,-0.645953270361,0.929241202634,004-ABD,0.141643966136,74,87,161
238,-0.645953270361,0.929241202634,004-ABE,0.141643966136,42,75,117
239,-0.645953270361,0.929241202634,004-ABF,0.141643966136,172,143,315
240,-0.645953270361,0.929241202634,004-ABG,0.141643966136,107,77,184
241,-0.645953270361,0.929241202634,004-ABH,0.141643966136,106,121,227
242,-0.645953270361,0.929241202634,004-ABI,0.141643966136,141,180,321
243,-0.645953270361,0.929241202634,004-ABJ,0.141643966136,106,95,201
244,-0.645953270361,0.929241202634,004-ABK,0.141643966136,129,109,238
245,-0.645953270361,0.929241202634,004-ABL,0.141643966136,143,69,212
246,-0.645953270361,0.929241202634,004-ABM,0.141643966136,127,73,200
247,-0.645953270361,0.929241202634,004-ABN,0.141643966136,104,68,172
248,-0.645953270361,0.929241202634,004-ABO,0.141643966136,78,37,115
249,-0.645953270361,0.929241202634,004-ABP,0.141643966136,109,65,174
250,-0.645953270361,0.929241202634,004-ABQ,0.141643966136,64,49,113
251,-0.645953270361,0.929241202634,004-ABR,0.141643966136,103,128,231
252,-0.645953270361,0.929241202634,004-ABS,0.141643966136,51,52,103
253,-0.645953270361,0.929241202634,004-ABT,0.141643966136,116,98,214
254,-0.645953270361,0.929241202634,004-ABU,0.141643966136,123,135,258
255,-0.645953270361,0.929241202634,004-ABV,0.141643966136,70,78,148
256,-0.645953270361,0.929241202634,004-ABW,0.141643966136,77,67,144
257,-0.645953270361,0.929241202634,004-ABX,0.141643966136,115,131,246
258,-0.645953270361,0.929241202634,004-ABY,0.141643966136,113,171,284
259,-0.645953270361,0.929241202634,004-ABZ,0.141643966136,123,177,300
260,-0.645953270361,0.929241202634,004-ACA,0.141643966136,69,181,250
261,-0.645953270361,0.929241202634,004-ACB,0.141643966136,47,84,131
262,-0.645953270361,0.929241202634,004-ACC,0.141643966136,61,76,137
263,-0.645953270361,0.929241202634,004-ACD,0.141643966136,123,116,239
264,-0.645953270361,0.929241202634,004-ACG,0.141643966136,108,135,243
265,-0.645953270361,0.929241202634,004-ACH,0.141643966136,90,65,155
266,-0.645953270361,0.929241202634,004-ACI,0.141643966136,95,85,180
267,-0.645953270361,0.929241202634,004-ACJ,0.141643966136,120,154,274
268,-0.645953270361,0.929241202634,004-ACK,0.141643966136,114,73,187
269,-0.645953270361,0.929241202634,004-ACL,0.141643966136,86,111,197
270,-0.645953270361,0.929241202634,004-ACM,0.141643966136,107,124,231
271,-0.645953270361,0.929241202634,004-ACO,0.141643966136,147,284,431
272,-0.645953270361,0.929241202634,004-ACP,0.141643966136,145,237,382
273,-0.645953270361,0.929241202634,004-ACQ,0.141643966136,83,156,239
274,-0.645953270361,0.929241202634,004-ACR,0.141643966136,89,180,269
275,-0.645953270361,0.929241202634,004-ACS,0.141643966136,106,132,238
276,-0.645953270361,0.929241202634,004-ACT,0.141643966136,81,162,243
277,-0.645953270361,0.929241202634,004-ACU,0.141643966136,113,133,246
278,-0.645953270361,0.929241202634,004-ACV,0.141643966136,88,152,240
279,-0.645953270361,0.929241202634,004-ACW,0.141643966136,114,148,262
280,-0.645953270361,0.929241202634,004-ACX,0.141643966136,73,104,177
281,-0.645953270361,0.929241202634,004-ACY,0.141643966136,61,43,104
282,-0.645953270361,0.929241202634,004-ACZ,0.141643966136,106,97,203
283,-0.645953270361,0.929241202634,004-ADA,0.141643966136,94,180,274
284,-0.645953270361,0.929241202634,004-ADB,0.141643966136,119,234,353
285,-0.645953270361,0.929241202634,004-ADC,0.141643966136,113,167,280
286,-0.645953270361,0.929241202634,004-ADD,0.141643966136,82,179,261
287,-0.645953270361,0.929241202634,004-ADE,0.141643966136,55,136,191
288,-0.645953270361,0.929241202634,004-ADF,0.141643966136,84,149,233
289,-0.645953270361,0.929241202634,004-ADG,0.141643966136,71,111,182
290,-0.645953270361,0.929241202634,004-ADH,0.141643966136,86,161,247
291,-0.645953270361,0.929241202634,004-ADI,0.141643966136,81,122,203
292,-0.645953270361,0.929241202634,004-ADJ,0.141643966136,51,104,155
293,-0.645953270361,0.929241202634,004-ADK,0.141643966136,98,129,227
294,-0.645953270361,0.929241202634,004-ADL,0.141643966136,109,196,305
295,-0.645953270361,0.929241202634,004-ADM,0.141643966136,126,177,303
296,-0.645953270361,0.929241202634,004-ADN,0.141643966136,131,178,309
297,-0.645953270361,0.929241202634,004-ADO,0.141643966136,88,148,236
298,-0.645953270361,0.929241202634,004-ADP,0.141643966136,86,147,233
299,-0.645953270361,0.929241202634,004-ADQ,0.141643966136,131,210,341
300,-0.645953270361,0.929241202634,004-ADR,0.141643966136,128,198,326
301,-0.645953270361,0.929241202634,004-ADS,0.141643966136,70,56,126
302,-0.645953270361,0.929241202634,004-ADT,0.141643966136,100,185,285
303,-0.645953270361,0.929241202634,004-ADU,0.141643966136,112,216,328
304,-0.645953270361,0.929241202634,004-ADV,0.141643966136,161,214,375
305,-0.645953270361,0.929241202634,004-ADW,0.141643966136,117,159,276
306,-0.645953270361,0.929241202634,004-ADX,0.141643966136,78,97,175
307,-0.645953270361,0.929241202634,004-ADY,0.141643966136,87,82,169
308,-0.645953270361,0.929241202634,004-ADZ,0.141643966136,137,252,389
309,-0.645953270361,0.929241202634,004-AEA,0.141643966136,167,212,379
310,-0.645953270361,0.929241202634,004-AEB,0.141643966136,104,261,365
311,-0.645953270361,0.929241202634,004-AEC,0.141643966136,129,162,291
312,-0.645953270361,0.929241202634,004-AED,0.141643966136,104,142,246
313,-0.645953270361,0.929241202634,004-AEE,0.141643966136,107,107,214
314,-0.645953270361,0.929241202634,004-AEF,0.141643966136,126,146,272
315,-0.645953270361,0.929241202634,004-AEG,0.141643966136,127,172,299
316,-0.645953270361,0.929241202634,004-AEH,0.141643966136,82,140,222
317,-0.645953270361,0.929241202634,004-AEI,0.141643966136,120,93,213
318,-0.645953270361,0.929241202634,004-AEJ,0.141643966136,132,115,247
319,-0.645953270361,0.929241202634,004-AEK,0.141643966136,127,154,281
320,-0.645953270361,0.929241202634,004-AEL,0.141643966136,176,154,330
321,-0.645953270361,0.929241202634,004-AEM,0.141643966136,72,115,187
322,-0.645953270361,0.929241202634,004-AEN,0.141643966136,129,146,275
323,-0.645953270361,0.929241202634,004-AEO,0.141643966136,104,102,206
324,-0.645953270361,0.929241202634,004-AEP,0.141643966136,94,98,192
325,-0.645953270361,0.929241202634,004-AEQ,0.141643966136,105,111,216
326,-0.645953270361,0.929241202634,004-AER,0.141643966136,111,150,261
327,-0.645953270361,0.929241202634,004-AES,0.141643966136,80,172,252
328,-0.645953270361,0.929241202634,004-AET,0.141643966136,98,142,240
329,-0.645953270361,0.929241202634,004-AEU,0.141643966136,64,135,199
330,-0.645953270361,0.929241202634,004-AEV,0.141643966136,65,119,184
331,-0.645953270361,0.929241202634,004-AEW,0.141643966136,100,135,235
332,-0.645953270361,0.929241202634,004-AEX,0.141643966136,82,193,275
333,-0.645953270361,0.929241202634,004-AEY,0.141643966136,66,106,172
334,-0.645953270361,0.929241202634,004-AEZ,0.141643966136,183,364,547
335,-0.645953270361,0.929241202634,005-AAA,0.141643966136,49,12,61
336,-0.645953270361,0.929241202634,005-AAB,0.141643966136,178,18,196
337,-0.645953270361,0.929241202634,005-AAC,0.141643966136,146,44,190
338,-0.645953270361,0.929241202634,005-AAD,0.141643966136,118,45,163
339,-0.645953270361,0.929241202634,005-AAE,0.141643966136,83,58,141
340,-0.645953270361,0.929241202634,005-AAF,0.141643966136,49,23,72
341,-0.645953270361,0.929241202634,005-AAG,0.141643966136,69,27,96
342,-0.645953270361,0.929241202634,005-AAH,0.141643966136,123,29,152
343,-0.645953270361,0.929241202634,005-AAI,0.141643966136,236,119,355
344,-0.645953270361,0.929241202634,005-AAJ,0.141643966136,279,117,396
345,-0.645953270361,0.929241202634,005-AAK,0.141643966136,38,28,66
346,-0.645953270361,0.929241202634,005-AAL,0.141643966136,47,41,88
347,-0.645953270361,0.929241202634,005-AAM,0.141643966136,40,31,71
348,-0.645953270361,0.929241202634,005-AAN,0.141643966136,53,20,73
349,-0.645953270361,0.929241202634,005-AAO,0.141643966136,134,41,175
350,-0.645953270361,0.929241202634,005-AAP,0.141643966136,301,42,343
351,-0.645953270361,0.929241202634,005-AAQ,0.141643966136,160,60,220
352,-0.645953270361,0.929241202634,005-AAR,0.141643966136,98,36,134
353,-0.645953270361,0.929241202634,005-AAS,0.141643966136,142,64,206
354,-0.645953270361,0.929241202634,005-AAT,0.141643966136,140,73,213
355,-0.645953270361,0.929241202634,005-AAU,0.141643966136,244,78,322
356,-0.645953270361,0.929241202634,005-AAV,0.141643966136,145,48,193
357,-0.645953270361,0.929241202634,005-AAW,0.141643966136,150,81,231
358,-0.645953270361,0.929241202634,005-AAX,0.141643966136,79,30,109
359,-0.645953270361,0.929241202634,005-AAY,0.141643966136,74,55,129
360,-0.645953270361,0.929241202634,005-AAZ,0.141643966136,52,26,78
361,-0.645953270361,0.929241202634,005-ABA,0.141643966136,48,35,83
362,-0.645953270361,0.929241202634,005-ABB,0.141643966136,59,28,87
363,-0.645953270361,0.929241202634,005-ABC,0.141643966136,86,45,131
364,-0.645953270361,0.929241202634,005-ABD,0.141643966136,82,45,127
365,-0.645953270361,0.929241202634,005-ABE,0.141643966136,62,35,97
366,-0.645953270361,0.929241202634,005-ABF,0.141643966136,248,303,551
367,-0.645953270361,0.929241202634,005-ABG,0.141643966136,165,181,346
368,-0.645953270361,0.929241202634,005-ABH,0.141643966136,257,112,369
369,-0.645953270361,0.929241202634,005-ABI,0.141643966136,37,26,63
370,-0.645953270361,0.929241202634,005-ABJ,0.141643966136,418,293,711
371,-0.645953270361,0.929241202634,005-ABK,0.141643966136,172,81,253
372,-0.645953270361,0.929241202634,005-ABL,0.141643966136,276,164,440
373,-0.645953270361,0.929241202634,005-ABM,0.141643966136,268,138,406
374,-0.645953270361,0.929241202634,005-ABN,0.141643966136,321,198,519
375,-0.645953270361,0.929241202634,005-ABO,0.141643966136,114,50,164
376,-0.645953270361,0.929241202634,005-ABP,0.141643966136,96,55,151
377,-0.645953270361,0.929241202634,005-ABQ,0.141643966136,261,112,373
378,-0.645953270361,0.929241202634,005-ABR,0.141643966136,190,259,449
379,-0.645953270361,0.929241202634,005-ABS,0.141643966136,127,79,206
380,-0.645953270361,0.929241202634,005-ABT,0.141643966136,170,140,310
381,-0.645953270361,0.929241202634,005-ABU,0.141643966136,210,102,312
382,-0.645953270361,0.929241202634,005-ABV,0.141643966136,153,37,190
383,-0.645953270361,0.929241202634,005-ABW,0.141643966136,133,145,278
384,-0.645953270361,0.929241202634,005-ABX,0.141643966136,348,331,679
385,-0.645953270361,0.929241202634,005-ABY,0.141643966136,285,196,481
386,-0.645953270361,0.929241202634,005-ABZ,0.141643966136,71,51,122
387,-0.645953270361,0.929241202634,005-ACA,0.141643966136,157,124,281
388,-0.645953270361,0.929241202634,005-ACB,0.141643966136,107,46,153
389,-0.645953270361,0.929241202634,005-ACC,0.141643966136,326,148,474
390,-0.645953270361,0.929241202634,005-ACD,0.141643966136,64,26,90
391,-0.645953270361,0.929241202634,005-ACE,0.141643966136,93,38,131
392,-0.645953270361,0.929241202634,005-ACF,0.141643966136,92,22,114
393,-0.645953270361,0.929241202634,005-ACG,0.141643966136,55,11,66
394,-0.645953270361,0.929241202634,005-ACH,0.141643966136,42,12,54
395,-0.645953270361,0.929241202634,005-ACI,0.141643966136,48,75,123
396,-0.645953270361,0.929241202634,005-ACJ,0.141643966136,117,261,378
397,-0.645953270361,0.929241202634,005-ACK,0.141643966136,64,153,217
398,-0.645953270361,0.929241202634,005-ACL,0.141643966136,255,130,385
399,-0.645953270361,0.929241202634,005-ACM,0.141643966136,104,59,163
400,-0.645953270361,0.929241202634,005-ACN,0.141643966136,135,64,199
401,-0.645953270361,0.929241202634,005-ACO,0.141643966136,117,45,162
402,-0.645953270361,0.929241202634,005-ACP,0.141643966136,77,38,115
403,-0.645953270361,0.929241202634,005-ACQ,0.141643966136,207,151,358
404,-0.645953270361,0.929241202634,005-ACR,0.141643966136,93,23,116
405,-0.645953270361,0.929241202634,006-AAA,0.141643966136,101,334,435
406,-0.645953270361,0.929241202634,006-AAB,0.141643966136,67,167,234
407,-0.645953270361,0.929241202634,006-AAC,0.141643966136,97,230,327
408,-0.645953270361,0.929241202634,006-AAD,0.141643966136,139,406,545
409,-0.645953270361,0.929241202634,006-AAE,0.141643966136,132,334,466
410,-0.645953270361,0.929241202634,006-AAF,0.141643966136,118,177,295
411,-0.645953270361,0.929241202634,006-AAG,0.141643966136,98,464,562
412,-0.645953270361,0.929241202634,006-AAH,0.141643966136,122,344,466
413,-0.645953270361,0.929241202634,006-AAI,0.141643966136,62,178,240
414,-0.645953270361,0.929241202634,006-AAJ,0.141643966136,79,272,351
415,-0.645953270361,0.929241202634,006-AAK,0.141643966136,54,147,201
416,-0.645953270361,0.929241202634,006-AAL,0.141643966136,62,217,279
417,-0.645953270361,0.929241202634,006-AAM,0.141643966136,63,159,222
418,-0.645953270361,0.929241202634,006-AAN,0.141643966136,110,303,413
419,-0.645953270361,0.929241202634,006-AAO,0.141643966136,48,239,287
420,-0.645953270361,0.929241202634,006-AAP,0.141643966136,93,461,554
421,-0.645953270361,0.929241202634,006-AAR,0.141643966136,110,415,525
422,-0.645953270361,0.929241202634,006-AAS,0.141643966136,55,131,186
423,-0.645953270361,0.929241202634,006-AAU,0.141643966136,43,303,346
424,-0.645953270361,0.929241202634,006-AAV,0.141643966136,135,585,720
425,-0.645953270361,0.929241202634,006-AAW,0.141643966136,74,365,439
426,-0.645953270361,0.929241202634,006-AAX,0.141643966136,36,162,198
427,-0.645953270361,0.929241202634,006-AAY,0.141643966136,35,371,406
428,-0.645953270361,0.929241202634,006-AAZ,0.141643966136,105,512,617
429,-0.645953270361,0.929241202634,006-ABA,0.141643966136,86,485,571
430,-0.645953270361,0.929241202634,006-ABB,0.141643966136,24,52,76
431,-0.645953270361,0.929241202634,006-ABC,0.141643966136,54,312,366
432,-0.645953270361,0.929241202634,006-ABD,0.141643966136,112,592,704
433,-0.645953270361,0.929241202634,006-ABF,0.141643966136,98,351,449
434,-0.645953270361,0.929241202634,006-ABG,0.141643966136,90,406,496
435,-0.645953270361,0.929241202634,006-ABH,0.141643966136,125,486,611
436,-0.645953270361,0.929241202634,006-ABJ,0.141643966136,171,401,572
437,-0.645953270361,0.929241202634,006-ABK,0.141643966136,28,175,203
438,-0.645953270361,0.929241202634,006-ABL,0.141643966136,103,548,651
439,-0.645953270361,0.929241202634,006-ABM,0.141643966136,13,65,78
440,-0.645953270361,0.929241202634,006-ABN,0.141643966136,38,309,347
441,-0.645953270361,0.929241202634,006-ABO,0.141643966136,45,397,442
442,-0.645953270361,0.929241202634,006-ABP,0.141643966136,43,248,291
443,-0.645953270361,0.929241202634,006-ABQ,0.141643966136,67,173,240
444,-0.645953270361,0.929241202634,006-ABR,0.141643966136,82,323,405
445,-0.645953270361,0.929241202634,007-AAA,0.141643966136,266,173,439
446,-0.645953270361,0.929241202634,007-AAB,0.141643966136,161,102,263
447,-0.645953270361,0.929241202634,007-AAE,0.141643966136,199,108,307
448,-0.645953270361,0.929241202634,007-AAF,0.141643966136,290,230,520
449,-0.645953270361,0.929241202634,007-AAH,0.141643966136,283,184,467
450,-0.645953270361,0.929241202634,007-AAJ,0.141643966136,71,55,126
451,-0.645953270361,0.929241202634,007-AAK,0.141643966136,139,128,267
452,-0.645953270361,0.929241202634,007-AAL,0.141643966136,251,110,361
453,-0.645953270361,0.929241202634,007-AAO,0.141643966136,128,141,269
454,-0.645953270361,0.929241202634,007-AAP,0.141643966136,198,284,482
455,-0.645953270361,0.929241202634,007-AAQ,0.141643966136,124,146,270
456,-0.645953270361,0.929241202634,007-AAR,0.141643966136,158,225,383
457,-0.645953270361,0.929241202634,007-AAS,0.141643966136,146,128,274
458,-0.645953270361,0.929241202634,007-AAT,0.141643966136,120,141,261
459,-0.645953270361,0.929241202634,007-AAU,0.141643966136,84,72,156
460,-0.645953270361,0.929241202634,007-AAV,0.141643966136,68,91,159
461,-0.645953270361,0.929241202634,007-AAW,0.141643966136,239,254,493
462,-0.645953270361,0.929241202634,007-AAX,0.141643966136,158,108,266
463,-0.645953270361,0.929241202634,007-AAY,0.141643966136,139,133,272
464,-0.645953270361,0.929241202634,007-AAZ,0.141643966136,119,88,207
465,-0.645953270361,0.929241202634,007-ABA,0.141643966136,150,125,275
466,-0.645953270361,0.929241202634,007-ABB,0.141643966136,56,36,92
467,-0.645953270361,0.929241202634,007-ABC,0.141643966136,80,80,160
468,-0.645953270361,0.929241202634,007-ABD,0.141643966136,54,77,131
469,-0.645953270361,0.929241202634,007-ABE,0.141643966136,135,232,367
470,-0.645953270361,0.929241202634,007-ABF,0.141643966136,159,329,488
471,-0.645953270361,0.929241202634,007-ABG,0.141643966136,31,70,101
472,-0.645953270361,0.929241202634,007-ABH,0.141643966136,249,192,441
473,-0.645953270361,0.929241202634,007-ABI,0.141643966136,289,268,557
474,-0.645953270361,0.929241202634,007-ABL,0.141643966136,234,191,425
475,-0.645953270361,0.929241202634,007-ABN,0.141643966136,272,236,508
476,-0.645953270361,0.929241202634,007-ABP,0.141643966136,165,131,296
477,-0.645953270361,0.929241202634,007-ABQ,0.141643966136,155,122,277
478,-0.645953270361,0.929241202634,007-ABS,0.141643966136,126,95,221
479,-0.645953270361,0.929241202634,007-ABU,0.141643966136,119,105,224
480,-0.645953270361,0.929241202634,007-ABV,0.141643966136,272,167,439
481,-0.645953270361,0.929241202634,007-ABW,0.141643966136,191,166,357
482,-0.645953270361,0.929241202634,007-ABX,0.141643966136,59,91,150
483,-0.645953270361,0.929241202634,007-ABY,0.141643966136,92,45,137
484,-0.645953270361,0.929241202634,007-ABZ,0.141643966136,151,123,274
485,-0.645953270361,0.929241202634,007-ACD,0.141643966136,57,44,101
486,-0.645953270361,0.929241202634,007-ACE,0.141643966136,315,220,535
487,-0.645953270361,0.929241202634,007-ACF,0.141643966136,232,271,503
488,-0.645953270361,0.929241202634,007-ACH,0.141643966136,261,223,484
489,-0.645953270361,0.929241202634,007-ACJ,0.141643966136,124,218,342
490,-0.645953270361,0.929241202634,007-ACK,0.141643966136,169,287,456
491,-0.645953270361,0.929241202634,007-ACL,0.141643966136,153,171,324
492,-0.645953270361,0.929241202634,007-ACM,0.141643966136,128,304,432
493,-0.645953270361,0.929241202634,007-ACN,0.141643966136,169,319,488
494,-0.645953270361,0.929241202634,007-ACO,0.141643966136,206,345,551
495,-0.645953270361,0.929241202634,007-ACP,0.141643966136,108,109,217
496,-0.645953270361,0.929241202634,007-ACQ,0.141643966136,192,269,461
497,-0.645953270361,0.929241202634,007-ACS,0.141643966136,94,116,210
498,-0.645953270361,0.929241202634,007-ACT,0.141643966136,56,60,116
499,-0.645953270361,0.929241202634,007-ACU,0.141643966136,32,54,86
500,-0.645953270361,0.929241202634,007-ACV,0.141643966136,122,98,220
501,-0.645953270361,0.929241202634,007-ACW,0.141643966136,161,343,504
502,-0.645953270361,0.929241202634,007-ACX,0.141643966136,236,336,572
503,-0.645953270361,0.929241202634,007-ACZ,0.141643966136,156,167,323
504,-0.645953270361,0.929241202634,007-ADB,0.141643966136,278,373,651
505,-0.645953270361,0.929241202634,007-ADD,0.141643966136,63,78,141
506,-0.645953270361,0.929241202634,007-ADE,0.141643966136,91,126,217
507,-0.645953270361,0.929241202634,007-ADF,0.141643966136,168,139,307
508,-0.645953270361,0.929241202634,007-ADH,0.141643966136,97,149,246
509,-0.645953270361,0.929241202634,007-ADI,0.141643966136,295,164,459
510,-0.645953270361,0.929241202634,007-ADK,0.141643966136,173,132,305
511,-0.645953270361,0.929241202634,007-ADL,0.141643966136,10,31,41
512,-0.645953270361,0.929241202634,007-ADW,0.141643966136,87,30,117
513,-0.645953270361,0.929241202634,007-ADX,0.141643966136,141,150,291
514,-0.645953270361,0.929241202634,008-AAA,0.141643966136,78,204,282
515,-0.645953270361,0.929241202634,008-AAF,0.141643966136,126,462,588
516,-0.645953270361,0.929241202634,008-AAG,0.141643966136,49,177,226
517,-0.645953270361,0.929241202634,008-AAH,0.141643966136,54,238,292
518,-0.645953270361,0.929241202634,008-AAJ,0.141643966136,84,283,367
519,-0.645953270361,0.929241202634,008-AAK,0.141643966136,161,350,511
520,-0.645953270361,0.929241202634,008-AAM,0.141643966136,74,219,293
521,-0.645953270361,0.929241202634,008-AAV,0.141643966136,101,316,417
522,-0.645953270361,0.929241202634,008-AAW,0.141643966136,81,303,384
523,-0.645953270361,0.929241202634,008-AAY,0.141643966136,61,289,350
524,-0.645953270361,0.929241202634,008-ABI,0.141643966136,99,276,375
525,-0.645953270361,0.929241202634,008-ABP,0.141643966136,42,161,203
526,-0.645953270361,0.929241202634,008-ACD,0.141643966136,106,353,459
527,-0.645953270361,0.929241202634,008-ACE,0.141643966136,94,331,425
528,-0.645953270361,0.929241202634,008-ACF,0.141643966136,80,308,388
529,-0.645953270361,0.929241202634,008-ACG,0.141643966136,113,382,495
530,-0.645953270361,0.929241202634,008-ACH,0.141643966136,127,419,546
531,-0.645953270361,0.929241202634,008-ACI,0.141643966136,121,360,481
532,-0.645953270361,0.929241202634,008-ACJ,0.141643966136,166,384,550
533,-0.645953270361,0.929241202634,008-ACK,0.141643966136,56,176,232
534,-0.645953270361,0.929241202634,008-ACL,0.141643966136,91,297,388
535,-0.645953270361,0.929241202634,008-ACM,0.141643966136,102,282,384
536,-0.645953270361,0.929241202634,008-ACN,0.141643966136,70,287,357
537,-0.645953270361,0.929241202634,008-ACO,0.141643966136,99,272,371
538,-0.645953270361,0.929241202634,008-ACP,0.141643966136,121,315,436
539,-0.645953270361,0.929241202634,008-ACQ,0.141643966136,152,428,580
540,-0.645953270361,0.929241202634,008-ACR,0.141643966136,80,327,407
541,-0.645953270361,0.929241202634,008-ACS,0.141643966136,82,425,507
542,-0.645953270361,0.929241202634,008-ACT,0.141643966136,83,338,421
543,-0.645953270361,0.929241202634,008-ACU,0.141643966136,143,361,504
544,-0.645953270361,0.929241202634,008-ACV,0.141643966136,110,322,432
545,-0.645953270361,0.929241202634,008-ACW,0.141643966136,137,368,505
546,-0.645953270361,0.929241202634,009-AAB,0.141643966136,205,284,489
547,-0.645953270361,0.929241202634,009-AAC,0.141643966136,77,417,494
548,-0.645953270361,0.929241202634,009-AAD,0.141643966136,99,177,276
549,-0.645953270361,0.929241202634,009-AAE,0.141643966136,92,150,242
550,-0.645953270361,0.929241202634,009-AAF,0.141643966136,110,107,217
551,-0.645953270361,0.929241202634,009-AAG,0.141643966136,136,291,427
552,-0.645953270361,0.929241202634,009-AAH,0.141643966136,124,127,251
553,-0.645953270361,0.929241202634,009-AAI,0.141643966136,95,202,297
554,-0.645953270361,0.929241202634,009-AAK,0.141643966136,128,142,270
555,-0.645953270361,0.929241202634,009-AAL,0.141643966136,107,296,403
556,-0.645953270361,0.929241202634,009-AAM,0.141643966136,87,252,339
557,-0.645953270361,0.929241202634,009-AAN,0.141643966136,89,199,288
558,-0.645953270361,0.929241202634,009-AAO,0.141643966136,99,96,195
559,-0.645953270361,0.929241202634,009-AAP,0.141643966136,94,243,337
560,-0.645953270361,0.929241202634,009-AAQ,0.141643966136,91,243,334
561,-0.645953270361,0.929241202634,009-AAR,0.141643966136,108,164,272
562,-0.645953270361,0.929241202634,009-AAS,0.141643966136,60,105,165
563,-0.645953270361,0.929241202634,009-AAT,0.141643966136,95,291,386
564,-0.645953270361,0.929241202634,009-AAU,0.141643966136,111,216,327
565,-0.645953270361,0.929241202634,009-AAV,0.141643966136,88,374,462
566,-0.645953270361,0.929241202634,009-AAW,0.141643966136,82,294,376
567,-0.645953270361,0.929241202634,009-AAX,0.141643966136,100,298,398
568,-0.645953270361,0.929241202634,009-AAY,0.141643966136,113,266,379
569,-0.645953270361,0.929241202634,009-AAZ,0.141643966136,99,323,422
570,-0.645953270361,0.929241202634,009-ABA,0.141643966136,77,204,281
571,-0.645953270361,0.929241202634,009-ABC,0.141643966136,106,258,364
572,-0.645953270361,0.929241202634,009-ABD,0.141643966136,84,378,462
573,-0.645953270361,0.929241202634,009-ABH,0.141643966136,116,393,509
574,-0.645953270361,0.929241202634,009-ABI,0.141643966136,88,330,418
575,-0.645953270361,0.929241202634,009-ABJ,0.141643966136,122,327,449
576,-0.645953270361,0.929241202634,009-ABK,0.141643966136,69,318,387
577,-0.645953270361,0.929241202634,009-ABL,0.141643966136,118,378,496
578,-0.645953270361,0.929241202634,009-ABM,0.141643966136,71,236,307
579,-0.645953270361,0.929241202634,009-ABN,0.141643966136,119,339,458
580,-0.645953270361,0.929241202634,009-ABO,0.141643966136,60,316,376
581,-0.645953270361,0.929241202634,009-ABQ,0.141643966136,129,323,452
582,-0.645953270361,0.929241202634,009-ABR,0.141643966136,86,285,371
583,-0.645953270361,0.929241202634,009-ABS,0.141643966136,87,174,261
584,-0.645953270361,0.929241202634,009-ABT,0.141643966136,99,132,231
585,-0.645953270361,0.929241202634,009-ABU,0.141643966136,77,179,256
586,-0.645953270361,0.929241202634,009-ABV,0.141643966136,105,243,348
587,-0.645953270361,0.929241202634,009-ABW,0.141643966136,126,421,547
588,-0.645953270361,0.929241202634,009-ABX,0.141643966136,113,206,319
589,-0.645953270361,0.929241202634,009-ABY,0.141643966136,119,194,313
590,-0.645953270361,0.929241202634,009-ABZ,0.141643966136,116,246,362
591,-0.645953270361,0.929241202634,009-ACA,0.141643966136,92,255,347
592,-0.645953270361,0.929241202634,009-ACB,0.141643966136,105,311,416
593,-0.645953270361,0.929241202634,009-ACC,0.141643966136,68,149,217
594,-0.645953270361,0.929241202634,009-ACD,0.141643966136,84,178,262
595,-0.645953270361,0.929241202634,009-ACE,0.141643966136,163,396,559
596,-0.645953270361,0.929241202634,009-ACF,0.141643966136,156,401,557
597,-0.645953270361,0.929241202634,009-ACG,0.141643966136,98,291,389
598,-0.645953270361,0.929241202634,009-ACH,0.141643966136,171,568,739
599,-0.645953270361,0.929241202634,009-ACI,0.141643966136,82,141,223
600,-0.645953270361,0.929241202634,009-ACJ,0.141643966136,123,342,465
601,-0.645953270361,0.929241202634,009-ACK,0.141643966136,101,253,354
602,-0.645953270361,0.929241202634,009-ACL,0.141643966136,113,360,473
603,-0.645953270361,0.929241202634,009-ACM,0.141643966136,81,265,346
604,-0.645953270361,0.929241202634,009-ACN,0.141643966136,170,22,192
605,-0.645953270361,0.929241202634,009-ACO,0.141643966136,224,8,232
606,-0.645953270361,0.929241202634,009-ACQ,0.141643966136,69,109,178
607,-0.645953270361,0.929241202634,009-ACR,0.141643966136,57,94,151
608,-0.645953270361,0.929241202634,009-ACS,0.141643966136,91,192,283
609,-0.645953270361,0.929241202634,009-ACT,0.141643966136,110,173,283
610,-0.645953270361,0.929241202634,009-ACU,0.141643966136,92,118,210
611,-0.645953270361,0.929241202634,009-ACV,0.141643966136,178,32,210
612,-0.645953270361,0.929241202634,009-ACX,0.141643966136,62,68,130
613,-0.645953270361,0.929241202634,009-ACY,0.141643966136,52,117,169
614,-0.645953270361,0.929241202634,009-ACZ,0.141643966136,165,254,419
615,-0.645953270361,0.929241202634,009-ADA,0.141643966136,129,142,271
616,-0.645953270361,0.929241202634,009-ADB,0.141643966136,112,236,348
617,-0.645953270361,0.929241202634,009-ADC,0.141643966136,85,169,254
618,-0.645953270361,0.929241202634,009-ADD,0.141643966136,139,266,405
619,-0.645953270361,0.929241202634,009-ADE,0.141643966136,103,174,277
620,-0.645953270361,0.929241202634,009-ADF,0.141643966136,20,44,64
621,-0.645953270361,0.929241202634,009-ADG,0.141643966136,90,232,322
622,-0.645953270361,0.929241202634,009-ADH,0.141643966136,84,147,231
623,-0.645953270361,0.929241202634,009-ADI,0.141643966136,117,224,341
624,-0.645953270361,0.929241202634,009-ADJ,0.141643966136,109,308,417
625,-0.645953270361,0.929241202634,009-ADK,0.141643966136,100,279,379
626,-0.645953270361,0.929241202634,009-ADL,0.141643966136,131,353,484
627,-0.645953270361,0.929241202634,009-ADM,0.141643966136,54,97,151
628,-0.645953270361,0.929241202634,009-ADN,0.141643966136,110,170,280
629,-0.645953270361,0.929241202634,009-ADO,0.141643966136,96,189,285
630,-0.645953270361,0.929241202634,009-ADP,0.141643966136,109,101,210
631,-0.645953270361,0.929241202634,009-ADR,0.141643966136,248,51,299
632,-0.645953270361,0.929241202634,009-ADS,0.141643966136,221,7,228
633,-0.645953270361,0.929241202634,009-ADT,0.141643966136,57,92,149
634,-0.645953270361,0.929241202634,009-ADU,0.141643966136,108,91,199
635,-0.645953270361,0.929241202634,009-ADV,0.141643966136,194,25,219
636,-0.645953270361,0.929241202634,009-ADW,0.141643966136,102,34,136
637,-0.645953270361,0.929241202634,009-ADX,0.141643966136,119,118,237
638,-0.645953270361,0.929241202634,009-ADY,0.141643966136,98,335,433
639,-0.645953270361,0.929241202634,009-ADZ,0.141643966136,110,238,348
640,-0.645953270361,0.929241202634,009-AEA,0.141643966136,106,208,314
641,-0.645953270361,0.929241202634,009-AEB,0.141643966136,80,178,258
642,-0.645953270361,0.929241202634,009-AEC,0.141643966136,117,303,420
643,-0.645953270361,0.929241202634,009-AED,0.141643966136,134,410,544
644,-0.645953270361,0.929241202634,009-AEE,0.141643966136,154,327,481
645,-0.645953270361,0.929241202634,009-AEF,0.141643966136,93,177,270
646,-0.645953270361,0.929241202634,009-AEG,0.141643966136,93,215,308
647,-0.645953270361,0.929241202634,009-AEH,0.141643966136,122,205,327
648,-0.645953270361,0.929241202634,009-AEI,0.141643966136,157,310,467
649,-0.645953270361,0.929241202634,009-AEK,0.141643966136,105,131,236
650,-0.645953270361,0.929241202634,009-AEL,0.141643966136,106,142,248
651,-0.645953270361,0.929241202634,009-AEM,0.141643966136,118,226,344
652,-0.645953270361,0.929241202634,009-AEN,0.141643966136,88,143,231
653,-0.645953270361,0.929241202634,009-AEO,0.141643966136,108,154,262
654,-0.645953270361,0.929241202634,009-AEP,0.141643966136,172,228,400
655,-0.645953270361,0.929241202634,009-AEQ,0.141643966136,153,184,337
656,-0.645953270361,0.929241202634,009-AER,0.141643966136,125,202,327
657,-0.645953270361,0.929241202634,009-AET,0.141643966136,145,100,245
658,-0.645953270361,0.929241202634,009-AEU,0.141643966136,90,56,146
659,-0.645953270361,0.929241202634,009-AEV,0.141643966136,367,247,614
660,-0.645953270361,0.929241202634,009-AEW,0.141643966136,135,99,234
661,-0.645953270361,0.929241202634,009-AEX,0.141643966136,130,157,287
662,-0.645953270361,0.929241202634,009-AEY,0.141643966136,44,14,58
663,-0.645953270361,0.929241202634,009-AEZ,0.141643966136,45,41,86
664,-0.645953270361,0.929241202634,009-AFA,0.141643966136,115,67,182
665,-0.645953270361,0.929241202634,009-AFB,0.141643966136,142,142,284
666,-0.645953270361,0.929241202634,009-AFC,0.141643966136,208,242,450
667,-0.645953270361,0.929241202634,009-AFD,0.141643966136,42,12,54
668,-0.645953270361,0.929241202634,009-AFE,0.141643966136,14,9,23
669,-0.645953270361,0.929241202634,009-AFF,0.141643966136,228,184,412
670,-0.645953270361,0.929241202634,009-AFH,0.141643966136,85,197,282
671,-0.645953270361,0.929241202634,009-AFI,0.141643966136,79,286,365
672,-0.645953270361,0.929241202634,009-AFJ,0.141643966136,103,325,428
673,-0.645953270361,0.929241202634,009-AFK,0.141643966136,124,285,409
674,-0.645953270361,0.929241202634,009-AFL,0.141643966136,61,227,288
675,-0.645953270361,0.929241202634,009-AFM,0.141643966136,114,264,378
676,-0.645953270361,0.929241202634,009-AFN,0.141643966136,115,417,532
677,-0.645953270361,0.929241202634,009-AFO,0.141643966136,90,327,417
678,-0.645953270361,0.929241202634,009-AFP,0.141643966136,61,169,230
679,-0.645953270361,0.929241202634,009-AFQ,0.141643966136,78,212,290
680,-0.645953270361,0.929241202634,009-AFR,0.141643966136,91,317,408
681,-0.645953270361,0.929241202634,009-AFS,0.141643966136,123,181,304
682,-0.645953270361,0.929241202634,009-AFT,0.141643966136,164,378,542
683,-0.645953270361,0.929241202634,009-AFU,0.141643966136,97,374,471
684,-0.645953270361,0.929241202634,009-AFV,0.141643966136,114,330,444
685,-0.645953270361,0.929241202634,009-AFW,0.141643966136,101,360,461
686,-0.645953270361,0.929241202634,009-AFX,0.141643966136,86,310,396
687,-0.645953270361,0.929241202634,009-AFY,0.141643966136,165,471,636
688,-0.645953270361,0.929241202634,009-AFZ,0.141643966136,131,432,563
689,-0.645953270361,0.929241202634,009-AGA,0.141643966136,73,221,294
690,-0.645953270361,0.929241202634,009-AGB,0.141643966136,15,96,111
691,-0.645953270361,0.929241202634,009-AGC,0.141643966136,96,314,410
692,-0.645953270361,0.929241202634,009-AGD,0.141643966136,73,286,359
693,-0.645953270361,0.929241202634,009-AGE,0.141643966136,98,391,489
694,-0.645953270361,0.929241202634,009-AGF,0.141643966136,96,367,463
695,-0.645953270361,0.929241202634,009-AGG,0.141643966136,17,40,57
696,-0.645953270361,0.929241202634,009-AGH,0.141643966136,124,369,493
697,-0.645953270361,0.929241202634,009-AGJ,0.141643966136,38,86,124
698,-0.645953270361,0.929241202634,009-AGK,0.141643966136,75,102,177
699,-0.645953270361,0.929241202634,009-AGL,0.141643966136,117,510,627
700,-0.645953270361,0.929241202634,009-AGM,0.141643966136,139,474,613
701,-0.645953270361,0.929241202634,009-AGN,0.141643966136,75,340,415
702,-0.645953270361,0.929241202634,009-AGO,0.141643966136,115,393,508
703,-0.645953270361,0.929241202634,009-AGP,0.141643966136,125,468,593
704,-0.645953270361,0.929241202634,009-AGQ,0.141643966136,95,500,595
705,-0.645953270361,0.929241202634,009-AGR,0.141643966136,131,542,673
706,-0.645953270361,0.929241202634,009-AGS,0.141643966136,128,359,487
707,-0.645953270361,0.929241202634,009-AGT,0.141643966136,152,610,762
708,-0.645953270361,0.929241202634,009-AGU,0.141643966136,93,408,501
709,-0.645953270361,0.929241202634,009-AGV,0.141643966136,108,329,437
710,-0.645953270361,0.929241202634,009-AGW,0.141643966136,130,370,500
711,-0.645953270361,0.929241202634,009-AGX,0.141643966136,107,428,535
712,-0.645953270361,0.929241202634,009-AGY,0.141643966136,84,273,357
713,-0.645953270361,0.929241202634,009-AGZ,0.141643966136,122,341,463
714,-0.645953270361,0.929241202634,009-AHA,0.141643966136,35,150,185
715,-0.645953270361,0.929241202634,009-AHB,0.141643966136,91,272,363
716,-0.645953270361,0.929241202634,009-AHC,0.141643966136,90,326,416
717,-0.645953270361,0.929241202634,009-AHD,0.141643966136,109,338,447
718,-0.645953270361,0.929241202634,009-AHE,0.141643966136,120,340,460
719,-0.645953270361,0.929241202634,009-AHF,0.141643966136,81,270,351
720,-0.645953270361,0.929241202634,009-AHG,0.141643966136,86,262,348
721,-0.645953270361,0.929241202634,009-AHH,0.141643966136,127,363,490
722,-0.645953270361,0.929241202634,009-AHI,0.141643966136,14,51,65
723,-0.645953270361,0.929241202634,009-AHJ,0.141643966136,60,270,330
724,-0.645953270361,0.929241202634,009-AHK,0.141643966136,48,361,409
725,-0.645953270361,0.929241202634,009-AHL,0.141643966136,78,472,550
726,-0.645953270361,0.929241202634,009-AHM,0.141643966136,51,471,522
727,-0.645953270361,0.929241202634,009-AHN,0.141643966136,55,355,410
728,-0.645953270361,0.929241202634,009-AHO,0.141643966136,136,269,405
729,-0.645953270361,0.929241202634,009-AHP,0.141643966136,21,30,51
730,-0.645953270361,0.929241202634,009-AHQ,0.141643966136,287,306,593
731,-0.645953270361,0.929241202634,009-AHS,0.141643966136,104,375,479
732,-0.645953270361,0.929241202634,009-AHT,0.141643966136,161,443,604
733,-0.645953270361,0.929241202634,009-AHU,0.141643966136,66,332,398
734,-0.645953270361,0.929241202634,009-AHV,0.141643966136,81,505,586
735,-0.645953270361,0.929241202634,009-AHW,0.141643966136,83,527,610
736,-0.645953270361,0.929241202634,009-AHX,0.141643966136,87,493,580
737,-0.645953270361,0.929241202634,009-AHY,0.141643966136,31,116,147
738,-0.645953270361,0.929241202634,009-AHZ,0.141643966136,77,245,322
739,-0.645953270361,0.929241202634,009-AIA,0.141643966136,79,315,394
740,-0.645953270361,0.929241202634,009-AIB,0.141643966136,57,93,150
741,-0.645953270361,0.929241202634,009-AIC,0.141643966136,56,193,249
742,-0.645953270361,0.929241202634,009-AID,0.141643966136,53,129,182
743,-0.645953270361,0.929241202634,009-AIE,0.141643966136,53,177,230
744,-0.645953270361,0.929241202634,009-AIF,0.141643966136,55,147,202
745,-0.645953270361,0.929241202634,009-AIG,0.141643966136,62,168,230
746,-0.645953270361,0.929241202634,009-AIH,0.141643966136,20,67,87
747,-0.645953270361,0.929241202634,009-AII,0.141643966136,70,288,358
748,-0.645953270361,0.929241202634,009-AIJ,0.141643966136,121,327,448
749,-0.645953270361,0.929241202634,009-AIK,0.141643966136,148,489,637
750,-0.645953270361,0.929241202634,009-AIL,0.141643966136,82,380,462
751,-0.645953270361,0.929241202634,009-AIM,0.141643966136,116,311,427
752,-0.645953270361,0.929241202634,009-AIN,0.141643966136,81,259,340
753,-0.645953270361,0.929241202634,009-AIO,0.141643966136,126,363,489
754,-0.645953270361,0.929241202634,009-AIP,0.141643966136,143,394,537
755,-0.645953270361,0.929241202634,009-AIQ,0.141643966136,103,413,516
756,-0.645953270361,0.929241202634,009-AIS,0.141643966136,86,302,388
757,-0.645953270361,0.929241202634,009-AIT,0.141643966136,101,415,516
758,-0.645953270361,0.929241202634,009-AIU,0.141643966136,192,512,704
759,-0.645953270361,0.929241202634,009-AIV,0.141643966136,128,386,514
760,-0.645953270361,0.929241202634,009-AIW,0.141643966136,127,358,485
761,-0.645953270361,0.929241202634,009-AIX,0.141643966136,132,598,730
762,-0.645953270361,0.929241202634,009-AIY,0.141643966136,176,457,633
763,-0.645953270361,0.929241202634,009-AIZ,0.141643966136,133,489,622
764,-0.645953270361,0.929241202634,009-AJA,0.141643966136,95,339,434
765,-0.645953270361,0.929241202634,009-AJB,0.141643966136,121,255,376
766,-0.645953270361,0.929241202634,009-AJC,0.141643966136,115,381,496
767,-0.645953270361,0.929241202634,009-AJD,0.141643966136,133,385,518
768,-0.645953270361,0.929241202634,009-AJE,0.141643966136,103,486,589
769,-0.645953270361,0.929241202634,009-AJF,0.141643966136,135,492,627
770,-0.645953270361,0.929241202634,009-AJG,0.141643966136,118,518,636
771,-0.645953270361,0.929241202634,009-AJH,0.141643966136,156,489,645
772,-0.645953270361,0.929241202634,009-AJI,0.141643966136,82,316,398
773,-0.645953270361,0.929241202634,009-AJJ,0.141643966136,71,300,371
774,-0.645953270361,0.929241202634,009-AJK,0.141643966136,115,281,396
775,-0.645953270361,0.929241202634,009-AJL,0.141643966136,285,694,979
776,-0.645953270361,0.929241202634,009-AJM,0.141643966136,102,116,218
777,-0.645953270361,0.929241202634,009-AJN,0.141643966136,108,364,472
778,-0.645953270361,0.929241202634,009-AJO,0.141643966136,89,290,379
779,-0.645953270361,0.929241202634,009-AJP,0.141643966136,140,226,366
780,-0.645953270361,0.929241202634,009-AJQ,0.141643966136,114,309,423
781,-0.645953270361,0.929241202634,009-AJR,0.141643966136,64,38,102
782,-0.645953270361,0.929241202634,009-AJS,0.141643966136,99,336,435
783,-0.645953270361,0.929241202634,009-AJT,0.141643966136,141,452,593
784,-0.645953270361,0.929241202634,009-AJU,0.141643966136,112,395,507
785,-0.645953270361,0.929241202634,009-AJV,0.141643966136,102,386,488
786,-0.645953270361,0.929241202634,009-AJW,0.141643966136,97,339,436
787,-0.645953270361,0.929241202634,009-AJX,0.141643966136,126,655,781
788,-0.645953270361,0.929241202634,009-AJY,0.141643966136,124,428,552
789,-0.645953270361,0.929241202634,009-AJZ,0.141643966136,123,442,565
790,-0.645953270361,0.929241202634,009-AKA,0.141643966136,158,254,412
791,-0.645953270361,0.929241202634,009-AKC,0.141643966136,111,389,500
792,-0.645953270361,0.929241202634,009-AKD,0.141643966136,80,333,413
793,-0.645953270361,0.929241202634,009-AKE,0.141643966136,42,134,176
794,-0.645953270361,0.929241202634,009-AKF,0.141643966136,100,404,504
795,-0.645953270361,0.929241202634,009-AKG,0.141643966136,81,212,293
796,-0.645953270361,0.929241202634,009-AKH,0.141643966136,8,14,22
797,-0.645953270361,0.929241202634,009-AKI,0.141643966136,95,229,324
798,-0.645953270361,0.929241202634,009-AKJ,0.141643966136,82,305,387
799,-0.645953270361,0.929241202634,009-AKK,0.141643966136,134,374,508
800,-0.645953270361,0.929241202634,009-AKL,0.141643966136,88,294,382
801,-0.645953270361,0.929241202634,009-AKM,0.141643966136,114,372,486
802,-0.645953270361,0.929241202634,009-AKN,0.141643966136,134,381,515
803,-0.645953270361,0.929241202634,009-AKO,0.141643966136,78,401,479
804,-0.645953270361,0.929241202634,009-AKP,0.141643966136,68,224,292
805,-0.645953270361,0.929241202634,009-AKQ,0.141643966136,133,445,578
806,-0.645953270361,0.929241202634,009-AKT,0.141643966136,117,217,334
807,-0.645953270361,0.929241202634,009-AKU,0.141643966136,87,96,183
808,-0.645953270361,0.929241202634,009-AKW,0.141643966136,7,39,46
809,-0.645953270361,0.929241202634,009-AKX,0.141643966136,76,286,362
810,-0.645953270361,0.929241202634,009-AKY,0.141643966136,127,526,653
811,-0.645953270361,0.929241202634,009-AKZ,0.141643966136,109,415,524
812,-0.645953270361,0.929241202634,009-ALA,0.141643966136,129,397,526
813,-0.645953270361,0.929241202634,009-ALB,0.141643966136,65,330,395
814,-0.645953270361,0.929241202634,009-ALC,0.141643966136,117,460,577
815,-0.645953270361,0.929241202634,009-ALD,0.141643966136,38,130,168
816,-0.645953270361,0.929241202634,009-ALE,0.141643966136,120,189,309
817,-0.645953270361,0.929241202634,009-ALF,0.141643966136,100,264,364
818,-0.645953270361,0.929241202634,009-ALG,0.141643966136,95,452,547
819,-0.645953270361,0.929241202634,009-ALH,0.141643966136,75,242,317
820,-0.645953270361,0.929241202634,009-ALI,0.141643966136,91,336,427
821,-0.645953270361,0.929241202634,009-ALJ,0.141643966136,122,528,650
822,-0.645953270361,0.929241202634,009-ALK,0.141643966136,148,300,448
823,-0.645953270361,0.929241202634,009-ALL,0.141643966136,116,305,421
824,-0.645953270361,0.929241202634,009-ALM,0.141643966136,62,252,314
825,-0.645953270361,0.929241202634,009-ALN,0.141643966136,58,152,210
826,-0.645953270361,0.929241202634,009-ALO,0.141643966136,52,235,287
827,-0.645953270361,0.929241202634,009-ALP,0.141643966136,148,333,481
828,-0.645953270361,0.929241202634,009-ALQ,0.141643966136,258,482,740
829,-0.645953270361,0.929241202634,009-ALR,0.141643966136,103,228,331
830,-0.645953270361,0.929241202634,009-ALS,0.141643966136,155,652,807
831,-0.645953270361,0.929241202634,009-ALT,0.141643966136,68,450,518
832,-0.645953270361,0.929241202634,009-ALU,0.141643966136,152,749,901
833,-0.645953270361,0.929241202634,009-ALV,0.141643966136,65,218,283
834,-0.645953270361,0.929241202634,009-ALW,0.141643966136,98,337,435
835,-0.645953270361,0.929241202634,009-ALX,0.141643966136,130,424,554
836,-0.645953270361,0.929241202634,009-ALY,0.141643966136,108,304,412
837,-0.645953270361,0.929241202634,009-ALZ,0.141643966136,71,269,340
838,-0.645953270361,0.929241202634,009-AMA,0.141643966136,107,424,531
839,-0.645953270361,0.929241202634,009-AMB,0.141643966136,164,428,592
840,-0.645953270361,0.929241202634,009-AMC,0.141643966136,170,476,646
841,-0.645953270361,0.929241202634,009-AMD,0.141643966136,117,341,458
842,-0.645953270361,0.929241202634,009-AME,0.141643966136,100,343,443
843,-0.645953270361,0.929241202634,009-AMF,0.141643966136,69,147,216
844,-0.645953270361,0.929241202634,010-AAA,0.141643966136,169,359,528
845,-0.645953270361,0.929241202634,010-AAC,0.141643966136,100,246,346
846,-0.645953270361,0.929241202634,010-AAD,0.141643966136,84,174,258
847,-0.645953270361,0.929241202634,010-AAE,0.141643966136,116,166,282
848,-0.645953270361,0.929241202634,010-AAF,0.141643966136,110,201,311
849,-0.645953270361,0.929241202634,010-AAG,0.141643966136,129,232,361
850,-0.645953270361,0.929241202634,010-AAJ,0.141643966136,161,181,342
851,-0.645953270361,0.929241202634,010-AAL,0.141643966136,126,174,300
852,-0.645953270361,0.929241202634,010-AAM,0.141643966136,93,81,174
853,-0.645953270361,0.929241202634,010-AAO,0.141643966136,139,297,436
854,-0.645953270361,0.929241202634,010-AAQ,0.141643966136,175,289,464
855,-0.645953270361,0.929241202634,010-AAR,0.141643966136,101,205,306
856,-0.645953270361,0.929241202634,010-AAS,0.141643966136,94,163,257
857,-0.645953270361,0.929241202634,010-AAV,0.141643966136,76,186,262
858,-0.645953270361,0.929241202634,010-AAW,0.141643966136,99,181,280
859,-0.645953270361,0.929241202634,010-AAX,0.141643966136,161,339,500
860,-0.645953270361,0.929241202634,010-AAY,0.141643966136,146,222,368
861,-0.645953270361,0.929241202634,010-AAZ,0.141643966136,109,209,318
862,-0.645953270361,0.929241202634,010-ABB,0.141643966136,163,201,364
863,-0.645953270361,0.929241202634,010-ABD,0.141643966136,103,200,303
864,-0.645953270361,0.929241202634,010-ABE,0.141643966136,176,286,462
865,-0.645953270361,0.929241202634,010-ABG,0.141643966136,189,262,451
866,-0.645953270361,0.929241202634,010-ABH,0.141643966136,142,203,345
867,-0.645953270361,0.929241202634,010-ABJ,0.141643966136,206,319,525
868,-0.645953270361,0.929241202634,010-ABK,0.141643966136,134,242,376
869,-0.645953270361,0.929241202634,010-ABL,0.141643966136,119,240,359
870,-0.645953270361,0.929241202634,011-AAA,0.141643966136,88,147,235
871,-0.645953270361,0.929241202634,011-AAB,0.141643966136,112,171,283
872,-0.645953270361,0.929241202634,011-AAE,0.141643966136,212,297,509
873,-0.645953270361,0.929241202634,011-AAH,0.141643966136,141,476,617
874,-0.645953270361,0.929241202634,011-AAK,0.141643966136,159,285,444
875,-0.645953270361,0.929241202634,011-AAN,0.141643966136,131,307,438
876,-0.645953270361,0.929241202634,011-AAP,0.141643966136,123,220,343
877,-0.645953270361,0.929241202634,011-AAR,0.141643966136,113,173,286
878,-0.645953270361,0.929241202634,011-AAT,0.141643966136,84,359,443
879,-0.645953270361,0.929241202634,011-AAW,0.141643966136,195,465,660
880,-0.645953270361,0.929241202634,011-AAY,0.141643966136,129,255,384
881,-0.645953270361,0.929241202634,011-ABA,0.141643966136,64,211,275
882,-0.645953270361,0.929241202634,011-ABB,0.141643966136,124,349,473
883,-0.645953270361,0.929241202634,011-ABD,0.141643966136,105,382,487
884,-0.645953270361,0.929241202634,011-ABF,0.141643966136,160,443,603
885,-0.645953270361,0.929241202634,011-ABH,0.141643966136,180,442,622
886,-0.645953270361,0.929241202634,011-ABK,0.141643966136,199,485,684
887,-0.645953270361,0.929241202634,011-ABM,0.141643966136,76,238,314
888,-0.645953270361,0.929241202634,011-ABO,0.141643966136,104,245,349
889,-0.645953270361,0.929241202634,011-ABQ,0.141643966136,97,376,473
890,-0.645953270361,0.929241202634,011-ABR,0.141643966136,100,296,396
891,-0.645953270361,0.929241202634,011-ABS,0.141643966136,122,357,479
892,-0.645953270361,0.929241202634,011-ABT,0.141643966136,102,253,355
893,-0.645953270361,0.929241202634,011-ABU,0.141643966136,131,391,522
894,-0.645953270361,0.929241202634,011-ABV,0.141643966136,178,395,573
895,-0.645953270361,0.929241202634,011-ABW,0.141643966136,139,459,598
896,-0.645953270361,0.929241202634,011-ABY,0.141643966136,148,462,610
897,-0.645953270361,0.929241202634,011-ACA,0.141643966136,115,350,465
898,-0.645953270361,0.929241202634,012-AAA,0.141643966136,181,334,515
899,-0.645953270361,0.929241202634,012-AAB,0.141643966136,177,401,578
900,-0.645953270361,0.929241202634,012-AAE,0.141643966136,157,366,523
901,-0.645953270361,0.929241202634,012-AAG,0.141643966136,181,123,304
902,-0.645953270361,0.929241202634,012-AAH,0.141643966136,84,93,177
903,-0.645953270361,0.929241202634,012-AAI,0.141643966136,138,162,300
904,-0.645953270361,0.929241202634,012-AAJ,0.141643966136,134,153,287
905,-0.645953270361,0.929241202634,012-AAK,0.141643966136,129,173,302
906,-0.645953270361,0.929241202634,012-AAL,0.141643966136,144,111,255
907,-0.645953270361,0.929241202634,012-AAO,0.141643966136,156,138,294
908,-0.645953270361,0.929241202634,012-AAP,0.141643966136,236,183,419
909,-0.645953270361,0.929241202634,012-AAQ,0.141643966136,165,87,252
910,-0.645953270361,0.929241202634,012-AAR,0.141643966136,159,180,339
911,-0.645953270361,0.929241202634,012-AAS,0.141643966136,179,187,366
912,-0.645953270361,0.929241202634,012-AAT,0.141643966136,248,270,518
913,-0.645953270361,0.929241202634,012-ABC,0.141643966136,184,399,583
914,-0.645953270361,0.929241202634,012-ABD,0.141643966136,109,68,177
915,-0.645953270361,0.929241202634,012-ABE,0.141643966136,192,108,300
916,-0.645953270361,0.929241202634,012-ABF,0.141643966136,216,168,384
917,-0.645953270361,0.929241202634,012-ABG,0.141643966136,168,244,412
918,-0.645953270361,0.929241202634,012-ABH,0.141643966136,192,244,436
919,-0.645953270361,0.929241202634,012-ABI,0.141643966136,246,361,607
920,-0.645953270361,0.929241202634,012-ABJ,0.141643966136,229,218,447
921,-0.645953270361,0.929241202634,012-ABK,0.141643966136,194,268,462
922,-0.645953270361,0.929241202634,012-ABX,0.141643966136,175,237,412
923,-0.645953270361,0.929241202634,012-ABZ,0.141643966136,221,341,562
924,-0.645953270361,0.929241202634,012-ACA,0.141643966136,189,236,425
925,-0.645953270361,0.929241202634,012-ACB,0.141643966136,184,192,376
926,-0.645953270361,0.929241202634,012-ACC,0.141643966136,202,347,549
927,-0.645953270361,0.929241202634,012-ACD,0.141643966136,159,359,518
928,-0.645953270361,0.929241202634,012-ACG,0.141643966136,266,75,341
929,-0.645953270361,0.929241202634,012-ACH,0.141643966136,379,83,462
930,-0.645953270361,0.929241202634,012-ACI,0.141643966136,328,48,376
931,-0.645953270361,0.929241202634,012-ACM,0.141643966136,120,86,206
932,-0.645953270361,0.929241202634,012-ACN,0.141643966136,148,166,314
933,-0.645953270361,0.929241202634,012-ACO,0.141643966136,123,197,320
934,-0.645953270361,0.929241202634,012-ACR,0.141643966136,46,128,174
935,-0.645953270361,0.929241202634,012-ACT,0.141643966136,344,45,389
936,-0.645953270361,0.929241202634,012-ACU,0.141643966136,430,45,475
937,-0.645953270361,0.929241202634,012-ACV,0.141643966136,365,55,420
938,-0.645953270361,0.929241202634,012-ADA,0.141643966136,121,370,491
939,-0.645953270361,0.929241202634,012-ADB,0.141643966136,187,366,553
940,-0.645953270361,0.929241202634,012-ADD,0.141643966136,160,313,473
941,-0.645953270361,0.929241202634,012-ADF,0.141643966136,115,326,441
942,-0.645953270361,0.929241202634,012-ADG,0.141643966136,136,322,458
943,-0.645953270361,0.929241202634,012-ADH,0.141643966136,156,309,465
944,-0.645953270361,0.929241202634,012-ADI,0.141643966136,148,360,508
945,-0.645953270361,0.929241202634,012-ADJ,0.141643966136,154,379,533
946,-0.645953270361,0.929241202634,012-ADK,0.141643966136,148,335,483
947,-0.645953270361,0.929241202634,012-ADM,0.141643966136,173,424,597
948,-0.645953270361,0.929241202634,012-ADN,0.141643966136,128,369,497
949,-0.645953270361,0.929241202634,012-ADO,0.141643966136,101,155,256
950,-0.645953270361,0.929241202634,012-ADP,0.141643966136,159,381,540
951,-0.645953270361,0.929241202634,012-ADQ,0.141643966136,210,467,677
952,-0.645953270361,0.929241202634,012-ADS,0.141643966136,101,259,360
953,-0.645953270361,0.929241202634,012-ADV,0.141643966136,173,353,526
954,-0.645953270361,0.929241202634,012-ADW,0.141643966136,237,464,701
955,-0.645953270361,0.929241202634,012-ADZ,0.141643966136,138,262,400
956,-0.645953270361,0.929241202634,012-AEA,0.141643966136,159,418,577
957,-0.645953270361,0.929241202634,012-AEB,0.141643966136,93,252,345
958,-0.645953270361,0.929241202634,012-AED,0.141643966136,187,398,585
959,-0.645953270361,0.929241202634,012-AEF,0.141643966136,79,302,381
960,-0.645953270361,0.929241202634,012-AEG,0.141643966136,161,436,597
961,-0.645953270361,0.929241202634,012-AEI,0.141643966136,167,433,600
962,-0.645953270361,0.929241202634,012-AEK,0.141643966136,175,417,592
963,-0.645953270361,0.929241202634,012-AEM,0.141643966136,207,592,799
964,-0.645953270361,0.929241202634,012-AEN,0.141643966136,105,273,378
965,-0.645953270361,0.929241202634,012-AEP,0.141643966136,112,267,379
966,-0.645953270361,0.929241202634,012-AEQ,0.141643966136,239,547,786
967,-0.645953270361,0.929241202634,012-AER,0.141643966136,130,214,344
968,-0.645953270361,0.929241202634,012-AET,0.141643966136,105,277,382
969,-0.645953270361,0.929241202634,012-AEU,0.141643966136,134,333,467
970,-0.645953270361,0.929241202634,012-AEV,0.141643966136,88,178,266
971,-0.645953270361,0.929241202634,012-AEW,0.141643966136,167,289,456
972,-0.645953270361,0.929241202634,012-AEX,0.141643966136,147,238,385
973,-0.645953270361,0.929241202634,012-AEY,0.141643966136,170,259,429
974,-0.645953270361,0.929241202634,012-AFA,0.141643966136,257,597,854
975,-0.645953270361,0.929241202634,012-AFB,0.141643966136,212,360,572
976,-0.645953270361,0.929241202634,012-AFD,0.141643966136,143,385,528
977,-0.645953270361,0.929241202634,012-AFE,0.141643966136,200,354,554
978,-0.645953270361,0.929241202634,012-AFF,0.141643966136,134,223,357
979,-0.645953270361,0.929241202634,012-AFG,0.141643966136,145,280,425
980,-0.645953270361,0.929241202634,012-AFH,0.141643966136,158,510,668
981,-0.645953270361,0.929241202634,012-AFL,0.141643966136,96,260,356
982,-0.645953270361,0.929241202634,012-AFM,0.141643966136,105,212,317
983,-0.645953270361,0.929241202634,012-AFN,0.141643966136,114,248,362
984,-0.645953270361,0.929241202634,012-AFO,0.141643966136,147,364,511
985,-0.645953270361,0.929241202634,012-AFP,0.141643966136,134,221,355
986,-0.645953270361,0.929241202634,012-AFQ,0.141643966136,179,367,546
987,-0.645953270361,0.929241202634,012-AFR,0.141643966136,146,133,279
988,-0.645953270361,0.929241202634,012-AFW,0.141643966136,160,367,527
989,-0.645953270361,0.929241202634,012-AFX,0.141643966136,146,272,418
990,-0.645953270361,0.929241202634,012-AFY,0.141643966136,86,245,331
991,-0.645953270361,0.929241202634,012-AFZ,0.141643966136,128,238,366
992,-0.645953270361,0.929241202634,012-AGA,0.141643966136,118,241,359
993,-0.645953270361,0.929241202634,012-AGB,0.141643966136,129,239,368
994,-0.645953270361,0.929241202634,012-AGC,0.141643966136,131,252,383
995,-0.645953270361,0.929241202634,012-AGD,0.141643966136,128,205,333
996,-0.645953270361,0.929241202634,012-AGE,0.141643966136,130,253,383
997,-0.645953270361,0.929241202634,012-UAF,0.141643966136,201,578,779
998,-0.645953270361,0.929241202634,013-AAA,0.141643966136,57,127,184
999,-0.645953270361,0.929241202634,013-AAB,0.141643966136,85,406,491
1000,-0.645953270361,0.929241202634,013-AAC,0.141643966136,88,401,489
1001,-0.645953270361,0.929241202634,013-AAD,0.141643966136,104,411,515
1002,-0.645953270361,0.929241202634,013-AAE,0.141643966136,100,305,405
1003,-0.645953270361,0.929241202634,013-AAF,0.141643966136,103,412,515
1004,-0.645953270361,0.929241202634,013-AAG,0.141643966136,106,376,482
1005,-0.645953270361,0.929241202634,013-AAH,0.141643966136,53,164,217
1006,-0.645953270361,0.929241202634,013-AAI,0.141643966136,120,450,570
1007,-0.645953270361,0.929241202634,013-AAJ,0.141643966136,60,308,368
1008,-0.645953270361,0.929241202634,013-AAK,0.141643966136,39,176,215
1009,-0.645953270361,0.929241202634,013-AAL,0.141643966136,111,411,522
1010,-0.645953270361,0.929241202634,013-AAM,0.141643966136,134,466,600
1011,-0.645953270361,0.929241202634,013-AAN,0.141643966136,60,149,209
1012,-0.645953270361,0.929241202634,013-AAO,0.141643966136,88,287,375
1013,-0.645953270361,0.929241202634,013-AAP,0.141643966136,46,152,198
1014,-0.645953270361,0.929241202634,013-AAQ,0.141643966136,35,108,143
1015,-0.645953270361,0.929241202634,013-AAR,0.141643966136,31,123,154
1016,-0.645953270361,0.929241202634,013-AAS,0.141643966136,48,167,215
1017,-0.645953270361,0.929241202634,013-AAT,0.141643966136,62,163,225
1018,-0.645953270361,0.929241202634,013-AAU,0.141643966136,68,226,294
1019,-0.645953270361,0.929241202634,013-AAV,0.141643966136,82,279,361
1020,-0.645953270361,0.929241202634,013-AAZ,0.141643966136,29,135,164
1021,-0.645953270361,0.929241202634,013-ABA,0.141643966136,67,261,328
1022,-0.645953270361,0.929241202634,013-ABB,0.141643966136,26,130,156
1023,-0.645953270361,0.929241202634,013-ABC,0.141643966136,54,325,379
1024,-0.645953270361,0.929241202634,013-ABD,0.141643966136,97,366,463
1025,-0.645953270361,0.929241202634,013-ABE,0.141643966136,35,139,174
1026,-0.645953270361,0.929241202634,013-ABF,0.141643966136,43,201,244
1027,-0.645953270361,0.929241202634,013-ABG,0.141643966136,38,185,223
1028,-0.645953270361,0.929241202634,013-ABH,0.141643966136,43,165,208
1029,-0.645953270361,0.929241202634,013-ABI,0.141643966136,54,234,288
1030,-0.645953270361,0.929241202634,013-ABJ,0.141643966136,41,222,263
1031,-0.645953270361,0.929241202634,013-ABK,0.141643966136,104,355,459
1032,-0.645953270361,0.929241202634,013-ABL,0.141643966136,63,189,252
1033,-0.645953270361,0.929241202634,013-ABM,0.141643966136,95,450,545
1034,-0.645953270361,0.929241202634,013-ABN,0.141643966136,44,275,319
1035,-0.645953270361,0.929241202634,013-ABO,0.141643966136,35,204,239
1036,-0.645953270361,0.929241202634,013-ABP,0.141643966136,54,331,385
1037,-0.645953270361,0.929241202634,013-ABQ,0.141643966136,82,242,324
1038,-0.645953270361,0.929241202634,013-ABR,0.141643966136,57,287,344
1039,-0.645953270361,0.929241202634,013-ABS,0.141643966136,41,83,124
1040,-0.645953270361,0.929241202634,013-ABT,0.141643966136,80,358,438
1041,-0.645953270361,0.929241202634,013-ABU,0.141643966136,75,371,446
1042,-0.645953270361,0.929241202634,013-ABV,0.141643966136,60,296,356
1043,-0.645953270361,0.929241202634,013-ABW,0.141643966136,30,200,230
1044,-0.645953270361,0.929241202634,013-ABX,0.141643966136,69,283,352
1045,-0.645953270361,0.929241202634,013-ABY,0.141643966136,65,221,286
1046,-0.645953270361,0.929241202634,013-ABZ,0.141643966136,30,124,154
1047,-0.645953270361,0.929241202634,013-ACA,0.141643966136,139,473,612
1048,-0.645953270361,0.929241202634,013-ACB,0.141643966136,139,480,619
1049,-0.645953270361,0.929241202634,013-ACC,0.141643966136,63,244,307
1050,-0.645953270361,0.929241202634,013-ACD,0.141643966136,65,375,440
1051,-0.645953270361,0.929241202634,013-ACE,0.141643966136,51,165,216
1052,-0.645953270361,0.929241202634,013-ACF,0.141643966136,50,226,276
1053,-0.645953270361,0.929241202634,013-ACG,0.141643966136,31,191,222
1054,-0.645953270361,0.929241202634,013-ACH,0.141643966136,41,141,182
1055,-0.645953270361,0.929241202634,013-ACI,0.141643966136,37,191,228
1056,-0.645953270361,0.929241202634,013-ACJ,0.141643966136,39,190,229
1057,-0.645953270361,0.929241202634,013-ACK,0.141643966136,88,326,414
1058,-0.645953270361,0.929241202634,013-ACL,0.141643966136,67,364,431
1059,-0.645953270361,0.929241202634,013-ACM,0.141643966136,57,322,379
1060,-0.645953270361,0.929241202634,013-ACN,0.141643966136,99,338,437
1061,-0.645953270361,0.929241202634,013-ACO,0.141643966136,77,294,371
1062,-0.645953270361,0.929241202634,013-ACP,0.141643966136,38,149,187
1063,-0.645953270361,0.929241202634,013-ACQ,0.141643966136,43,187,230
1064,-0.645953270361,0.929241202634,013-ACR,0.141643966136,77,303,380
1065,-0.645953270361,0.929241202634,013-ACS,0.141643966136,71,347,418
1066,-0.645953270361,0.929241202634,013-ACT,0.141643966136,32,160,192
1067,-0.645953270361,0.929241202634,013-ACU,0.141643966136,34,95,129
1068,-0.645953270361,0.929241202634,013-ACV,0.141643966136,47,234,281
1069,-0.645953270361,0.929241202634,013-ACW,0.141643966136,47,213,260
1070,-0.645953270361,0.929241202634,013-ACX,0.141643966136,65,239,304
1071,-0.645953270361,0.929241202634,013-ACY,0.141643966136,74,372,446
1072,-0.645953270361,0.929241202634,013-ACZ,0.141643966136,131,632,763
1073,-0.645953270361,0.929241202634,013-ADA,0.141643966136,121,703,824
1074,-0.645953270361,0.929241202634,013-ADB,0.141643966136,24,103,127
1075,-0.645953270361,0.929241202634,013-ADC,0.141643966136,43,163,206
1076,-0.645953270361,0.929241202634,013-ADD,0.141643966136,39,173,212
1077,-0.645953270361,0.929241202634,013-ADE,0.141643966136,33,152,185
1078,-0.645953270361,0.929241202634,013-ADF,0.141643966136,95,374,469
1079,-0.645953270361,0.929241202634,013-ADG,0.141643966136,63,204,267
1080,-0.645953270361,0.929241202634,013-ADH,0.141643966136,47,134,181
1081,-0.645953270361,0.929241202634,013-ADI,0.141643966136,12,71,83
1082,-0.645953270361,0.929241202634,013-ADJ,0.141643966136,25,84,109
1083,-0.645953270361,0.929241202634,013-ADK,0.141643966136,25,164,189
1084,-0.645953270361,0.929241202634,013-ADL,0.141643966136,62,216,278
1085,-0.645953270361,0.929241202634,013-ADM,0.141643966136,49,146,195
1086,-0.645953270361,0.929241202634,013-ADN,0.141643966136,58,222,280
1087,-0.645953270361,0.929241202634,013-ADO,0.141643966136,68,163,231
1088,-0.645953270361,0.929241202634,013-ADP,0.141643966136,40,111,151
1089,-0.645953270361,0.929241202634,013-ADQ,0.141643966136,56,193,249
1090,-0.645953270361,0.929241202634,013-ADR,0.141643966136,53,261,314
1091,-0.645953270361,0.929241202634,013-ADS,0.141643966136,149,701,850
1092,-0.645953270361,0.929241202634,013-ADT,0.141643966136,73,219,292
1093,-0.645953270361,0.929241202634,013-ADU,0.141643966136,45,220,265
1094,-0.645953270361,0.929241202634,013-ADV,0.141643966136,84,445,529
1095,-0.645953270361,0.929241202634,013-ADW,0.141643966136,63,255,318
1096,-0.645953270361,0.929241202634,013-ADX,0.141643966136,63,312,375
1097,-0.645953270361,0.929241202634,013-ADY,0.141643966136,11,73,84
1098,-0.645953270361,0.929241202634,013-ADZ,0.141643966136,97,470,567
1099,-0.645953270361,0.929241202634,013-AEA,0.141643966136,62,280,342
1100,-0.645953270361,0.929241202634,013-AEB,0.141643966136,76,279,355
1101,-0.645953270361,0.929241202634,013-AEC,0.141643966136,35,165,200
1102,-0.645953270361,0.929241202634,013-AED,0.141643966136,71,263,334
1103,-0.645953270361,0.929241202634,013-AEE,0.141643966136,53,149,202
1104,-0.645953270361,0.929241202634,013-AEF,0.141643966136,37,188,225
1105,-0.645953270361,0.929241202634,013-AEG,0.141643966136,71,286,357
1106,-0.645953270361,0.929241202634,013-AEH,0.141643966136,62,313,375
1107,-0.645953270361,0.929241202634,013-AEI,0.141643966136,36,128,164
1108,-0.645953270361,0.929241202634,013-AEJ,0.141643966136,63,314,377
1109,-0.645953270361,0.929241202634,013-AEK,0.141643966136,63,242,305
1110,-0.645953270361,0.929241202634,013-AEL,0.141643966136,34,177,211
1111,-0.645953270361,0.929241202634,013-AEM,0.141643966136,48,258,306
1112,-0.645953270361,0.929241202634,013-AEN,0.141643966136,34,153,187
1113,-0.645953270361,0.929241202634,013-AEO,0.141643966136,64,220,284
1114,-0.645953270361,0.929241202634,013-AEP,0.141643966136,51,232,283
1115,-0.645953270361,0.929241202634,013-AEQ,0.141643966136,39,156,195
1116,-0.645953270361,0.929241202634,013-AER,0.141643966136,25,170,195
1117,-0.645953270361,0.929241202634,013-AES,0.141643966136,59,253,312
1118,-0.645953270361,0.929241202634,013-AET,0.141643966136,66,390,456
1119,-0.645953270361,0.929241202634,013-AEU,0.141643966136,53,162,215
1120,-0.645953270361,0.929241202634,013-AEV,0.141643966136,53,231,284
1121,-0.645953270361,0.929241202634,013-AEW,0.141643966136,22,92,114
1122,-0.645953270361,0.929241202634,013-AEX,0.141643966136,49,169,218
1123,-0.645953270361,0.929241202634,013-AEY,0.141643966136,74,455,529
1124,-0.645953270361,0.929241202634,013-AEZ,0.141643966136,43,144,187
1125,-0.645953270361,0.929241202634,013-AFA,0.141643966136,99,321,420
1126,-0.645953270361,0.929241202634,013-AFB,0.141643966136,98,358,456
1127,-0.645953270361,0.929241202634,013-AFC,0.141643966136,68,275,343
1128,-0.645953270361,0.929241202634,013-AFD,0.141643966136,92,348,440
1129,-0.645953270361,0.929241202634,013-AFE,0.141643966136,88,456,544
1130,-0.645953270361,0.929241202634,013-AFF,0.141643966136,60,260,320
1131,-0.645953270361,0.929241202634,013-AFG,0.141643966136,105,481,586
1132,-0.645953270361,0.929241202634,013-AFH,0.141643966136,88,410,498
1133,-0.645953270361,0.929241202634,013-AFI,0.141643966136,34,141,175
1134,-0.645953270361,0.929241202634,013-AFJ,0.141643966136,94,483,577
1135,-0.645953270361,0.929241202634,013-AFK,0.141643966136,37,153,190
1136,-0.645953270361,0.929241202634,013-AFL,0.141643966136,24,92,116
1137,-0.645953270361,0.929241202634,013-AFM,0.141643966136,51,216,267
1138,-0.645953270361,0.929241202634,013-AFO,0.141643966136,78,248,326
1139,-0.645953270361,0.929241202634,013-AFP,0.141643966136,39,172,211
1140,-0.645953270361,0.929241202634,013-AFQ,0.141643966136,67,275,342
1141,-0.645953270361,0.929241202634,013-AFR,0.141643966136,70,194,264
1142,-0.645953270361,0.929241202634,013-AFS,0.141643966136,93,248,341
1143,-0.645953270361,0.929241202634,013-AFT,0.141643966136,69,241,310
1144,-0.645953270361,0.929241202634,013-AFU,0.141643966136,93,226,319
1145,-0.645953270361,0.929241202634,013-AFV,0.141643966136,51,201,252
1146,-0.645953270361,0.929241202634,013-AFW,0.141643966136,66,219,285
1147,-0.645953270361,0.929241202634,013-AFX,0.141643966136,37,131,168
1148,-0.645953270361,0.929241202634,013-AFY,0.141643966136,56,145,201
1149,-0.645953270361,0.929241202634,013-AGA,0.141643966136,56,242,298
1150,-0.645953270361,0.929241202634,013-AGC,0.141643966136,74,203,277
1151,-0.645953270361,0.929241202634,013-AGD,0.141643966136,95,378,473
1152,-0.645953270361,0.929241202634,013-AGE,0.141643966136,77,295,372
1153,-0.645953270361,0.929241202634,013-AGG,0.141643966136,51,121,172
1154,-0.645953270361,0.929241202634,013-AGH,0.141643966136,63,189,252
1155,-0.645953270361,0.929241202634,013-AGI,0.141643966136,62,234,296
1156,-0.645953270361,0.929241202634,013-AGJ,0.141643966136,122,471,593
1157,-0.645953270361,0.929241202634,013-AGK,0.141643966136,30,95,125
1158,-0.645953270361,0.929241202634,013-AGL,0.141643966136,84,293,377
1159,-0.645953270361,0.929241202634,013-AGM,0.141643966136,65,213,278
1160,-0.645953270361,0.929241202634,013-AGN,0.141643966136,55,201,256
1161,-0.645953270361,0.929241202634,013-AGO,0.141643966136,64,252,316
1162,-0.645953270361,0.929241202634,013-AGP,0.141643966136,19,69,88
1163,-0.645953270361,0.929241202634,013-AGQ,0.141643966136,86,252,338
1164,-0.645953270361,0.929241202634,013-AGR,0.141643966136,40,99,139
1165,-0.645953270361,0.929241202634,013-AGS,0.141643966136,62,123,185
1166,-0.645953270361,0.929241202634,013-AGT,0.141643966136,21,60,81
1167,-0.645953270361,0.929241202634,013-AGU,0.141643966136,42,170,212
1168,-0.645953270361,0.929241202634,013-AGV,0.141643966136,49,281,330
1169,-0.645953270361,0.929241202634,013-AGW,0.141643966136,33,182,215
1170,-0.645953270361,0.929241202634,013-AGX,0.141643966136,53,176,229
1171,-0.645953270361,0.929241202634,013-AGY,0.141643966136,52,226,278
1172,-0.645953270361,0.929241202634,013-AGZ,0.141643966136,58,287,345
1173,-0.645953270361,0.929241202634,013-AHA,0.141643966136,46,207,253
1174,-0.645953270361,0.929241202634,013-AHB,0.141643966136,55,198,253
1175,-0.645953270361,0.929241202634,013-AHC,0.141643966136,43,216,259
1176,-0.645953270361,0.929241202634,013-AHD,0.141643966136,37,129,166
1177,-0.645953270361,0.929241202634,013-AHE,0.141643966136,29,135,164
1178,-0.645953270361,0.929241202634,013-AHF,0.141643966136,50,202,252
1179,-0.645953270361,0.929241202634,013-AHG,0.141643966136,63,150,213
1180,-0.645953270361,0.929241202634,013-AHH,0.141643966136,57,165,222
1181,-0.645953270361,0.929241202634,013-AHI,0.141643966136,38,78,116
1182,-0.645953270361,0.929241202634,013-AHJ,0.141643966136,60,108,168
1183,-0.645953270361,0.929241202634,013-AHK,0.141643966136,81,230,311
1184,-0.645953270361,0.929241202634,013-AHL,0.141643966136,63,150,213
1185,-0.645953270361,0.929241202634,013-AHM,0.141643966136,112,266,378
1186,-0.645953270361,0.929241202634,013-AHN,0.141643966136,99,416,515
1187,-0.645953270361,0.929241202634,013-AHO,0.141643966136,62,87,149
1188,-0.645953270361,0.929241202634,013-AHP,0.141643966136,140,487,627
1189,-0.645953270361,0.929241202634,013-AHQ,0.141643966136,90,251,341
1190,-0.645953270361,0.929241202634,013-AHR,0.141643966136,60,352,412
1191,-0.645953270361,0.929241202634,013-AHS,0.141643966136,58,274,332
1192,-0.645953270361,0.929241202634,013-AHT,0.141643966136,97,337,434
1193,-0.645953270361,0.929241202634,013-AHU,0.141643966136,73,421,494
1194,-0.645953270361,0.929241202634,013-AHV,0.141643966136,105,635,740
1195,-0.645953270361,0.929241202634,013-AHW,0.141643966136,78,346,424
1196,-0.645953270361,0.929241202634,013-AHX,0.141643966136,49,382,431
1197,-0.645953270361,0.929241202634,013-AHY,0.141643966136,72,293,365
1198,-0.645953270361,0.929241202634,014-AAA,0.141643966136,72,212,284
1199,-0.645953270361,0.929241202634,014-AAB,0.141643966136,90,353,443
1200,-0.645953270361,0.929241202634,014-AAE,0.141643966136,88,152,240
1201,-0.645953270361,0.929241202634,014-AAF,0.141643966136,80,121,201
1202,-0.645953270361,0.929241202634,014-AAI,0.141643966136,73,201,274
1203,-0.645953270361,0.929241202634,014-AAJ,0.141643966136,132,344,476
1204,-0.645953270361,0.929241202634,014-AAM,0.141643966136,71,169,240
1205,-0.645953270361,0.929241202634,014-AAN,0.141643966136,123,272,395
1206,-0.645953270361,0.929241202634,014-AAQ,0.141643966136,59,300,359
1207,-0.645953270361,0.929241202634,014-AAS,0.141643966136,84,322,406
1208,-0.645953270361,0.929241202634,014-AAU,0.141643966136,75,387,462
1209,-0.645953270361,0.929241202634,014-AAW,0.141643966136,11,77,88
1210,-0.645953270361,0.929241202634,014-AAY,0.141643966136,65,162,227
1211,-0.645953270361,0.929241202634,014-ABA,0.141643966136,42,266,308
1212,-0.645953270361,0.929241202634,014-ABB,0.141643966136,20,17,37
1213,-0.645953270361,0.929241202634,014-ABC,0.141643966136,75,260,335
1214,-0.645953270361,0.929241202634,014-ABD,0.141643966136,16,40,56
1215,-0.645953270361,0.929241202634,014-ABE,0.141643966136,74,345,419
1216,-0.645953270361,0.929241202634,014-ABG,0.141643966136,56,227,283
1217,-0.645953270361,0.929241202634,014-ABI,0.141643966136,36,161,197
1218,-0.645953270361,0.929241202634,014-ABJ,0.141643966136,76,377,453
1219,-0.645953270361,0.929241202634,014-ABK,0.141643966136,63,227,290
1220,-0.645953270361,0.929241202634,014-ABM,0.141643966136,87,241,328
1221,-0.645953270361,0.929241202634,014-ABN,0.141643966136,64,167,231
1222,-0.645953270361,0.929241202634,014-ABQ,0.141643966136,58,268,326
1223,-0.645953270361,0.929241202634,014-ABR,0.141643966136,115,458,573
1224,-0.645953270361,0.929241202634,014-ABS,0.141643966136,23,92,115
1225,-0.645953270361,0.929241202634,014-ABT,0.141643966136,53,312,365
1226,-0.645953270361,0.929241202634,014-ABU,0.141643966136,62,266,328
1227,-0.645953270361,0.929241202634,014-ABW,0.141643966136,38,203,241
1228,-0.645953270361,0.929241202634,014-ABX,0.141643966136,25,142,167
1229,-0.645953270361,0.929241202634,014-ABY,0.141643966136,89,322,411
1230,-0.645953270361,0.929241202634,014-ABZ,0.141643966136,69,367,436
1231,-0.645953270361,0.929241202634,014-ACA,0.141643966136,81,239,320
1232,-0.645953270361,0.929241202634,014-ACB,0.141643966136,65,279,344
1233,-0.645953270361,0.929241202634,014-ACC,0.141643966136,75,296,371
1234,-0.645953270361,0.929241202634,014-ACD,0.141643966136,79,342,421
1235,-0.645953270361,0.929241202634,014-ACE,0.141643966136,63,244,307
1236,-0.645953270361,0.929241202634,015-AAA,0.141643966136,117,100,217
1237,-0.645953270361,0.929241202634,015-AAB,0.141643966136,161,120,281
1238,-0.645953270361,0.929241202634,015-AAF,0.141643966136,31,30,61
1239,-0.645953270361,0.929241202634,015-AAG,0.141643966136,76,81,157
1240,-0.645953270361,0.929241202634,015-AAH,0.141643966136,147,115,262
1241,-0.645953270361,0.929241202634,015-AAK,0.141643966136,118,216,334
1242,-0.645953270361,0.929241202634,015-AAL,0.141643966136,126,106,232
1243,-0.645953270361,0.929241202634,015-AAM,0.141643966136,39,35,74
1244,-0.645953270361,0.929241202634,015-AAP,0.141643966136,88,36,124
1245,-0.645953270361,0.929241202634,015-AAQ,0.141643966136,160,176,336
1246,-0.645953270361,0.929241202634,015-AAS,0.141643966136,139,165,304
1247,-0.645953270361,0.929241202634,015-AAU,0.141643966136,100,144,244
1248,-0.645953270361,0.929241202634,015-AAW,0.141643966136,128,167,295
1249,-0.645953270361,0.929241202634,015-AAX,0.141643966136,172,270,442
1250,-0.645953270361,0.929241202634,015-ABA,0.141643966136,106,100,206
1251,-0.645953270361,0.929241202634,015-ABB,0.141643966136,174,291,465
1252,-0.645953270361,0.929241202634,015-ABC,0.141643966136,147,248,395
1253,-0.645953270361,0.929241202634,015-ABE,0.141643966136,115,123,238
1254,-0.645953270361,0.929241202634,015-ABF,0.141643966136,210,321,531
1255,-0.645953270361,0.929241202634,015-ABI,0.141643966136,98,89,187
1256,-0.645953270361,0.929241202634,015-ABJ,0.141643966136,203,308,511
1257,-0.645953270361,0.929241202634,015-ABL,0.141643966136,102,204,306
1258,-0.645953270361,0.929241202634,015-ABM,0.141643966136,105,216,321
1259,-0.645953270361,0.929241202634,015-ABN,0.141643966136,240,378,618
1260,-0.645953270361,0.929241202634,015-ABQ,0.141643966136,82,33,115
1261,-0.645953270361,0.929241202634,015-ABR,0.141643966136,226,104,330
1262,-0.645953270361,0.929241202634,015-ABV,0.141643966136,164,94,258
1263,-0.645953270361,0.929241202634,015-ABX,0.141643966136,99,311,410
1264,-0.645953270361,0.929241202634,015-ABY,0.141643966136,117,361,478
1265,-0.645953270361,0.929241202634,015-ABZ,0.141643966136,100,326,426
1266,-0.645953270361,0.929241202634,015-ACB,0.141643966136,124,238,362
1267,-0.645953270361,0.929241202634,015-ACC,0.141643966136,132,184,316
1268,-0.645953270361,0.929241202634,015-ACD,0.141643966136,113,210,323
1269,-0.645953270361,0.929241202634,015-ACE,0.141643966136,172,218,390
1270,-0.645953270361,0.929241202634,015-ACH,0.141643966136,86,113,199
1271,-0.645953270361,0.929241202634,015-ACI,0.141643966136,70,117,187
1272,-0.645953270361,0.929241202634,015-ACJ,0.141643966136,106,193,299
1273,-0.645953270361,0.929241202634,015-ACK,0.141643966136,119,211,330
1274,-0.645953270361,0.929241202634,015-ACM,0.141643966136,100,206,306
1275,-0.645953270361,0.929241202634,015-ACN,0.141643966136,107,268,375
1276,-0.645953270361,0.929241202634,015-ACP,0.141643966136,92,194,286
1277,-0.645953270361,0.929241202634,015-ACQ,0.141643966136,120,251,371
1278,-0.645953270361,0.929241202634,015-ACR,0.141643966136,104,263,367
1279,-0.645953270361,0.929241202634,015-ACS,0.141643966136,197,257,454
1280,-0.645953270361,0.929241202634,015-ACT,0.141643966136,102,201,303
1281,-0.645953270361,0.929241202634,015-ACU,0.141643966136,191,453,644
1282,-0.645953270361,0.929241202634,015-ACV,0.141643966136,132,240,372
1283,-0.645953270361,0.929241202634,015-ACZ,0.141643966136,101,182,283
1284,-0.645953270361,0.929241202634,015-ADB,0.141643966136,134,285,419
1285,-0.645953270361,0.929241202634,015-ADC,0.141643966136,193,321,514
1286,-0.645953270361,0.929241202634,015-ADD,0.141643966136,85,193,278
1287,-0.645953270361,0.929241202634,015-ADF,0.141643966136,107,248,355
1288,-0.645953270361,0.929241202634,015-ADG,0.141643966136,113,299,412
1289,-0.645953270361,0.929241202634,015-ADH,0.141643966136,78,197,275
1290,-0.645953270361,0.929241202634,015-ADI,0.141643966136,105,310,415
1291,-0.645953270361,0.929241202634,015-ADJ,0.141643966136,92,167,259
1292,-0.645953270361,0.929241202634,015-ADL,0.141643966136,143,269,412
1293,-0.645953270361,0.929241202634,015-ADM,0.141643966136,133,192,325
1294,-0.645953270361,0.929241202634,015-ADN,0.141643966136,172,159,331
1295,-0.645953270361,0.929241202634,015-ADO,0.141643966136,131,186,317
1296,-0.645953270361,0.929241202634,015-ADP,0.141643966136,148,199,347
1297,-0.645953270361,0.929241202634,015-ADQ,0.141643966136,186,213,399
1298,-0.645953270361,0.929241202634,015-ADR,0.141643966136,114,244,358
1299,-0.645953270361,0.929241202634,015-ADS,0.141643966136,123,171,294
1300,-0.645953270361,0.929241202634,015-ADU,0.141643966136,98,262,360
1301,-0.645953270361,0.929241202634,015-ADW,0.141643966136,90,213,303
1302,-0.645953270361,0.929241202634,015-ADX,0.141643966136,152,266,418
1303,-0.645953270361,0.929241202634,015-ADY,0.141643966136,157,263,420
1304,-0.645953270361,0.929241202634,015-ADZ,0.141643966136,118,196,314
1305,-0.645953270361,0.929241202634,015-AEA,0.141643966136,105,155,260
1306,-0.645953270361,0.929241202634,015-AED,0.141643966136,114,228,342
1307,-0.645953270361,0.929241202634,015-AEF,0.141643966136,186,242,428
1308,-0.645953270361,0.929241202634,015-AEG,0.141643966136,87,116,203
1309,-0.645953270361,0.929241202634,015-AEH,0.141643966136,132,165,297
1310,-0.645953270361,0.929241202634,015-AEI,0.141643966136,131,167,298
1311,-0.645953270361,0.929241202634,015-AEJ,0.141643966136,101,113,214
1312,-0.645953270361,0.929241202634,015-AEK,0.141643966136,170,339,509
1313,-0.645953270361,0.929241202634,015-AEL,0.141643966136,143,172,315
1314,-0.645953270361,0.929241202634,015-AEM,0.141643966136,161,314,475
1315,-0.645953270361,0.929241202634,015-AEN,0.141643966136,148,254,402
1316,-0.645953270361,0.929241202634,015-AEO,0.141643966136,131,235,366
1317,-0.645953270361,0.929241202634,015-AEQ,0.141643966136,184,188,372
1318,-0.645953270361,0.929241202634,015-AER,0.141643966136,133,128,261
1319,-0.645953270361,0.929241202634,015-AET,0.141643966136,141,204,345
1320,-0.645953270361,0.929241202634,015-AEU,0.141643966136,169,248,417
1321,-0.645953270361,0.929241202634,015-AEV,0.141643966136,152,251,403
1322,-0.645953270361,0.929241202634,015-AEW,0.141643966136,100,244,344
1323,-0.645953270361,0.929241202634,015-AEY,0.141643966136,97,163,260
1324,-0.645953270361,0.929241202634,015-AEZ,0.141643966136,128,133,261
1325,-0.645953270361,0.929241202634,015-AFB,0.141643966136,122,163,285
1326,-0.645953270361,0.929241202634,015-AFC,0.141643966136,99,209,308
1327,-0.645953270361,0.929241202634,015-AFD,0.141643966136,116,241,357
1328,-0.645953270361,0.929241202634,015-AFE,0.141643966136,66,180,246
1329,-0.645953270361,0.929241202634,015-AFF,0.141643966136,240,244,484
1330,-0.645953270361,0.929241202634,015-AFH,0.141643966136,121,112,233
1331,-0.645953270361,0.929241202634,016-AAA,0.141643966136,100,145,245
1332,-0.645953270361,0.929241202634,016-AAB,0.141643966136,182,153,335
1333,-0.645953270361,0.929241202634,016-AAD,0.141643966136,154,211,365
1334,-0.645953270361,0.929241202634,016-AAE,0.141643966136,161,135,296
1335,-0.645953270361,0.929241202634,016-AAG,0.141643966136,202,267,469
1336,-0.645953270361,0.929241202634,016-AAI,0.141643966136,145,253,398
1337,-0.645953270361,0.929241202634,016-AAJ,0.141643966136,90,192,282
1338,-0.645953270361,0.929241202634,016-AAK,0.141643966136,101,120,221
1339,-0.645953270361,0.929241202634,016-AAL,0.141643966136,181,289,470
1340,-0.645953270361,0.929241202634,016-AAN,0.141643966136,93,291,384
1341,-0.645953270361,0.929241202634,016-AAP,0.141643966136,110,277,387
1342,-0.645953270361,0.929241202634,016-AAQ,0.141643966136,133,324,457
1343,-0.645953270361,0.929241202634,016-AAR,0.141643966136,93,268,361
1344,-0.645953270361,0.929241202634,016-AAS,0.141643966136,43,148,191
1345,-0.645953270361,0.929241202634,016-AAT,0.141643966136,239,376,615
1346,-0.645953270361,0.929241202634,016-AAU,0.141643966136,217,477,694
1347,-0.645953270361,0.929241202634,016-AAW,0.141643966136,224,465,689
1348,-0.645953270361,0.929241202634,016-AAY,0.141643966136,261,591,852
1349,-0.645953270361,0.929241202634,016-ABA,0.141643966136,284,382,666
1350,-0.645953270361,0.929241202634,016-ABE,0.141643966136,113,133,246
1351,-0.645953270361,0.929241202634,016-ABF,0.141643966136,193,377,570
1352,-0.645953270361,0.929241202634,016-ABG,0.141643966136,82,319,401
1353,-0.645953270361,0.929241202634,016-ABH,0.141643966136,184,207,391
1354,-0.645953270361,0.929241202634,016-ABI,0.141643966136,293,358,651
1355,-0.645953270361,0.929241202634,016-ABQ,0.141643966136,220,460,680
1356,-0.645953270361,0.929241202634,017-AAA,0.141643966136,86,144,230
1357,-0.645953270361,0.929241202634,017-AAB,0.141643966136,114,169,283
1358,-0.645953270361,0.929241202634,017-AAE,0.141643966136,135,224,359
1359,-0.645953270361,0.929241202634,017-AAF,0.141643966136,108,313,421
1360,-0.645953270361,0.929241202634,017-AAJ,0.141643966136,120,246,366
1361,-0.645953270361,0.929241202634,017-AAK,0.141643966136,94,253,347
1362,-0.645953270361,0.929241202634,017-AAN,0.141643966136,152,378,530
1363,-0.645953270361,0.929241202634,017-AAP,0.141643966136,108,229,337
1364,-0.645953270361,0.929241202634,017-AAQ,0.141643966136,105,247,352
1365,-0.645953270361,0.929241202634,017-AAT,0.141643966136,166,253,419
1366,-0.645953270361,0.929241202634,017-AAV,0.141643966136,61,77,138
1367,-0.645953270361,0.929241202634,017-AAW,0.141643966136,96,165,261
1368,-0.645953270361,0.929241202634,017-AAY,0.141643966136,129,170,299
1369,-0.645953270361,0.929241202634,017-ABB,0.141643966136,106,282,388
1370,-0.645953270361,0.929241202634,017-ABC,0.141643966136,141,241,382
1371,-0.645953270361,0.929241202634,017-ABF,0.141643966136,94,151,245
1372,-0.645953270361,0.929241202634,017-ABI,0.141643966136,105,110,215
1373,-0.645953270361,0.929241202634,017-ABK,0.141643966136,103,142,245
1374,-0.645953270361,0.929241202634,017-ABM,0.141643966136,77,186,263
1375,-0.645953270361,0.929241202634,017-ABO,0.141643966136,108,159,267
1376,-0.645953270361,0.929241202634,017-ABP,0.141643966136,146,246,392
1377,-0.645953270361,0.929241202634,017-ABR,0.141643966136,57,183,240
1378,-0.645953270361,0.929241202634,017-ABS,0.141643966136,75,296,371
1379,-0.645953270361,0.929241202634,017-ABT,0.141643966136,47,242,289
1380,-0.645953270361,0.929241202634,017-ABU,0.141643966136,100,442,542
1381,-0.645953270361,0.929241202634,017-ABX,0.141643966136,37,163,200
1382,-0.645953270361,0.929241202634,017-ABY,0.141643966136,89,385,474
1383,-0.645953270361,0.929241202634,017-ACA,0.141643966136,48,74,122
1384,-0.645953270361,0.929241202634,017-ACB,0.141643966136,101,243,344
1385,-0.645953270361,0.929241202634,017-ACC,0.141643966136,56,227,283
1386,-0.645953270361,0.929241202634,017-ACD,0.141643966136,128,448,576
1387,-0.645953270361,0.929241202634,017-ACF,0.141643966136,32,198,230
1388,-0.645953270361,0.929241202634,017-ACH,0.141643966136,143,305,448
1389,-0.645953270361,0.929241202634,017-ACJ,0.141643966136,100,235,335
1390,-0.645953270361,0.929241202634,017-ACK,0.141643966136,47,126,173
1391,-0.645953270361,0.929241202634,017-ACL,0.141643966136,35,107,142
1392,-0.645953270361,0.929241202634,017-ACM,0.141643966136,52,183,235
1393,-0.645953270361,0.929241202634,017-ACO,0.141643966136,128,337,465
1394,-0.645953270361,0.929241202634,017-ACR,0.141643966136,86,241,327
1395,-0.645953270361,0.929241202634,017-SCN,0.141643966136,67,215,282
1396,-0.645953270361,0.929241202634,018-AAA,0.141643966136,224,350,574
1397,-0.645953270361,0.929241202634,018-AAB,0.141643966136,222,293,515
1398,-0.645953270361,0.929241202634,018-AAD,0.141643966136,253,395,648
1399,-0.645953270361,0.929241202634,018-AAH,0.141643966136,253,397,650
1400,-0.645953270361,0.929241202634,018-AAI,0.141643966136,200,294,494
1401,-0.645953270361,0.929241202634,018-AAL,0.141643966136,257,359,616
1402,-0.645953270361,0.929241202634,018-AAQ,0.141643966136,175,454,629
1403,-0.645953270361,0.929241202634,018-AAR,0.141643966136,200,403,603
1404,-0.645953270361,0.929241202634,018-AAS,0.141643966136,207,465,672
1405,-0.645953270361,0.929241202634,018-AAV,0.141643966136,210,490,700
1406,-0.645953270361,0.929241202634,018-AAZ,0.141643966136,200,509,709
1407,-0.645953270361,0.929241202634,018-ABA,0.141643966136,250,504,754
1408,-0.645953270361,0.929241202634,018-ABD,0.141643966136,304,241,545
1409,-0.645953270361,0.929241202634,018-ABE,0.141643966136,282,267,549
1410,-0.645953270361,0.929241202634,018-ABF,0.141643966136,323,149,472
1411,-0.645953270361,0.929241202634,018-ABG,0.141643966136,460,171,631
1412,-0.645953270361,0.929241202634,018-ABH,0.141643966136,474,102,576
1413,-0.645953270361,0.929241202634,018-ABK,0.141643966136,409,177,586
1414,-0.645953270361,0.929241202634,018-ABM,0.141643966136,328,65,393
1415,-0.645953270361,0.929241202634,018-ABN,0.141643966136,396,208,604
1416,-0.645953270361,0.929241202634,018-ABP,0.141643966136,265,91,356
1417,-0.645953270361,0.929241202634,018-ABQ,0.141643966136,370,216,586
1418,-0.645953270361,0.929241202634,018-ABU,0.141643966136,268,110,378
1419,-0.645953270361,0.929241202634,018-ABV,0.141643966136,254,91,345
1420,-0.645953270361,0.929241202634,018-ABX,0.141643966136,256,101,357
1421,-0.645953270361,0.929241202634,018-ABY,0.141643966136,217,140,357
1422,-0.645953270361,0.929241202634,018-ACA,0.141643966136,188,93,281
1423,-0.645953270361,0.929241202634,018-ACB,0.141643966136,229,111,340
1424,-0.645953270361,0.929241202634,018-ACE,0.141643966136,217,72,289
1425,-0.645953270361,0.929241202634,018-ACF,0.141643966136,337,153,490
1426,-0.645953270361,0.929241202634,018-ACJ,0.141643966136,211,155,366
1427,-0.645953270361,0.929241202634,018-ACK,0.141643966136,120,99,219
1428,-0.645953270361,0.929241202634,018-ACM,0.141643966136,182,121,303
1429,-0.645953270361,0.929241202634,018-ACN,0.141643966136,172,139,311
1430,-0.645953270361,0.929241202634,018-ACP,0.141643966136,213,71,284
1431,-0.645953270361,0.929241202634,018-ACQ,0.141643966136,340,59,399
1432,-0.645953270361,0.929241202634,018-ACR,0.141643966136,160,4,164
1433,-0.645953270361,0.929241202634,018-ACS,0.141643966136,204,10,214
1434,-0.645953270361,0.929241202634,018-ACV,0.141643966136,349,54,403
1435,-0.645953270361,0.929241202634,018-ACW,0.141643966136,374,20,394
1436,-0.645953270361,0.929241202634,018-ACY,0.141643966136,388,23,411
1437,-0.645953270361,0.929241202634,018-ACZ,0.141643966136,663,90,753
1438,-0.645953270361,0.929241202634,018-ADE,0.141643966136,477,42,519
1439,-0.645953270361,0.929241202634,018-ADF,0.141643966136,265,73,338
1440,-0.645953270361,0.929241202634,018-ADI,0.141643966136,214,83,297
1441,-0.645953270361,0.929241202634,018-ADJ,0.141643966136,192,139,331
1442,-0.645953270361,0.929241202634,018-ADK,0.141643966136,145,127,272
1443,-0.645953270361,0.929241202634,018-ADN,0.141643966136,203,244,447
1444,-0.645953270361,0.929241202634,018-ADO,0.141643966136,301,331,632
1445,-0.645953270361,0.929241202634,018-ADP,0.141643966136,215,246,461
1446,-0.645953270361,0.929241202634,018-ADU,0.141643966136,186,216,402
1447,-0.645953270361,0.929241202634,018-ADV,0.141643966136,216,282,498
1448,-0.645953270361,0.929241202634,018-ADW,0.141643966136,234,291,525
1449,-0.645953270361,0.929241202634,018-AEB,0.141643966136,113,79,192
1450,-0.645953270361,0.929241202634,018-AED,0.141643966136,185,208,393
1451,-0.645953270361,0.929241202634,018-AEE,0.141643966136,187,186,373
1452,-0.645953270361,0.929241202634,018-AEI,0.141643966136,138,136,274
1453,-0.645953270361,0.929241202634,018-AEJ,0.141643966136,154,225,379
1454,-0.645953270361,0.929241202634,018-AEK,0.141643966136,238,274,512
1455,-0.645953270361,0.929241202634,018-AEP,0.141643966136,160,385,545
1456,-0.645953270361,0.929241202634,018-AEQ,0.141643966136,124,353,477
1457,-0.645953270361,0.929241202634,018-AES,0.141643966136,198,425,623
1458,-0.645953270361,0.929241202634,018-AET,0.141643966136,199,545,744
1459,-0.645953270361,0.929241202634,018-AEU,0.141643966136,199,333,532
1460,-0.645953270361,0.929241202634,018-AEV,0.141643966136,238,380,618
1461,-0.645953270361,0.929241202634,018-AEX,0.141643966136,168,362,530
1462,-0.645953270361,0.929241202634,018-AEY,0.141643966136,161,456,617
1463,-0.645953270361,0.929241202634,018-AEZ,0.141643966136,155,365,520
1464,-0.645953270361,0.929241202634,018-AFB,0.141643966136,184,529,713
1465,-0.645953270361,0.929241202634,018-AFC,0.141643966136,202,462,664
1466,-0.645953270361,0.929241202634,018-AFG,0.141643966136,114,300,414
1467,-0.645953270361,0.929241202634,018-AFH,0.141643966136,164,453,617
1468,-0.645953270361,0.929241202634,018-AFI,0.141643966136,191,417,608
1469,-0.645953270361,0.929241202634,018-AFK,0.141643966136,187,417,604
1470,-0.645953270361,0.929241202634,018-AFL,0.141643966136,136,269,405
1471,-0.645953270361,0.929241202634,018-AFM,0.141643966136,204,462,666
1472,-0.645953270361,0.929241202634,018-AFP,0.141643966136,145,214,359
1473,-0.645953270361,0.929241202634,018-AFQ,0.141643966136,110,232,342
1474,-0.645953270361,0.929241202634,018-AFR,0.141643966136,201,524,725
1475,-0.645953270361,0.929241202634,018-AFU,0.141643966136,191,396,587
1476,-0.645953270361,0.929241202634,018-AFV,0.141643966136,55,41,96
1477,-0.645953270361,0.929241202634,018-AFW,0.141643966136,158,274,432
1478,-0.645953270361,0.929241202634,018-AFZ,0.141643966136,154,94,248
1479,-0.645953270361,0.929241202634,018-AGA,0.141643966136,269,274,543
1480,-0.645953270361,0.929241202634,018-AGB,0.141643966136,241,254,495
1481,-0.645953270361,0.929241202634,018-AGD,0.141643966136,194,200,394
1482,-0.645953270361,0.929241202634,018-AGF,0.141643966136,278,250,528
1483,-0.645953270361,0.929241202634,018-AGG,0.141643966136,238,178,416
1484,-0.645953270361,0.929241202634,018-AGH,0.141643966136,228,192,420
1485,-0.645953270361,0.929241202634,018-AGJ,0.141643966136,221,212,433
1486,-0.645953270361,0.929241202634,018-AGO,0.141643966136,243,202,445
1487,-0.645953270361,0.929241202634,018-AGQ,0.141643966136,263,240,503
1488,-0.645953270361,0.929241202634,018-AGS,0.141643966136,242,194,436
1489,-0.645953270361,0.929241202634,018-AGW,0.141643966136,195,177,372
1490,-0.645953270361,0.929241202634,018-AGX,0.141643966136,210,205,415
1491,-0.645953270361,0.929241202634,018-AGZ,0.141643966136,123,77,200
1492,-0.645953270361,0.929241202634,018-AHA,0.141643966136,257,209,466
1493,-0.645953270361,0.929241202634,018-AHF,0.141643966136,247,252,499
1494,-0.645953270361,0.929241202634,018-AHG,0.141643966136,246,208,454
1495,-0.645953270361,0.929241202634,018-AHI,0.141643966136,280,232,512
1496,-0.645953270361,0.929241202634,018-AHL,0.141643966136,267,294,561
1497,-0.645953270361,0.929241202634,018-AHN,0.141643966136,225,213,438
1498,-0.645953270361,0.929241202634,018-AHO,0.141643966136,307,234,541
1499,-0.645953270361,0.929241202634,018-AHU,0.141643966136,337,5,342
1500,-0.645953270361,0.929241202634,018-AHW,0.141643966136,320,6,326
1501,-0.645953270361,0.929241202634,018-AIA,0.141643966136,445,9,454
1502,-0.645953270361,0.929241202634,018-AIC,0.141643966136,452,13,465
1503,-0.645953270361,0.929241202634,018-AIG,0.141643966136,486,15,501
1504,-0.645953270361,0.929241202634,018-AII,0.141643966136,393,6,399
1505,-0.645953270361,0.929241202634,018-AIK,0.141643966136,457,8,465
1506,-0.645953270361,0.929241202634,018-AIO,0.141643966136,534,12,546
1507,-0.645953270361,0.929241202634,018-AIQ,0.141643966136,523,11,534
1508,-0.645953270361,0.929241202634,018-AIS,0.141643966136,503,10,513
1509,-0.645953270361,0.929241202634,018-AIW,0.141643966136,512,5,517
1510,-0.645953270361,0.929241202634,018-AIX,0.141643966136,539,11,550
1511,-0.645953270361,0.929241202634,018-AIZ,0.141643966136,418,2,420
1512,-0.645953270361,0.929241202634,018-AJA,0.141643966136,387,7,394
1513,-0.645953270361,0.929241202634,018-AJC,0.141643966136,426,8,434
1514,-0.645953270361,0.929241202634,018-AJD,0.141643966136,419,6,425
1515,-0.645953270361,0.929241202634,018-AJH,0.141643966136,248,6,254
1516,-0.645953270361,0.929241202634,018-AJJ,0.141643966136,220,52,272
1517,-0.645953270361,0.929241202634,018-AJL,0.141643966136,295,7,302
1518,-0.645953270361,0.929241202634,018-AJN,0.141643966136,150,21,171
1519,-0.645953270361,0.929241202634,018-AJP,0.141643966136,314,3,317
1520,-0.645953270361,0.929241202634,018-AJT,0.141643966136,350,3,353
1521,-0.645953270361,0.929241202634,018-AJV,0.141643966136,360,123,483
1522,-0.645953270361,0.929241202634,018-AJX,0.141643966136,280,8,288
1523,-0.645953270361,0.929241202634,018-AJY,0.141643966136,265,3,268
1524,-0.645953270361,0.929241202634,018-AKA,0.141643966136,385,8,393
1525,-0.645953270361,0.929241202634,018-AKB,0.141643966136,374,6,380
1526,-0.645953270361,0.929241202634,018-AKC,0.141643966136,103,36,139
1527,-0.645953270361,0.929241202634,018-AKD,0.141643966136,294,7,301
1528,-0.645953270361,0.929241202634,018-AKE,0.141643966136,375,6,381
1529,-0.645953270361,0.929241202634,018-AKF,0.141643966136,326,16,342
1530,-0.645953270361,0.929241202634,018-AKH,0.141643966136,320,4,324
1531,-0.645953270361,0.929241202634,018-AKI,0.141643966136,287,9,296
1532,-0.645953270361,0.929241202634,018-AKP,0.141643966136,341,9,350
1533,-0.645953270361,0.929241202634,018-AKT,0.141643966136,319,7,326
1534,-0.645953270361,0.929241202634,018-AKV,0.141643966136,299,6,305
1535,-0.645953270361,0.929241202634,018-AKX,0.141643966136,377,4,381
1536,-0.645953270361,0.929241202634,018-AKZ,0.141643966136,187,2,189
1537,-0.645953270361,0.929241202634,018-ALB,0.141643966136,387,6,393
1538,-0.645953270361,0.929241202634,018-ALD,0.141643966136,214,5,219
1539,-0.645953270361,0.929241202634,018-ALJ,0.141643966136,301,3,304
1540,-0.645953270361,0.929241202634,018-ALP,0.141643966136,353,4,357
1541,-0.645953270361,0.929241202634,018-ALQ,0.141643966136,289,10,299
1542,-0.645953270361,0.929241202634,018-ALR,0.141643966136,236,4,240
1543,-0.645953270361,0.929241202634,018-ALS,0.141643966136,239,5,244
1544,-0.645953270361,0.929241202634,018-ALT,0.141643966136,277,11,288
1545,-0.645953270361,0.929241202634,018-ALU,0.141643966136,373,4,377
1546,-0.645953270361,0.929241202634,018-ALV,0.141643966136,283,7,290
1547,-0.645953270361,0.929241202634,018-ALW,0.141643966136,345,9,354
1548,-0.645953270361,0.929241202634,018-AMC,0.141643966136,212,24,236
1549,-0.645953270361,0.929241202634,018-AME,0.141643966136,187,20,207
1550,-0.645953270361,0.929241202634,018-AMI,0.141643966136,426,9,435
1551,-0.645953270361,0.929241202634,018-AMM,0.141643966136,199,3,202
1552,-0.645953270361,0.929241202634,018-AMQ,0.141643966136,289,4,293
1553,-0.645953270361,0.929241202634,018-AMS,0.141643966136,269,3,272
1554,-0.645953270361,0.929241202634,018-AMU,0.141643966136,240,7,247
1555,-0.645953270361,0.929241202634,018-AMV,0.141643966136,37,1,38
1556,-0.645953270361,0.929241202634,018-AMX,0.141643966136,217,4,221
1557,-0.645953270361,0.929241202634,018-AMZ,0.141643966136,347,4,351
1558,-0.645953270361,0.929241202634,018-ANA,0.141643966136,276,5,281
1559,-0.645953270361,0.929241202634,018-ANB,0.141643966136,218,3,221
1560,-0.645953270361,0.929241202634,018-ANC,0.141643966136,479,120,599
1561,-0.645953270361,0.929241202634,018-AND,0.141643966136,291,10,301
1562,-0.645953270361,0.929241202634,018-ANE,0.141643966136,260,4,264
1563,-0.645953270361,0.929241202634,018-ANF,0.141643966136,369,24,393
1564,-0.645953270361,0.929241202634,018-ANN,0.141643966136,97,4,101
1565,-0.645953270361,0.929241202634,018-ANP,0.141643966136,25,16,41
1566,-0.645953270361,0.929241202634,018-ANR,0.141643966136,56,15,71
1567,-0.645953270361,0.929241202634,018-ANT,0.141643966136,168,2,170
1568,-0.645953270361,0.929241202634,018-ANV,0.141643966136,90,8,98
1569,-0.645953270361,0.929241202634,018-ANX,0.141643966136,140,1,141
1570,-0.645953270361,0.929241202634,018-ANZ,0.141643966136,112,5,117
1571,-0.645953270361,0.929241202634,018-AOB,0.141643966136,193,13,206
1572,-0.645953270361,0.929241202634,018-AOD,0.141643966136,125,5,130
1573,-0.645953270361,0.929241202634,018-AOF,0.141643966136,85,27,112
1574,-0.645953270361,0.929241202634,018-AOH,0.141643966136,171,5,176
1575,-0.645953270361,0.929241202634,018-AOJ,0.141643966136,214,6,220
1576,-0.645953270361,0.929241202634,018-AOL,0.141643966136,152,2,154
1577,-0.645953270361,0.929241202634,018-AON,0.141643966136,150,4,154
1578,-0.645953270361,0.929241202634,018-AOQ,0.141643966136,109,10,119
1579,-0.645953270361,0.929241202634,018-AOR,0.141643966136,200,11,211
1580,-0.645953270361,0.929241202634,018-AOS,0.141643966136,255,5,260
1581,-0.645953270361,0.929241202634,018-AOT,0.141643966136,297,6,303
1582,-0.645953270361,0.929241202634,018-AOU,0.141643966136,125,1,126
1583,-0.645953270361,0.929241202634,018-APB,0.141643966136,217,13,230
1584,-0.645953270361,0.929241202634,018-APD,0.141643966136,106,25,131
1585,-0.645953270361,0.929241202634,018-APF,0.141643966136,15,0,15
1586,-0.645953270361,0.929241202634,018-APL,0.141643966136,99,65,164
1587,-0.645953270361,0.929241202634,018-APN,0.141643966136,277,5,282
1588,-0.645953270361,0.929241202634,018-APP,0.141643966136,253,5,258
1589,-0.645953270361,0.929241202634,018-APR,0.141643966136,264,8,272
1590,-0.645953270361,0.929241202634,018-APT,0.141643966136,220,5,225
1591,-0.645953270361,0.929241202634,018-APV,0.141643966136,169,39,208
1592,-0.645953270361,0.929241202634,018-APX,0.141643966136,269,8,277
1593,-0.645953270361,0.929241202634,018-APY,0.141643966136,92,7,99
1594,-0.645953270361,0.929241202634,018-APZ,0.141643966136,169,22,191
1595,-0.645953270361,0.929241202634,018-AQB,0.141643966136,225,12,237
1596,-0.645953270361,0.929241202634,018-AQC,0.141643966136,267,10,277
1597,-0.645953270361,0.929241202634,018-AQD,0.141643966136,346,59,405
1598,-0.645953270361,0.929241202634,018-AQE,0.141643966136,315,12,327
1599,-0.645953270361,0.929241202634,018-AQF,0.141643966136,142,95,237
1600,-0.645953270361,0.929241202634,018-AQH,0.141643966136,231,18,249
1601,-0.645953270361,0.929241202634,018-AQM,0.141643966136,327,8,335
1602,-0.645953270361,0.929241202634,018-AQO,0.141643966136,290,4,294
1603,-0.645953270361,0.929241202634,018-AQQ,0.141643966136,152,5,157
1604,-0.645953270361,0.929241202634,018-AQU,0.141643966136,247,5,252
1605,-0.645953270361,0.929241202634,018-AQW,0.141643966136,194,5,199
1606,-0.645953270361,0.929241202634,018-AQY,0.141643966136,171,6,177
1607,-0.645953270361,0.929241202634,018-ARA,0.141643966136,174,5,179
1608,-0.645953270361,0.929241202634,018-ARC,0.141643966136,215,6,221
1609,-0.645953270361,0.929241202634,018-ARE,0.141643966136,164,6,170
1610,-0.645953270361,0.929241202634,018-ARF,0.141643966136,120,26,146
1611,-0.645953270361,0.929241202634,018-ARH,0.141643966136,254,2,256
1612,-0.645953270361,0.929241202634,018-ARI,0.141643966136,270,5,275
1613,-0.645953270361,0.929241202634,018-ARJ,0.141643966136,313,25,338
1614,-0.645953270361,0.929241202634,018-ARK,0.141643966136,258,5,263
1615,-0.645953270361,0.929241202634,018-ARM,0.141643966136,131,20,151
1616,-0.645953270361,0.929241202634,018-ARN,0.141643966136,158,7,165
1617,-0.645953270361,0.929241202634,018-ARO,0.141643966136,245,16,261
1618,-0.645953270361,0.929241202634,018-ARP,0.141643966136,185,6,191
1619,-0.645953270361,0.929241202634,018-ARV,0.141643966136,244,9,253
1620,-0.645953270361,0.929241202634,018-ARX,0.141643966136,227,6,233
1621,-0.645953270361,0.929241202634,018-ARZ,0.141643966136,244,4,248
1622,-0.645953270361,0.929241202634,018-ASB,0.141643966136,197,3,200
1623,-0.645953270361,0.929241202634,018-ASD,0.141643966136,152,4,156
1624,-0.645953270361,0.929241202634,018-ASF,0.141643966136,30,0,30
1625,-0.645953270361,0.929241202634,018-ASH,0.141643966136,268,10,278
1626,-0.645953270361,0.929241202634,018-ASL,0.141643966136,222,3,225
1627,-0.645953270361,0.929241202634,018-ASN,0.141643966136,66,8,74
1628,-0.645953270361,0.929241202634,018-ASP,0.141643966136,259,11,270
1629,-0.645953270361,0.929241202634,018-ASQ,0.141643966136,91,6,97
1630,-0.645953270361,0.929241202634,018-ASR,0.141643966136,239,5,244
1631,-0.645953270361,0.929241202634,018-ASS,0.141643966136,295,4,299
1632,-0.645953270361,0.929241202634,018-AST,0.141643966136,190,2,192
1633,-0.645953270361,0.929241202634,018-ASU,0.141643966136,241,7,248
1634,-0.645953270361,0.929241202634,018-ASV,0.141643966136,284,6,290
1635,-0.645953270361,0.929241202634,018-ASW,0.141643966136,257,1,258
1636,-0.645953270361,0.929241202634,018-ASX,0.141643966136,319,18,337
1637,-0.645953270361,0.929241202634,018-ATJ,0.141643966136,316,7,323
1638,-0.645953270361,0.929241202634,018-ATL,0.141643966136,246,4,250
1639,-0.645953270361,0.929241202634,018-ATN,0.141643966136,332,7,339
1640,-0.645953270361,0.929241202634,018-ATP,0.141643966136,210,6,216
1641,-0.645953270361,0.929241202634,018-ATR,0.141643966136,191,2,193
1642,-0.645953270361,0.929241202634,018-ATT,0.141643966136,269,7,276
1643,-0.645953270361,0.929241202634,018-ATV,0.141643966136,234,5,239
1644,-0.645953270361,0.929241202634,018-ATZ,0.141643966136,282,1,283
1645,-0.645953270361,0.929241202634,018-AUB,0.141643966136,278,6,284
1646,-0.645953270361,0.929241202634,018-AUD,0.141643966136,212,3,215
1647,-0.645953270361,0.929241202634,018-AUE,0.141643966136,239,8,247
1648,-0.645953270361,0.929241202634,018-AUF,0.141643966136,211,10,221
1649,-0.645953270361,0.929241202634,018-AUG,0.141643966136,37,21,58
1650,-0.645953270361,0.929241202634,018-AUH,0.141643966136,252,9,261
1651,-0.645953270361,0.929241202634,018-AUI,0.141643966136,348,16,364
1652,-0.645953270361,0.929241202634,018-AUJ,0.141643966136,170,18,188
1653,-0.645953270361,0.929241202634,018-AUT,0.141643966136,238,10,248
1654,-0.645953270361,0.929241202634,018-AUV,0.141643966136,228,5,233
1655,-0.645953270361,0.929241202634,018-AUX,0.141643966136,368,14,382
1656,-0.645953270361,0.929241202634,018-AUZ,0.141643966136,215,15,230
1657,-0.645953270361,0.929241202634,018-AVB,0.141643966136,226,10,236
1658,-0.645953270361,0.929241202634,018-AVD,0.141643966136,279,17,296
1659,-0.645953270361,0.929241202634,018-AVF,0.141643966136,292,6,298
1660,-0.645953270361,0.929241202634,018-AVG,0.141643966136,271,13,284
1661,-0.645953270361,0.929241202634,018-AVI,0.141643966136,250,5,255
1662,-0.645953270361,0.929241202634,018-AVJ,0.141643966136,257,7,264
1663,-0.645953270361,0.929241202634,018-AVK,0.141643966136,298,7,305
1664,-0.645953270361,0.929241202634,018-AVL,0.141643966136,265,5,270
1665,-0.645953270361,0.929241202634,018-AVM,0.141643966136,215,7,222
1666,-0.645953270361,0.929241202634,018-AVP,0.141643966136,315,11,326
1667,-0.645953270361,0.929241202634,018-AVQ,0.141643966136,297,20,317
1668,-0.645953270361,0.929241202634,018-AWA,0.141643966136,353,35,388
1669,-0.645953270361,0.929241202634,018-AWE,0.141643966136,278,103,381
1670,-0.645953270361,0.929241202634,018-AWI,0.141643966136,265,16,281
1671,-0.645953270361,0.929241202634,018-AWM,0.141643966136,242,32,274
1672,-0.645953270361,0.929241202634,018-AWN,0.141643966136,300,146,446
1673,-0.645953270361,0.929241202634,018-AWO,0.141643966136,303,99,402
1674,-0.645953270361,0.929241202634,018-AWQ,0.141643966136,352,63,415
1675,-0.645953270361,0.929241202634,018-AWR,0.141643966136,229,25,254
1676,-0.645953270361,0.929241202634,018-AWS,0.141643966136,363,71,434
1677,-0.645953270361,0.929241202634,018-AWT,0.141643966136,211,31,242
1678,-0.645953270361,0.929241202634,018-AWU,0.141643966136,307,144,451
1679,-0.645953270361,0.929241202634,018-AWV,0.141643966136,279,42,321
1680,-0.645953270361,0.929241202634,018-AWW,0.141643966136,327,35,362
1681,-0.645953270361,0.929241202634,018-AWX,0.141643966136,285,33,318
1682,-0.645953270361,0.929241202634,018-AWY,0.141643966136,192,33,225
1683,-0.645953270361,0.929241202634,018-AWZ,0.141643966136,193,24,217
1684,-0.645953270361,0.929241202634,018-AXF,0.141643966136,124,57,181
1685,-0.645953270361,0.929241202634,018-AXH,0.141643966136,107,14,121
1686,-0.645953270361,0.929241202634,018-AXL,0.141643966136,138,57,195
1687,-0.645953270361,0.929241202634,018-AXO,0.141643966136,31,12,43
1688,-0.645953270361,0.929241202634,018-AXP,0.141643966136,141,39,180
1689,-0.645953270361,0.929241202634,018-AXQ,0.141643966136,133,27,160
1690,-0.645953270361,0.929241202634,018-AXS,0.141643966136,126,29,155
1691,-0.645953270361,0.929241202634,018-AXT,0.141643966136,154,32,186
1692,-0.645953270361,0.929241202634,018-AXU,0.141643966136,132,33,165
1693,-0.645953270361,0.929241202634,018-AXV,0.141643966136,119,56,175
1694,-0.645953270361,0.929241202634,018-AXX,0.141643966136,124,29,153
1695,-0.645953270361,0.929241202634,018-AXY,0.141643966136,166,55,221
1696,-0.645953270361,0.929241202634,018-AYJ,0.141643966136,150,24,174
1697,-0.645953270361,0.929241202634,018-AYL,0.141643966136,125,49,174
1698,-0.645953270361,0.929241202634,018-AYN,0.141643966136,158,65,223
1699,-0.645953270361,0.929241202634,018-AYP,0.141643966136,25,13,38
1700,-0.645953270361,0.929241202634,018-AYR,0.141643966136,63,25,88
1701,-0.645953270361,0.929241202634,018-AYT,0.141643966136,117,10,127
1702,-0.645953270361,0.929241202634,018-AYV,0.141643966136,151,90,241
1703,-0.645953270361,0.929241202634,018-AYX,0.141643966136,125,85,210
1704,-0.645953270361,0.929241202634,018-AYZ,0.141643966136,155,90,245
1705,-0.645953270361,0.929241202634,018-AZB,0.141643966136,84,30,114
1706,-0.645953270361,0.929241202634,018-AZC,0.141643966136,66,16,82
1707,-0.645953270361,0.929241202634,018-AZE,0.141643966136,170,67,237
1708,-0.645953270361,0.929241202634,018-AZF,0.141643966136,182,74,256
1709,-0.645953270361,0.929241202634,018-AZG,0.141643966136,177,42,219
1710,-0.645953270361,0.929241202634,018-AZH,0.141643966136,85,42,127
1711,-0.645953270361,0.929241202634,018-AZI,0.141643966136,130,46,176
1712,-0.645953270361,0.929241202634,018-AZJ,0.141643966136,139,85,224
1713,-0.645953270361,0.929241202634,018-AZK,0.141643966136,196,102,298
1714,-0.645953270361,0.929241202634,018-AZL,0.141643966136,184,55,239
1715,-0.645953270361,0.929241202634,018-AZM,0.141643966136,164,46,210
1716,-0.645953270361,0.929241202634,018-AZO,0.141643966136,162,43,205
1717,-0.645953270361,0.929241202634,018-AZU,0.141643966136,40,21,61
1718,-0.645953270361,0.929241202634,018-AZW,0.141643966136,201,40,241
1719,-0.645953270361,0.929241202634,018-BAA,0.141643966136,114,31,145
1720,-0.645953270361,0.929241202634,018-BAC,0.141643966136,110,22,132
1721,-0.645953270361,0.929241202634,018-BAE,0.141643966136,113,25,138
1722,-0.645953270361,0.929241202634,018-BAG,0.141643966136,125,45,170
1723,-0.645953270361,0.929241202634,018-BAI,0.141643966136,79,31,110
1724,-0.645953270361,0.929241202634,018-BAJ,0.141643966136,102,53,155
1725,-0.645953270361,0.929241202634,018-BAL,0.141643966136,107,48,155
1726,-0.645953270361,0.929241202634,018-BAM,0.141643966136,71,39,110
1727,-0.645953270361,0.929241202634,018-BAN,0.141643966136,104,42,146
1728,-0.645953270361,0.929241202634,018-BAO,0.141643966136,94,36,130
1729,-0.645953270361,0.929241202634,018-BAQ,0.141643966136,81,39,120
1730,-0.645953270361,0.929241202634,018-BAR,0.141643966136,84,19,103
1731,-0.645953270361,0.929241202634,018-BAS,0.141643966136,69,21,90
1732,-0.645953270361,0.929241202634,018-BAT,0.141643966136,75,27,102
1733,-0.645953270361,0.929241202634,018-BAU,0.141643966136,61,33,94
1734,-0.645953270361,0.929241202634,018-BBB,0.141643966136,143,58,201
1735,-0.645953270361,0.929241202634,018-BBH,0.141643966136,135,46,181
1736,-0.645953270361,0.929241202634,018-BBJ,0.141643966136,131,71,202
1737,-0.645953270361,0.929241202634,018-BBN,0.141643966136,219,246,465
1738,-0.645953270361,0.929241202634,018-BBP,0.141643966136,114,77,191
1739,-0.645953270361,0.929241202634,018-BBQ,0.141643966136,137,51,188
1740,-0.645953270361,0.929241202634,018-BBR,0.141643966136,199,115,314
1741,-0.645953270361,0.929241202634,018-BBT,0.141643966136,217,240,457
1742,-0.645953270361,0.929241202634,018-BBU,0.141643966136,251,275,526
1743,-0.645953270361,0.929241202634,018-BBW,0.141643966136,167,135,302
1744,-0.645953270361,0.929241202634,018-BBX,0.141643966136,145,122,267
1745,-0.645953270361,0.929241202634,018-BBZ,0.141643966136,144,119,263
1746,-0.645953270361,0.929241202634,018-BCI,0.141643966136,77,59,136
1747,-0.645953270361,0.929241202634,018-BCO,0.141643966136,237,262,499
1748,-0.645953270361,0.929241202634,018-BCS,0.141643966136,226,162,388
1749,-0.645953270361,0.929241202634,018-BCU,0.141643966136,152,151,303
1750,-0.645953270361,0.929241202634,018-BCW,0.141643966136,153,125,278
1751,-0.645953270361,0.929241202634,018-BCY,0.141643966136,98,101,199
1752,-0.645953270361,0.929241202634,018-BCZ,0.141643966136,130,94,224
1753,-0.645953270361,0.929241202634,018-BDA,0.141643966136,150,110,260
1754,-0.645953270361,0.929241202634,018-BDB,0.141643966136,196,157,353
1755,-0.645953270361,0.929241202634,018-BDC,0.141643966136,204,222,426
1756,-0.645953270361,0.929241202634,018-BDE,0.141643966136,206,216,422
1757,-0.645953270361,0.929241202634,018-BDF,0.141643966136,166,175,341
1758,-0.645953270361,0.929241202634,018-BDG,0.141643966136,143,123,266
1759,-0.645953270361,0.929241202634,018-BDH,0.141643966136,190,163,353
1760,-0.645953270361,0.929241202634,018-BDI,0.141643966136,148,149,297
1761,-0.645953270361,0.929241202634,018-BDQ,0.141643966136,98,44,142
1762,-0.645953270361,0.929241202634,018-BDS,0.141643966136,109,46,155
1763,-0.645953270361,0.929241202634,018-BDV,0.141643966136,81,36,117
1764,-0.645953270361,0.929241202634,018-BDW,0.141643966136,77,31,108
1765,-0.645953270361,0.929241202634,018-BDX,0.141643966136,143,61,204
1766,-0.645953270361,0.929241202634,018-BDY,0.141643966136,151,41,192
1767,-0.645953270361,0.929241202634,018-BDZ,0.141643966136,161,74,235
1768,-0.645953270361,0.929241202634,018-BEA,0.141643966136,177,43,220
1769,-0.645953270361,0.929241202634,018-BEB,0.141643966136,190,86,276
1770,-0.645953270361,0.929241202634,018-BEC,0.141643966136,116,46,162
1771,-0.645953270361,0.929241202634,018-BED,0.141643966136,197,64,261
1772,-0.645953270361,0.929241202634,018-BEF,0.141643966136,126,35,161
1773,-0.645953270361,0.929241202634,018-BEG,0.141643966136,90,37,127
1774,-0.645953270361,0.929241202634,018-BEH,0.141643966136,76,36,112
1775,-0.645953270361,0.929241202634,018-BES,0.141643966136,234,136,370
1776,-0.645953270361,0.929241202634,018-BEV,0.141643966136,228,121,349
1777,-0.645953270361,0.929241202634,018-BEW,0.141643966136,131,53,184
1778,-0.645953270361,0.929241202634,018-BEY,0.141643966136,201,55,256
1779,-0.645953270361,0.929241202634,018-BEZ,0.141643966136,293,116,409
1780,-0.645953270361,0.929241202634,018-BFA,0.141643966136,117,47,164
1781,-0.645953270361,0.929241202634,018-BFB,0.141643966136,185,82,267
1782,-0.645953270361,0.929241202634,018-BFC,0.141643966136,121,47,168
1783,-0.645953270361,0.929241202634,018-BFD,0.141643966136,142,57,199
1784,-0.645953270361,0.929241202634,018-BFF,0.141643966136,183,94,277
1785,-0.645953270361,0.929241202634,018-BFH,0.141643966136,167,72,239
1786,-0.645953270361,0.929241202634,018-BFI,0.141643966136,132,64,196
1787,-0.645953270361,0.929241202634,018-BFJ,0.141643966136,107,40,147
1788,-0.645953270361,0.929241202634,018-BFK,0.141643966136,101,41,142
1789,-0.645953270361,0.929241202634,018-BFL,0.141643966136,89,28,117
1790,-0.645953270361,0.929241202634,018-BFX,0.141643966136,221,35,256
1791,-0.645953270361,0.929241202634,018-BFZ,0.141643966136,364,38,402
1792,-0.645953270361,0.929241202634,018-BGD,0.141643966136,256,129,385
1793,-0.645953270361,0.929241202634,018-BGE,0.141643966136,187,97,284
1794,-0.645953270361,0.929241202634,018-BGG,0.141643966136,198,87,285
1795,-0.645953270361,0.929241202634,018-BGH,0.141643966136,194,77,271
1796,-0.645953270361,0.929241202634,018-BGI,0.141643966136,195,81,276
1797,-0.645953270361,0.929241202634,018-BGK,0.141643966136,188,66,254
1798,-0.645953270361,0.929241202634,018-BGL,0.141643966136,149,83,232
1799,-0.645953270361,0.929241202634,018-BGM,0.141643966136,72,29,101
1800,-0.645953270361,0.929241202634,018-BGN,0.141643966136,206,56,262
1801,-0.645953270361,0.929241202634,018-BGO,0.141643966136,149,71,220
1802,-0.645953270361,0.929241202634,018-BGP,0.141643966136,195,102,297
1803,-0.645953270361,0.929241202634,018-BGQ,0.141643966136,158,104,262
1804,-0.645953270361,0.929241202634,018-BGY,0.141643966136,219,175,394
1805,-0.645953270361,0.929241202634,018-BHA,0.141643966136,155,118,273
1806,-0.645953270361,0.929241202634,018-BHC,0.141643966136,205,195,400
1807,-0.645953270361,0.929241202634,018-BHE,0.141643966136,161,127,288
1808,-0.645953270361,0.929241202634,018-BHG,0.141643966136,168,112,280
1809,-0.645953270361,0.929241202634,018-BHK,0.141643966136,212,136,348
1810,-0.645953270361,0.929241202634,018-BHM,0.141643966136,208,104,312
1811,-0.645953270361,0.929241202634,018-BHO,0.141643966136,184,76,260
1812,-0.645953270361,0.929241202634,018-BHP,0.141643966136,204,119,323
1813,-0.645953270361,0.929241202634,018-BHQ,0.141643966136,194,125,319
1814,-0.645953270361,0.929241202634,018-BHS,0.141643966136,181,141,322
1815,-0.645953270361,0.929241202634,018-BHT,0.141643966136,178,133,311
1816,-0.645953270361,0.929241202634,018-BHU,0.141643966136,176,143,319
1817,-0.645953270361,0.929241202634,018-BHV,0.141643966136,214,155,369
1818,-0.645953270361,0.929241202634,018-BHY,0.141643966136,173,104,277
1819,-0.645953270361,0.929241202634,018-BHZ,0.141643966136,119,79,198
1820,-0.645953270361,0.929241202634,018-BIG,0.141643966136,221,264,485
1821,-0.645953270361,0.929241202634,018-BII,0.141643966136,201,267,468
1822,-0.645953270361,0.929241202634,018-BIM,0.141643966136,163,80,243
1823,-0.645953270361,0.929241202634,018-BIO,0.141643966136,265,180,445
1824,-0.645953270361,0.929241202634,018-BIU,0.141643966136,138,123,261
1825,-0.645953270361,0.929241202634,018-BIW,0.141643966136,199,198,397
1826,-0.645953270361,0.929241202634,018-BIY,0.141643966136,196,199,395
1827,-0.645953270361,0.929241202634,018-BJA,0.141643966136,283,252,535
1828,-0.645953270361,0.929241202634,018-BJC,0.141643966136,252,237,489
1829,-0.645953270361,0.929241202634,018-BJF,0.141643966136,235,210,445
1830,-0.645953270361,0.929241202634,018-BJG,0.141643966136,261,217,478
1831,-0.645953270361,0.929241202634,018-BJI,0.141643966136,212,165,377
1832,-0.645953270361,0.929241202634,018-BJJ,0.141643966136,163,130,293
1833,-0.645953270361,0.929241202634,018-BJK,0.141643966136,155,147,302
1834,-0.645953270361,0.929241202634,018-BJM,0.141643966136,200,202,402
1835,-0.645953270361,0.929241202634,018-BJN,0.141643966136,193,160,353
1836,-0.645953270361,0.929241202634,018-BJO,0.141643966136,190,142,332
1837,-0.645953270361,0.929241202634,018-BJS,0.141643966136,176,86,262
1838,-0.645953270361,0.929241202634,018-BJT,0.141643966136,212,75,287
1839,-0.645953270361,0.929241202634,018-BJV,0.141643966136,227,80,307
1840,-0.645953270361,0.929241202634,018-BJW,0.141643966136,150,23,173
1841,-0.645953270361,0.929241202634,018-BJX,0.141643966136,318,113,431
1842,-0.645953270361,0.929241202634,018-BJY,0.141643966136,367,232,599
1843,-0.645953270361,0.929241202634,018-BKB,0.141643966136,316,120,436
1844,-0.645953270361,0.929241202634,018-BKG,0.141643966136,384,78,462
1845,-0.645953270361,0.929241202634,018-BKH,0.141643966136,423,147,570
1846,-0.645953270361,0.929241202634,018-BKI,0.141643966136,407,221,628
1847,-0.645953270361,0.929241202634,018-BKJ,0.141643966136,299,67,366
1848,-0.645953270361,0.929241202634,018-BKM,0.141643966136,380,126,506
1849,-0.645953270361,0.929241202634,018-BKO,0.141643966136,390,59,449
1850,-0.645953270361,0.929241202634,018-BKQ,0.141643966136,382,198,580
1851,-0.645953270361,0.929241202634,018-BKW,0.141643966136,381,39,420
1852,-0.645953270361,0.929241202634,018-BKX,0.141643966136,428,79,507
1853,-0.645953270361,0.929241202634,018-BKY,0.141643966136,183,17,200
1854,-0.645953270361,0.929241202634,018-BKZ,0.141643966136,339,55,394
1855,-0.645953270361,0.929241202634,018-BLB,0.141643966136,292,70,362
1856,-0.645953270361,0.929241202634,018-BLC,0.141643966136,323,38,361
1857,-0.645953270361,0.929241202634,018-BLG,0.141643966136,453,84,537
1858,-0.645953270361,0.929241202634,018-BLH,0.141643966136,308,217,525
1859,-0.645953270361,0.929241202634,018-BLK,0.141643966136,294,91,385
1860,-0.645953270361,0.929241202634,018-BLM,0.141643966136,462,78,540
1861,-0.645953270361,0.929241202634,018-BLO,0.141643966136,406,137,543
1862,-0.645953270361,0.929241202634,018-BLQ,0.141643966136,387,187,574
1863,-0.645953270361,0.929241202634,018-BLR,0.141643966136,473,167,640
1864,-0.645953270361,0.929241202634,018-BLS,0.141643966136,480,89,569
1865,-0.645953270361,0.929241202634,018-BLT,0.141643966136,371,85,456
1866,-0.645953270361,0.929241202634,018-BLZ,0.141643966136,440,76,516
1867,-0.645953270361,0.929241202634,018-BMA,0.141643966136,462,60,522
1868,-0.645953270361,0.929241202634,018-BMD,0.141643966136,478,30,508
1869,-0.645953270361,0.929241202634,018-BMF,0.141643966136,347,89,436
1870,-0.645953270361,0.929241202634,018-BMG,0.141643966136,383,15,398
1871,-0.645953270361,0.929241202634,018-BMH,0.141643966136,502,69,571
1872,-0.645953270361,0.929241202634,018-BMI,0.141643966136,400,22,422
1873,-0.645953270361,0.929241202634,018-BMJ,0.141643966136,415,62,477
1874,-0.645953270361,0.929241202634,018-BMQ,0.141643966136,293,11,304
1875,-0.645953270361,0.929241202634,018-BMR,0.141643966136,210,6,216
1876,-0.645953270361,0.929241202634,018-BMS,0.141643966136,170,1,171
1877,-0.645953270361,0.929241202634,018-BMT,0.141643966136,190,1,191
1878,-0.645953270361,0.929241202634,018-BMW,0.141643966136,273,3,276
1879,-0.645953270361,0.929241202634,018-BMX,0.141643966136,144,2,146
1880,-0.645953270361,0.929241202634,018-BNF,0.141643966136,220,8,228
1881,-0.645953270361,0.929241202634,018-BNG,0.141643966136,246,6,252
1882,-0.645953270361,0.929241202634,018-BNJ,0.141643966136,161,5,166
1883,-0.645953270361,0.929241202634,018-BNK,0.141643966136,264,5,269
1884,-0.645953270361,0.929241202634,018-BNM,0.141643966136,456,24,480
1885,-0.645953270361,0.929241202634,018-BNN,0.141643966136,203,1,204
1886,-0.645953270361,0.929241202634,018-BNV,0.141643966136,273,4,277
1887,-0.645953270361,0.929241202634,018-BNW,0.141643966136,315,9,324
1888,-0.645953270361,0.929241202634,018-BNY,0.141643966136,379,45,424
1889,-0.645953270361,0.929241202634,018-BNZ,0.141643966136,260,10,270
1890,-0.645953270361,0.929241202634,018-BOA,0.141643966136,338,4,342
1891,-0.645953270361,0.929241202634,018-BOB,0.141643966136,296,4,300
1892,-0.645953270361,0.929241202634,018-BOK,0.141643966136,184,199,383
1893,-0.645953270361,0.929241202634,018-BOL,0.141643966136,159,72,231
1894,-0.645953270361,0.929241202634,018-BOM,0.141643966136,175,80,255
1895,-0.645953270361,0.929241202634,018-BON,0.141643966136,241,84,325
1896,-0.645953270361,0.929241202634,018-BOO,0.141643966136,223,107,330
1897,-0.645953270361,0.929241202634,018-BOP,0.141643966136,222,83,305
1898,-0.645953270361,0.929241202634,018-BOQ,0.141643966136,199,165,364
1899,-0.645953270361,0.929241202634,018-BOR,0.141643966136,210,108,318
1900,-0.645953270361,0.929241202634,018-BOS,0.141643966136,214,240,454
1901,-0.645953270361,0.929241202634,018-BOT,0.141643966136,222,120,342
1902,-0.645953270361,0.929241202634,018-BOU,0.141643966136,221,54,275
1903,-0.645953270361,0.929241202634,018-BOV,0.141643966136,119,49,168
1904,-0.645953270361,0.929241202634,018-BOW,0.141643966136,211,79,290
1905,-0.645953270361,0.929241202634,018-BPD,0.141643966136,242,132,374
1906,-0.645953270361,0.929241202634,018-BPE,0.141643966136,215,83,298
1907,-0.645953270361,0.929241202634,018-BPF,0.141643966136,340,36,376
1908,-0.645953270361,0.929241202634,018-BPG,0.141643966136,198,68,266
1909,-0.645953270361,0.929241202634,018-BPH,0.141643966136,186,70,256
1910,-0.645953270361,0.929241202634,018-BPI,0.141643966136,176,109,285
1911,-0.645953270361,0.929241202634,018-BPJ,0.141643966136,176,77,253
1912,-0.645953270361,0.929241202634,018-BPK,0.141643966136,291,21,312
1913,-0.645953270361,0.929241202634,018-BPL,0.141643966136,179,179,358
1914,-0.645953270361,0.929241202634,018-BPM,0.141643966136,174,174,348
1915,-0.645953270361,0.929241202634,018-BPN,0.141643966136,145,131,276
1916,-0.645953270361,0.929241202634,018-BPZ,0.141643966136,178,61,239
1917,-0.645953270361,0.929241202634,018-BQA,0.141643966136,224,102,326
1918,-0.645953270361,0.929241202634,018-BQB,0.141643966136,207,96,303
1919,-0.645953270361,0.929241202634,018-BQC,0.141643966136,211,52,263
1920,-0.645953270361,0.929241202634,018-BQD,0.141643966136,245,99,344
1921,-0.645953270361,0.929241202634,018-BQE,0.141643966136,191,11,202
1922,-0.645953270361,0.929241202634,018-BQF,0.141643966136,243,64,307
1923,-0.645953270361,0.929241202634,018-BQG,0.141643966136,186,4,190
1924,-0.645953270361,0.929241202634,018-BQH,0.141643966136,138,74,212
1925,-0.645953270361,0.929241202634,018-BQI,0.141643966136,170,123,293
1926,-0.645953270361,0.929241202634,018-BQJ,0.141643966136,245,139,384
1927,-0.645953270361,0.929241202634,018-BQK,0.141643966136,195,149,344
1928,-0.645953270361,0.929241202634,018-BQT,0.141643966136,383,68,451
1929,-0.645953270361,0.929241202634,018-BQU,0.141643966136,272,45,317
1930,-0.645953270361,0.929241202634,018-BQV,0.141643966136,291,54,345
1931,-0.645953270361,0.929241202634,018-BQW,0.141643966136,625,20,645
1932,-0.645953270361,0.929241202634,018-BQX,0.141643966136,163,26,189
1933,-0.645953270361,0.929241202634,018-BQY,0.141643966136,288,187,475
1934,-0.645953270361,0.929241202634,018-BQZ,0.141643966136,133,29,162
1935,-0.645953270361,0.929241202634,018-BRA,0.141643966136,114,48,162
1936,-0.645953270361,0.929241202634,018-BRB,0.141643966136,283,142,425
1937,-0.645953270361,0.929241202634,018-BRC,0.141643966136,190,55,245
1938,-0.645953270361,0.929241202634,018-BRD,0.141643966136,269,147,416
1939,-0.645953270361,0.929241202634,018-BRE,0.141643966136,75,25,100
1940,-0.645953270361,0.929241202634,018-BRM,0.141643966136,159,369,528
1941,-0.645953270361,0.929241202634,018-BRN,0.141643966136,175,266,441
1942,-0.645953270361,0.929241202634,018-BRP,0.141643966136,149,187,336
1943,-0.645953270361,0.929241202634,018-BRS,0.141643966136,56,56,112
1944,-0.645953270361,0.929241202634,018-BRU,0.141643966136,205,249,454
1945,-0.645953270361,0.929241202634,018-BRV,0.141643966136,252,302,554
1946,-0.645953270361,0.929241202634,018-BRX,0.141643966136,206,294,500
1947,-0.645953270361,0.929241202634,018-BRZ,0.141643966136,244,343,587
1948,-0.645953270361,0.929241202634,018-BSA,0.141643966136,199,288,487
1949,-0.645953270361,0.929241202634,018-BSE,0.141643966136,153,249,402
1950,-0.645953270361,0.929241202634,018-BSG,0.141643966136,181,245,426
1951,-0.645953270361,0.929241202634,018-BSH,0.141643966136,169,145,314
1952,-0.645953270361,0.929241202634,018-BSJ,0.141643966136,138,246,384
1953,-0.645953270361,0.929241202634,018-BSL,0.141643966136,221,287,508
1954,-0.645953270361,0.929241202634,018-BSM,0.141643966136,144,235,379
1955,-0.645953270361,0.929241202634,018-BSP,0.141643966136,377,22,399
1956,-0.645953270361,0.929241202634,018-BSQ,0.141643966136,22,2,24
1957,-0.645953270361,0.929241202634,018-BSR,0.141643966136,396,14,410
1958,-0.645953270361,0.929241202634,018-BST,0.141643966136,503,10,513
1959,-0.645953270361,0.929241202634,018-BSX,0.141643966136,200,109,309
1960,-0.645953270361,0.929241202634,018-BSY,0.141643966136,279,151,430
1961,-0.645953270361,0.929241202634,018-BTA,0.141643966136,216,132,348
1962,-0.645953270361,0.929241202634,018-BTG,0.141643966136,166,70,236
1963,-0.645953270361,0.929241202634,018-BTH,0.141643966136,243,129,372
1964,-0.645953270361,0.929241202634,018-BTI,0.141643966136,201,118,319
1965,-0.645953270361,0.929241202634,018-BTM,0.141643966136,189,107,296
1966,-0.645953270361,0.929241202634,018-BTN,0.141643966136,249,187,436
1967,-0.645953270361,0.929241202634,018-BTO,0.141643966136,234,238,472
1968,-0.645953270361,0.929241202634,018-BTT,0.141643966136,255,227,482
1969,-0.645953270361,0.929241202634,018-BTU,0.141643966136,188,119,307
1970,-0.645953270361,0.929241202634,018-BTW,0.141643966136,231,193,424
1971,-0.645953270361,0.929241202634,018-BUA,0.141643966136,282,215,497
1972,-0.645953270361,0.929241202634,018-BUB,0.141643966136,254,190,444
1973,-0.645953270361,0.929241202634,018-BUD,0.141643966136,248,208,456
1974,-0.645953270361,0.929241202634,018-BUJ,0.141643966136,333,238,571
1975,-0.645953270361,0.929241202634,018-BUK,0.141643966136,286,227,513
1976,-0.645953270361,0.929241202634,018-BUL,0.141643966136,274,172,446
1977,-0.645953270361,0.929241202634,018-BUP,0.141643966136,197,346,543
1978,-0.645953270361,0.929241202634,018-BUQ,0.141643966136,135,283,418
1979,-0.645953270361,0.929241202634,018-BUS,0.141643966136,146,339,485
1980,-0.645953270361,0.929241202634,018-BUT,0.141643966136,110,257,367
1981,-0.645953270361,0.929241202634,018-BUW,0.141643966136,141,324,465
1982,-0.645953270361,0.929241202634,018-BUX,0.141643966136,164,303,467
1983,-0.645953270361,0.929241202634,018-BUZ,0.141643966136,138,289,427
1984,-0.645953270361,0.929241202634,018-BVA,0.141643966136,196,271,467
1985,-0.645953270361,0.929241202634,018-BVD,0.141643966136,243,536,779
1986,-0.645953270361,0.929241202634,018-BVF,0.141643966136,189,401,590
1987,-0.645953270361,0.929241202634,018-BVH,0.141643966136,167,486,653
1988,-0.645953270361,0.929241202634,018-BVI,0.141643966136,202,466,668
1989,-0.645953270361,0.929241202634,018-BVJ,0.141643966136,211,429,640
1990,-0.645953270361,0.929241202634,018-BVM,0.141643966136,178,280,458
1991,-0.645953270361,0.929241202634,018-BVO,0.141643966136,223,211,434
1992,-0.645953270361,0.929241202634,018-BVP,0.141643966136,208,149,357
1993,-0.645953270361,0.929241202634,018-BVQ,0.141643966136,169,137,306
1994,-0.645953270361,0.929241202634,018-BVR,0.141643966136,226,210,436
1995,-0.645953270361,0.929241202634,018-BVS,0.141643966136,264,246,510
1996,-0.645953270361,0.929241202634,018-BVU,0.141643966136,131,84,215
1997,-0.645953270361,0.929241202634,018-BVW,0.141643966136,202,159,361
1998,-0.645953270361,0.929241202634,018-BVX,0.141643966136,164,109,273
1999,-0.645953270361,0.929241202634,018-BWA,0.141643966136,224,158,382
2000,-0.645953270361,0.929241202634,018-BWG,0.141643966136,263,222,485
2001,-0.645953270361,0.929241202634,018-BWH,0.141643966136,215,134,349
2002,-0.645953270361,0.929241202634,018-BWI,0.141643966136,246,196,442
2003,-0.645953270361,0.929241202634,018-BWK,0.141643966136,207,111,318
2004,-0.645953270361,0.929241202634,018-BWL,0.141643966136,245,206,451
2005,-0.645953270361,0.929241202634,018-BWP,0.141643966136,178,163,341
2006,-0.645953270361,0.929241202634,018-BWQ,0.141643966136,212,154,366
2007,-0.645953270361,0.929241202634,018-BWR,0.141643966136,244,178,422
2008,-0.645953270361,0.929241202634,018-BWU,0.141643966136,218,129,347
2009,-0.645953270361,0.929241202634,018-BWV,0.141643966136,198,108,306
2010,-0.645953270361,0.929241202634,018-BXC,0.141643966136,238,314,552
2011,-0.645953270361,0.929241202634,018-BXF,0.141643966136,172,143,315
2012,-0.645953270361,0.929241202634,018-BXI,0.141643966136,269,188,457
2013,-0.645953270361,0.929241202634,018-BXJ,0.141643966136,187,107,294
2014,-0.645953270361,0.929241202634,018-BXK,0.141643966136,252,177,429
2015,-0.645953270361,0.929241202634,018-BXL,0.141643966136,210,151,361
2016,-0.645953270361,0.929241202634,018-BXM,0.141643966136,211,192,403
2017,-0.645953270361,0.929241202634,018-BXN,0.141643966136,192,155,347
2018,-0.645953270361,0.929241202634,018-BXO,0.141643966136,174,154,328
2019,-0.645953270361,0.929241202634,018-BXP,0.141643966136,174,116,290
2020,-0.645953270361,0.929241202634,018-BXV,0.141643966136,237,252,489
2021,-0.645953270361,0.929241202634,018-BXW,0.141643966136,196,128,324
2022,-0.645953270361,0.929241202634,018-BXX,0.141643966136,223,98,321
2023,-0.645953270361,0.929241202634,018-BXZ,0.141643966136,122,42,164
2024,-0.645953270361,0.929241202634,018-BYC,0.141643966136,209,143,352
2025,-0.645953270361,0.929241202634,018-BYD,0.141643966136,228,142,370
2026,-0.645953270361,0.929241202634,018-BYF,0.141643966136,142,70,212
2027,-0.645953270361,0.929241202634,018-BYG,0.141643966136,203,104,307
2028,-0.645953270361,0.929241202634,018-BYH,0.141643966136,153,57,210
2029,-0.645953270361,0.929241202634,018-BYJ,0.141643966136,220,137,357
2030,-0.645953270361,0.929241202634,018-BYK,0.141643966136,122,46,168
2031,-0.645953270361,0.929241202634,018-BYQ,0.141643966136,252,267,519
2032,-0.645953270361,0.929241202634,018-BYR,0.141643966136,231,330,561
2033,-0.645953270361,0.929241202634,018-BYS,0.141643966136,199,213,412
2034,-0.645953270361,0.929241202634,018-BYW,0.141643966136,211,252,463
2035,-0.645953270361,0.929241202634,018-BYX,0.141643966136,184,262,446
2036,-0.645953270361,0.929241202634,018-BYY,0.141643966136,146,232,378
2037,-0.645953270361,0.929241202634,018-BZB,0.141643966136,448,205,653
2038,-0.645953270361,0.929241202634,018-BZC,0.141643966136,266,268,534
2039,-0.645953270361,0.929241202634,018-BZD,0.141643966136,218,248,466
2040,-0.645953270361,0.929241202634,018-BZJ,0.141643966136,204,299,503
2041,-0.645953270361,0.929241202634,018-BZL,0.141643966136,259,281,540
2042,-0.645953270361,0.929241202634,018-BZM,0.141643966136,216,263,479
2043,-0.645953270361,0.929241202634,018-BZR,0.141643966136,371,181,552
2044,-0.645953270361,0.929241202634,018-BZS,0.141643966136,372,117,489
2045,-0.645953270361,0.929241202634,018-BZW,0.141643966136,258,116,374
2046,-0.645953270361,0.929241202634,018-BZX,0.141643966136,253,68,321
2047,-0.645953270361,0.929241202634,018-BZY,0.141643966136,233,64,297
2048,-0.645953270361,0.929241202634,018-CAC,0.141643966136,329,143,472
2049,-0.645953270361,0.929241202634,018-CAE,0.141643966136,306,91,397
2050,-0.645953270361,0.929241202634,018-CAG,0.141643966136,310,81,391
2051,-0.645953270361,0.929241202634,018-CAH,0.141643966136,339,47,386
2052,-0.645953270361,0.929241202634,018-CAJ,0.141643966136,303,45,348
2053,-0.645953270361,0.929241202634,018-CAL,0.141643966136,313,53,366
2054,-0.645953270361,0.929241202634,018-CAM,0.141643966136,281,45,326
2055,-0.645953270361,0.929241202634,018-CAN,0.141643966136,239,27,266
2056,-0.645953270361,0.929241202634,018-CAR,0.141643966136,324,33,357
2057,-0.645953270361,0.929241202634,018-CAS,0.141643966136,277,32,309
2058,-0.645953270361,0.929241202634,018-CAT,0.141643966136,326,35,361
2059,-0.645953270361,0.929241202634,018-CAW,0.141643966136,341,41,382
2060,-0.645953270361,0.929241202634,018-CAX,0.141643966136,370,53,423
2061,-0.645953270361,0.929241202634,018-CAY,0.141643966136,363,29,392
2062,-0.645953270361,0.929241202634,018-CBA,0.141643966136,133,44,177
2063,-0.645953270361,0.929241202634,018-CBC,0.141643966136,255,235,490
2064,-0.645953270361,0.929241202634,018-CBE,0.141643966136,189,67,256
2065,-0.645953270361,0.929241202634,018-CBI,0.141643966136,171,133,304
2066,-0.645953270361,0.929241202634,018-CBK,0.141643966136,277,184,461
2067,-0.645953270361,0.929241202634,018-CBM,0.141643966136,198,225,423
2068,-0.645953270361,0.929241202634,018-CBP,0.141643966136,214,238,452
2069,-0.645953270361,0.929241202634,018-CBR,0.141643966136,211,226,437
2070,-0.645953270361,0.929241202634,018-CBS,0.141643966136,250,239,489
2071,-0.645953270361,0.929241202634,018-CBT,0.141643966136,176,197,373
2072,-0.645953270361,0.929241202634,018-CBV,0.141643966136,123,165,288
2073,-0.645953270361,0.929241202634,018-CBX,0.141643966136,160,175,335
2074,-0.645953270361,0.929241202634,018-CBY,0.141643966136,204,72,276
2075,-0.645953270361,0.929241202634,018-CCA,0.141643966136,222,275,497
2076,-0.645953270361,0.929241202634,018-CCB,0.141643966136,240,231,471
2077,-0.645953270361,0.929241202634,018-CCH,0.141643966136,210,243,453
2078,-0.645953270361,0.929241202634,018-CCI,0.141643966136,113,157,270
2079,-0.645953270361,0.929241202634,018-CCJ,0.141643966136,126,181,307
2080,-0.645953270361,0.929241202634,018-CCK,0.141643966136,261,269,530
2081,-0.645953270361,0.929241202634,018-CCN,0.141643966136,189,290,479
2082,-0.645953270361,0.929241202634,018-CCO,0.141643966136,176,279,455
2083,-0.645953270361,0.929241202634,018-CCQ,0.141643966136,138,166,304
2084,-0.645953270361,0.929241202634,018-CCT,0.141643966136,204,325,529
2085,-0.645953270361,0.929241202634,018-CCV,0.141643966136,210,364,574
2086,-0.645953270361,0.929241202634,018-CCX,0.141643966136,191,337,528
2087,-0.645953270361,0.929241202634,018-CDB,0.141643966136,174,313,487
2088,-0.645953270361,0.929241202634,018-CDC,0.141643966136,182,286,468
2089,-0.645953270361,0.929241202634,018-CDD,0.141643966136,183,286,469
2090,-0.645953270361,0.929241202634,018-CDI,0.141643966136,266,363,629
2091,-0.645953270361,0.929241202634,018-CDJ,0.141643966136,199,330,529
2092,-0.645953270361,0.929241202634,018-CDL,0.141643966136,278,459,737
2093,-0.645953270361,0.929241202634,018-CDN,0.141643966136,165,294,459
2094,-0.645953270361,0.929241202634,018-CDP,0.141643966136,239,377,616
2095,-0.645953270361,0.929241202634,018-CDT,0.141643966136,187,260,447
2096,-0.645953270361,0.929241202634,018-CDU,0.141643966136,173,214,387
2097,-0.645953270361,0.929241202634,018-CDV,0.141643966136,221,390,611
2098,-0.645953270361,0.929241202634,018-CDY,0.141643966136,222,281,503
2099,-0.645953270361,0.929241202634,018-CDZ,0.141643966136,216,261,477
2100,-0.645953270361,0.929241202634,018-CEB,0.141643966136,220,330,550
2101,-0.645953270361,0.929241202634,018-CEE,0.141643966136,276,385,661
2102,-0.645953270361,0.929241202634,018-CEF,0.141643966136,51,95,146
2103,-0.645953270361,0.929241202634,018-CEG,0.141643966136,251,383,634
2104,-0.645953270361,0.929241202634,018-CEH,0.141643966136,186,333,519
2105,-0.645953270361,0.929241202634,018-CEJ,0.141643966136,276,318,594
2106,-0.645953270361,0.929241202634,018-CEK,0.141643966136,188,255,443
2107,-0.645953270361,0.929241202634,018-CEL,0.141643966136,224,290,514
2108,-0.645953270361,0.929241202634,018-CET,0.141643966136,259,325,584
2109,-0.645953270361,0.929241202634,018-CEV,0.141643966136,184,228,412
2110,-0.645953270361,0.929241202634,018-CEW,0.141643966136,173,137,310
2111,-0.645953270361,0.929241202634,018-CEX,0.141643966136,178,335,513
2112,-0.645953270361,0.929241202634,018-CEY,0.141643966136,191,222,413
2113,-0.645953270361,0.929241202634,018-CEZ,0.141643966136,229,252,481
2114,-0.645953270361,0.929241202634,018-CFD,0.141643966136,232,326,558
2115,-0.645953270361,0.929241202634,018-CFE,0.141643966136,178,391,569
2116,-0.645953270361,0.929241202634,018-CFG,0.141643966136,204,406,610
2117,-0.645953270361,0.929241202634,018-CFI,0.141643966136,171,445,616
2118,-0.645953270361,0.929241202634,018-CFJ,0.141643966136,175,378,553
2119,-0.645953270361,0.929241202634,018-CFK,0.141643966136,127,396,523
2120,-0.645953270361,0.929241202634,018-CFL,0.141643966136,43,112,155
2121,-0.645953270361,0.929241202634,018-CFQ,0.141643966136,116,358,474
2122,-0.645953270361,0.929241202634,018-CFR,0.141643966136,230,323,553
2123,-0.645953270361,0.929241202634,018-CFS,0.141643966136,163,372,535
2124,-0.645953270361,0.929241202634,018-CFT,0.141643966136,93,140,233
2125,-0.645953270361,0.929241202634,018-CFW,0.141643966136,187,370,557
2126,-0.645953270361,0.929241202634,018-CFY,0.141643966136,77,118,195
2127,-0.645953270361,0.929241202634,018-CFZ,0.141643966136,152,379,531
2128,-0.645953270361,0.929241202634,018-CGB,0.141643966136,94,98,192
2129,-0.645953270361,0.929241202634,018-CGC,0.141643966136,114,207,321
2130,-0.645953270361,0.929241202634,018-CGE,0.141643966136,192,303,495
2131,-0.645953270361,0.929241202634,018-CGF,0.141643966136,182,403,585
2132,-0.645953270361,0.929241202634,018-CGG,0.141643966136,140,226,366
2133,-0.645953270361,0.929241202634,018-CGH,0.141643966136,140,264,404
2134,-0.645953270361,0.929241202634,018-CGI,0.141643966136,145,397,542
2135,-0.645953270361,0.929241202634,018-CGK,0.141643966136,172,442,614
2136,-0.645953270361,0.929241202634,018-CGL,0.141643966136,143,398,541
2137,-0.645953270361,0.929241202634,018-CGN,0.141643966136,117,166,283
2138,-0.645953270361,0.929241202634,018-CGO,0.141643966136,148,255,403
2139,-0.645953270361,0.929241202634,018-CGP,0.141643966136,160,226,386
2140,-0.645953270361,0.929241202634,018-CGQ,0.141643966136,162,290,452
2141,-0.645953270361,0.929241202634,018-CGS,0.141643966136,208,354,562
2142,-0.645953270361,0.929241202634,018-CGT,0.141643966136,97,137,234
2143,-0.645953270361,0.929241202634,018-CGV,0.141643966136,128,200,328
2144,-0.645953270361,0.929241202634,018-CGW,0.141643966136,156,267,423
2145,-0.645953270361,0.929241202634,018-CGX,0.141643966136,130,154,284
2146,-0.645953270361,0.929241202634,018-CGY,0.141643966136,236,175,411
2147,-0.645953270361,0.929241202634,018-CHA,0.141643966136,163,328,491
2148,-0.645953270361,0.929241202634,018-CHC,0.141643966136,181,220,401
2149,-0.645953270361,0.929241202634,018-CHD,0.141643966136,65,44,109
2150,-0.645953270361,0.929241202634,018-CHE,0.141643966136,161,195,356
2151,-0.645953270361,0.929241202634,018-CHG,0.141643966136,172,140,312
2152,-0.645953270361,0.929241202634,018-CHL,0.141643966136,144,187,331
2153,-0.645953270361,0.929241202634,018-CHM,0.141643966136,194,192,386
2154,-0.645953270361,0.929241202634,018-CHQ,0.141643966136,161,185,346
2155,-0.645953270361,0.929241202634,018-CHR,0.141643966136,189,219,408
2156,-0.645953270361,0.929241202634,018-CHS,0.141643966136,144,171,315
2157,-0.645953270361,0.929241202634,018-CHU,0.141643966136,184,257,441
2158,-0.645953270361,0.929241202634,018-CHV,0.141643966136,241,251,492
2159,-0.645953270361,0.929241202634,018-CIC,0.141643966136,134,173,307
2160,-0.645953270361,0.929241202634,018-CID,0.141643966136,165,186,351
2161,-0.645953270361,0.929241202634,018-CIE,0.141643966136,136,178,314
2162,-0.645953270361,0.929241202634,018-CIF,0.141643966136,133,141,274
2163,-0.645953270361,0.929241202634,018-CIG,0.141643966136,175,188,363
2164,-0.645953270361,0.929241202634,018-CII,0.141643966136,170,182,352
2165,-0.645953270361,0.929241202634,018-CIJ,0.141643966136,150,206,356
2166,-0.645953270361,0.929241202634,018-CIP,0.141643966136,181,172,353
2167,-0.645953270361,0.929241202634,018-CIR,0.141643966136,120,127,247
2168,-0.645953270361,0.929241202634,018-CIS,0.141643966136,153,178,331
2169,-0.645953270361,0.929241202634,018-CIT,0.141643966136,144,237,381
2170,-0.645953270361,0.929241202634,018-CIU,0.141643966136,217,216,433
2171,-0.645953270361,0.929241202634,018-CIV,0.141643966136,179,185,364
2172,-0.645953270361,0.929241202634,018-CIW,0.141643966136,62,31,93
2173,-0.645953270361,0.929241202634,018-CJB,0.141643966136,221,288,509
2174,-0.645953270361,0.929241202634,018-CJE,0.141643966136,186,338,524
2175,-0.645953270361,0.929241202634,018-CJF,0.141643966136,187,400,587
2176,-0.645953270361,0.929241202634,018-CJG,0.141643966136,283,337,620
2177,-0.645953270361,0.929241202634,018-CJI,0.141643966136,249,373,622
2178,-0.645953270361,0.929241202634,018-CJJ,0.141643966136,227,411,638
2179,-0.645953270361,0.929241202634,018-CJP,0.141643966136,229,259,488
2180,-0.645953270361,0.929241202634,018-CJQ,0.141643966136,132,179,311
2181,-0.645953270361,0.929241202634,018-CJU,0.141643966136,235,328,563
2182,-0.645953270361,0.929241202634,018-CJV,0.141643966136,204,289,493
2183,-0.645953270361,0.929241202634,018-CJX,0.141643966136,263,379,642
2184,-0.645953270361,0.929241202634,018-CJY,0.141643966136,250,389,639
2185,-0.645953270361,0.929241202634,018-CKE,0.141643966136,263,428,691
2186,-0.645953270361,0.929241202634,018-CKF,0.141643966136,221,307,528
2187,-0.645953270361,0.929241202634,018-CKH,0.141643966136,240,342,582
2188,-0.645953270361,0.929241202634,018-CKI,0.141643966136,112,165,277
2189,-0.645953270361,0.929241202634,018-CKL,0.141643966136,267,312,579
2190,-0.645953270361,0.929241202634,018-CKM,0.141643966136,252,345,597
2191,-0.645953270361,0.929241202634,018-CKT,0.141643966136,130,154,284
2192,-0.645953270361,0.929241202634,018-CKU,0.141643966136,163,236,399
2193,-0.645953270361,0.929241202634,018-CKV,0.141643966136,199,277,476
2194,-0.645953270361,0.929241202634,018-CKW,0.141643966136,162,148,310
2195,-0.645953270361,0.929241202634,018-CKX,0.141643966136,171,226,397
2196,-0.645953270361,0.929241202634,018-CKY,0.141643966136,218,237,455
2197,-0.645953270361,0.929241202634,018-CLB,0.141643966136,153,181,334
2198,-0.645953270361,0.929241202634,018-CLH,0.141643966136,143,189,332
2199,-0.645953270361,0.929241202634,018-CLI,0.141643966136,169,175,344
2200,-0.645953270361,0.929241202634,018-CLK,0.141643966136,181,257,438
2201,-0.645953270361,0.929241202634,018-CLL,0.141643966136,207,215,422
2202,-0.645953270361,0.929241202634,018-CLO,0.141643966136,197,225,422
2203,-0.645953270361,0.929241202634,018-CLP,0.141643966136,183,245,428
2204,-0.645953270361,0.929241202634,018-CLQ,0.141643966136,152,164,316
2205,-0.645953270361,0.929241202634,018-CLV,0.141643966136,112,75,187
2206,-0.645953270361,0.929241202634,018-CLZ,0.141643966136,207,276,483
2207,-0.645953270361,0.929241202634,018-CMB,0.141643966136,211,286,497
2208,-0.645953270361,0.929241202634,018-CMD,0.141643966136,218,291,509
2209,-0.645953270361,0.929241202634,018-CME,0.141643966136,170,199,369
2210,-0.645953270361,0.929241202634,018-CMG,0.141643966136,218,261,479
2211,-0.645953270361,0.929241202634,018-CMJ,0.141643966136,231,305,536
2212,-0.645953270361,0.929241202634,018-CMK,0.141643966136,246,306,552
2213,-0.645953270361,0.929241202634,018-CMM,0.141643966136,223,148,371
2214,-0.645953270361,0.929241202634,018-CMO,0.141643966136,174,267,441
2215,-0.645953270361,0.929241202634,018-CMP,0.141643966136,194,298,492
2216,-0.645953270361,0.929241202634,018-CMR,0.141643966136,165,228,393
2217,-0.645953270361,0.929241202634,018-CMT,0.141643966136,193,214,407
2218,-0.645953270361,0.929241202634,018-CMU,0.141643966136,239,229,468
2219,-0.645953270361,0.929241202634,018-CMY,0.141643966136,302,278,580
2220,-0.645953270361,0.929241202634,018-CMZ,0.141643966136,248,310,558
2221,-0.645953270361,0.929241202634,018-CNA,0.141643966136,270,254,524
2222,-0.645953270361,0.929241202634,018-CNB,0.141643966136,259,399,658
2223,-0.645953270361,0.929241202634,018-CNE,0.141643966136,315,276,591
2224,-0.645953270361,0.929241202634,018-CNI,0.141643966136,356,224,580
2225,-0.645953270361,0.929241202634,018-CNJ,0.141643966136,162,15,177
2226,-0.645953270361,0.929241202634,018-CNM,0.141643966136,281,114,395
2227,-0.645953270361,0.929241202634,018-CNO,0.141643966136,332,154,486
2228,-0.645953270361,0.929241202634,018-CNQ,0.141643966136,267,178,445
2229,-0.645953270361,0.929241202634,018-CNR,0.141643966136,254,146,400
2230,-0.645953270361,0.929241202634,018-CNS,0.141643966136,160,99,259
2231,-0.645953270361,0.929241202634,018-CNV,0.141643966136,371,204,575
2232,-0.645953270361,0.929241202634,018-CNX,0.141643966136,348,183,531
2233,-0.645953270361,0.929241202634,018-COA,0.141643966136,206,430,636
2234,-0.645953270361,0.929241202634,018-COC,0.141643966136,146,322,468
2235,-0.645953270361,0.929241202634,018-COD,0.141643966136,202,382,584
2236,-0.645953270361,0.929241202634,018-COF,0.141643966136,162,483,645
2237,-0.645953270361,0.929241202634,018-COK,0.141643966136,218,391,609
2238,-0.645953270361,0.929241202634,018-COM,0.141643966136,212,372,584
2239,-0.645953270361,0.929241202634,018-COO,0.141643966136,194,369,563
2240,-0.645953270361,0.929241202634,018-COP,0.141643966136,230,338,568
2241,-0.645953270361,0.929241202634,018-COU,0.141643966136,194,344,538
2242,-0.645953270361,0.929241202634,018-COV,0.141643966136,212,385,597
2243,-0.645953270361,0.929241202634,018-COW,0.141643966136,179,367,546
2244,-0.645953270361,0.929241202634,018-COX,0.141643966136,240,289,529
2245,-0.645953270361,0.929241202634,018-CPD,0.141643966136,156,249,405
2246,-0.645953270361,0.929241202634,018-CPE,0.141643966136,185,278,463
2247,-0.645953270361,0.929241202634,018-CPH,0.141643966136,230,362,592
2248,-0.645953270361,0.929241202634,018-CPI,0.141643966136,203,332,535
2249,-0.645953270361,0.929241202634,018-CPM,0.141643966136,231,421,652
2250,-0.645953270361,0.929241202634,018-CPO,0.141643966136,279,417,696
2251,-0.645953270361,0.929241202634,018-CPS,0.141643966136,252,390,642
2252,-0.645953270361,0.929241202634,018-CPT,0.141643966136,265,338,603
2253,-0.645953270361,0.929241202634,018-CPX,0.141643966136,264,401,665
2254,-0.645953270361,0.929241202634,018-CPY,0.141643966136,233,428,661
2255,-0.645953270361,0.929241202634,018-CQB,0.141643966136,249,457,706
2256,-0.645953270361,0.929241202634,018-CQC,0.141643966136,236,363,599
2257,-0.645953270361,0.929241202634,018-CQG,0.141643966136,353,213,566
2258,-0.645953270361,0.929241202634,018-CQJ,0.141643966136,462,147,609
2259,-0.645953270361,0.929241202634,018-CQK,0.141643966136,381,48,429
2260,-0.645953270361,0.929241202634,018-CQL,0.141643966136,474,92,566
2261,-0.645953270361,0.929241202634,018-CQM,0.141643966136,394,113,507
2262,-0.645953270361,0.929241202634,018-CQN,0.141643966136,352,66,418
2263,-0.645953270361,0.929241202634,018-CQO,0.141643966136,433,136,569
2264,-0.645953270361,0.929241202634,018-CQQ,0.141643966136,428,131,559
2265,-0.645953270361,0.929241202634,018-CQR,0.141643966136,268,41,309
2266,-0.645953270361,0.929241202634,018-CQU,0.141643966136,276,61,337
2267,-0.645953270361,0.929241202634,018-CQV,0.141643966136,365,19,384
2268,-0.645953270361,0.929241202634,018-CQW,0.141643966136,494,28,522
2269,-0.645953270361,0.929241202634,018-CQZ,0.141643966136,349,231,580
2270,-0.645953270361,0.929241202634,018-CRA,0.141643966136,391,128,519
2271,-0.645953270361,0.929241202634,018-CRB,0.141643966136,336,221,557
2272,-0.645953270361,0.929241202634,018-CRE,0.141643966136,340,232,572
2273,-0.645953270361,0.929241202634,018-CRG,0.141643966136,390,36,426
2274,-0.645953270361,0.929241202634,018-CRI,0.141643966136,461,66,527
2275,-0.645953270361,0.929241202634,018-CRK,0.141643966136,454,20,474
2276,-0.645953270361,0.929241202634,018-CRQ,0.141643966136,314,136,450
2277,-0.645953270361,0.929241202634,018-CRS,0.141643966136,356,166,522
2278,-0.645953270361,0.929241202634,018-CRW,0.141643966136,283,275,558
2279,-0.645953270361,0.929241202634,018-CRY,0.141643966136,440,212,652
2280,-0.645953270361,0.929241202634,018-CSA,0.141643966136,279,275,554
2281,-0.645953270361,0.929241202634,018-CSD,0.141643966136,243,368,611
2282,-0.645953270361,0.929241202634,018-CSE,0.141643966136,208,226,434
2283,-0.645953270361,0.929241202634,018-CSF,0.141643966136,205,249,454
2284,-0.645953270361,0.929241202634,018-CSH,0.141643966136,262,331,593
2285,-0.645953270361,0.929241202634,018-CSI,0.141643966136,253,131,384
2286,-0.645953270361,0.929241202634,018-CSJ,0.141643966136,220,388,608
2287,-0.645953270361,0.929241202634,018-CSK,0.141643966136,236,368,604
2288,-0.645953270361,0.929241202634,018-CSL,0.141643966136,201,337,538
2289,-0.645953270361,0.929241202634,018-CSM,0.141643966136,220,254,474
2290,-0.645953270361,0.929241202634,018-CSN,0.141643966136,200,272,472
2291,-0.645953270361,0.929241202634,018-CSO,0.141643966136,200,243,443
2292,-0.645953270361,0.929241202634,018-CSR,0.141643966136,296,203,499
2293,-0.645953270361,0.929241202634,018-CSS,0.141643966136,299,312,611
2294,-0.645953270361,0.929241202634,018-CST,0.141643966136,221,175,396
2295,-0.645953270361,0.929241202634,018-CSV,0.141643966136,278,291,569
2296,-0.645953270361,0.929241202634,018-CSX,0.141643966136,260,274,534
2297,-0.645953270361,0.929241202634,018-CSZ,0.141643966136,200,328,528
2298,-0.645953270361,0.929241202634,018-CTA,0.141643966136,211,304,515
2299,-0.645953270361,0.929241202634,018-CTD,0.141643966136,388,137,525
2300,-0.645953270361,0.929241202634,018-CTE,0.141643966136,430,227,657
2301,-0.645953270361,0.929241202634,018-CTG,0.141643966136,462,78,540
2302,-0.645953270361,0.929241202634,018-CTI,0.141643966136,393,83,476
2303,-0.645953270361,0.929241202634,018-CTM,0.141643966136,261,149,410
2304,-0.645953270361,0.929241202634,018-CTN,0.141643966136,250,190,440
2305,-0.645953270361,0.929241202634,018-CTP,0.141643966136,234,141,375
2306,-0.645953270361,0.929241202634,018-CTR,0.141643966136,306,235,541
2307,-0.645953270361,0.929241202634,018-CTS,0.141643966136,264,159,423
2308,-0.645953270361,0.929241202634,018-CTW,0.141643966136,382,100,482
2309,-0.645953270361,0.929241202634,018-CTX,0.141643966136,191,289,480
2310,-0.645953270361,0.929241202634,018-CTY,0.141643966136,270,189,459
2311,-0.645953270361,0.929241202634,018-CTZ,0.141643966136,364,80,444
2312,-0.645953270361,0.929241202634,018-CUF,0.141643966136,296,230,526
2313,-0.645953270361,0.929241202634,018-CUG,0.141643966136,302,68,370
2314,-0.645953270361,0.929241202634,018-CUI,0.141643966136,501,58,559
2315,-0.645953270361,0.929241202634,018-CUJ,0.141643966136,295,86,381
2316,-0.645953270361,0.929241202634,018-CUQ,0.141643966136,226,409,635
2317,-0.645953270361,0.929241202634,018-CUR,0.141643966136,163,374,537
2318,-0.645953270361,0.929241202634,018-CUS,0.141643966136,233,436,669
2319,-0.645953270361,0.929241202634,018-CUT,0.141643966136,164,344,508
2320,-0.645953270361,0.929241202634,018-CUU,0.141643966136,188,291,479
2321,-0.645953270361,0.929241202634,018-CUV,0.141643966136,55,110,165
2322,-0.645953270361,0.929241202634,018-CUW,0.141643966136,58,56,114
2323,-0.645953270361,0.929241202634,018-CUX,0.141643966136,215,357,572
2324,-0.645953270361,0.929241202634,018-CUY,0.141643966136,69,69,138
2325,-0.645953270361,0.929241202634,018-CVD,0.141643966136,203,377,580
2326,-0.645953270361,0.929241202634,018-CVE,0.141643966136,190,392,582
2327,-0.645953270361,0.929241202634,018-CVF,0.141643966136,158,340,498
2328,-0.645953270361,0.929241202634,018-CVI,0.141643966136,122,414,536
2329,-0.645953270361,0.929241202634,018-CVJ,0.141643966136,149,385,534
2330,-0.645953270361,0.929241202634,018-CVK,0.141643966136,184,442,626
2331,-0.645953270361,0.929241202634,018-CVN,0.141643966136,147,316,463
2332,-0.645953270361,0.929241202634,018-CVO,0.141643966136,107,213,320
2333,-0.645953270361,0.929241202634,018-CVP,0.141643966136,178,384,562
2334,-0.645953270361,0.929241202634,018-CVQ,0.141643966136,185,363,548
2335,-0.645953270361,0.929241202634,018-CVS,0.141643966136,157,235,392
2336,-0.645953270361,0.929241202634,018-CVT,0.141643966136,192,382,574
2337,-0.645953270361,0.929241202634,018-CVU,0.141643966136,108,375,483
2338,-0.645953270361,0.929241202634,018-CVW,0.141643966136,169,265,434
2339,-0.645953270361,0.929241202634,018-CVX,0.141643966136,240,396,636
2340,-0.645953270361,0.929241202634,018-CVY,0.141643966136,124,330,454
2341,-0.645953270361,0.929241202634,018-CWA,0.141643966136,120,190,310
2342,-0.645953270361,0.929241202634,018-CWB,0.141643966136,180,430,610
2343,-0.645953270361,0.929241202634,018-CWC,0.141643966136,166,324,490
2344,-0.645953270361,0.929241202634,018-CWG,0.141643966136,134,207,341
2345,-0.645953270361,0.929241202634,018-CWH,0.141643966136,175,420,595
2346,-0.645953270361,0.929241202634,018-CWI,0.141643966136,130,252,382
2347,-0.645953270361,0.929241202634,018-CWJ,0.141643966136,137,270,407
2348,-0.645953270361,0.929241202634,018-CWK,0.141643966136,111,334,445
2349,-0.645953270361,0.929241202634,018-CWL,0.141643966136,157,305,462
2350,-0.645953270361,0.929241202634,018-CWM,0.141643966136,155,379,534
2351,-0.645953270361,0.929241202634,018-CWO,0.141643966136,411,45,456
2352,-0.645953270361,0.929241202634,018-CWQ,0.141643966136,337,112,449
2353,-0.645953270361,0.929241202634,018-CWS,0.141643966136,373,85,458
2354,-0.645953270361,0.929241202634,018-CWT,0.141643966136,262,104,366
2355,-0.645953270361,0.929241202634,018-CWW,0.141643966136,319,159,478
2356,-0.645953270361,0.929241202634,018-CWX,0.141643966136,293,264,557
2357,-0.645953270361,0.929241202634,018-CWZ,0.141643966136,218,250,468
2358,-0.645953270361,0.929241202634,018-CXA,0.141643966136,214,165,379
2359,-0.645953270361,0.929241202634,018-CXC,0.141643966136,67,97,164
2360,-0.645953270361,0.929241202634,018-CXD,0.141643966136,342,252,594
2361,-0.645953270361,0.929241202634,018-CYE,0.141643966136,202,499,701
2362,-0.645953270361,0.929241202634,018-CYG,0.141643966136,236,513,749
2363,-0.645953270361,0.929241202634,018-CYH,0.141643966136,120,252,372
2364,-0.645953270361,0.929241202634,018-CYJ,0.141643966136,158,352,510
2365,-0.645953270361,0.929241202634,018-CYL,0.141643966136,175,342,517
2366,-0.645953270361,0.929241202634,018-CYN,0.141643966136,188,341,529
2367,-0.645953270361,0.929241202634,018-CYP,0.141643966136,162,338,500
2368,-0.645953270361,0.929241202634,018-CYQ,0.141643966136,216,400,616
2369,-0.645953270361,0.929241202634,018-CYR,0.141643966136,158,313,471
2370,-0.645953270361,0.929241202634,018-CYT,0.141643966136,158,203,361
2371,-0.645953270361,0.929241202634,018-CYV,0.141643966136,105,143,248
2372,-0.645953270361,0.929241202634,018-CYW,0.141643966136,126,169,295
2373,-0.645953270361,0.929241202634,018-CYX,0.141643966136,80,76,156
2374,-0.645953270361,0.929241202634,018-CYY,0.141643966136,160,356,516
2375,-0.645953270361,0.929241202634,018-CYZ,0.141643966136,175,361,536
2376,-0.645953270361,0.929241202634,018-CZA,0.141643966136,188,310,498
2377,-0.645953270361,0.929241202634,018-CZC,0.141643966136,185,370,555
2378,-0.645953270361,0.929241202634,018-CZE,0.141643966136,136,515,651
2379,-0.645953270361,0.929241202634,018-CZF,0.141643966136,184,386,570
2380,-0.645953270361,0.929241202634,018-CZG,0.141643966136,183,383,566
2381,-0.645953270361,0.929241202634,018-CZJ,0.141643966136,148,308,456
2382,-0.645953270361,0.929241202634,018-CZM,0.141643966136,82,286,368
2383,-0.645953270361,0.929241202634,018-CZN,0.141643966136,198,475,673
2384,-0.645953270361,0.929241202634,018-CZO,0.141643966136,144,437,581
2385,-0.645953270361,0.929241202634,018-CZP,0.141643966136,201,437,638
2386,-0.645953270361,0.929241202634,018-CZS,0.141643966136,118,330,448
2387,-0.645953270361,0.929241202634,018-CZT,0.141643966136,381,376,757
2388,-0.645953270361,0.929241202634,018-CZW,0.141643966136,19,6,25
2389,-0.645953270361,0.929241202634,018-CZX,0.141643966136,233,346,579
2390,-0.645953270361,0.929241202634,018-DAA,0.141643966136,157,378,535
2391,-0.645953270361,0.929241202634,018-DAB,0.141643966136,137,209,346
2392,-0.645953270361,0.929241202634,018-DAD,0.141643966136,153,338,491
2393,-0.645953270361,0.929241202634,018-DAE,0.141643966136,174,309,483
2394,-0.645953270361,0.929241202634,018-DAF,0.141643966136,20,47,67
2395,-0.645953270361,0.929241202634,018-DAH,0.141643966136,276,218,494
2396,-0.645953270361,0.929241202634,018-DAI,0.141643966136,303,254,557
2397,-0.645953270361,0.929241202634,018-DAJ,0.141643966136,333,215,548
2398,-0.645953270361,0.929241202634,018-DAK,0.141643966136,73,33,106
2399,-0.645953270361,0.929241202634,018-DAL,0.141643966136,48,53,101
2400,-0.645953270361,0.929241202634,018-DAM,0.141643966136,54,13,67
2401,-0.645953270361,0.929241202634,018-DAN,0.141643966136,65,250,315
2402,-0.645953270361,0.929241202634,018-DAO,0.141643966136,111,84,195
2403,-0.645953270361,0.929241202634,018-DAP,0.141643966136,117,107,224
2404,-0.645953270361,0.929241202634,018-DAS,0.141643966136,344,57,401
2405,-0.645953270361,0.929241202634,018-DAW,0.141643966136,403,14,417
2406,-0.645953270361,0.929241202634,018-DAX,0.141643966136,123,31,154
2407,-0.645953270361,0.929241202634,018-DAY,0.141643966136,14,7,21
2408,-0.645953270361,0.929241202634,018-DAZ,0.141643966136,142,76,218
2409,-0.645953270361,0.929241202634,018-DBA,0.141643966136,10,2,12
2410,-0.645953270361,0.929241202634,018-DBC,0.141643966136,217,22,239
2411,-0.645953270361,0.929241202634,018-DBD,0.141643966136,229,281,510
2412,-0.645953270361,0.929241202634,018-DBF,0.141643966136,108,202,310
2413,-0.645953270361,0.929241202634,018-DBG,0.141643966136,172,249,421
2414,-0.645953270361,0.929241202634,018-DBH,0.141643966136,172,360,532
2415,-0.645953270361,0.929241202634,018-DBI,0.141643966136,198,280,478
2416,-0.645953270361,0.929241202634,018-DBJ,0.141643966136,154,346,500
2417,-0.645953270361,0.929241202634,018-DBK,0.141643966136,187,342,529
2418,-0.645953270361,0.929241202634,018-DBM,0.141643966136,138,194,332
2419,-0.645953270361,0.929241202634,018-DBN,0.141643966136,191,360,551
2420,-0.645953270361,0.929241202634,018-DBO,0.141643966136,135,146,281
2421,-0.645953270361,0.929241202634,018-DBU,0.141643966136,129,239,368
2422,-0.645953270361,0.929241202634,018-DBV,0.141643966136,304,341,645
2423,-0.645953270361,0.929241202634,018-DBW,0.141643966136,282,353,635
2424,-0.645953270361,0.929241202634,018-DBX,0.141643966136,140,454,594
2425,-0.645953270361,0.929241202634,018-DBY,0.141643966136,184,494,678
2426,-0.645953270361,0.929241202634,018-DCC,0.141643966136,118,251,369
2427,-0.645953270361,0.929241202634,018-DCE,0.141643966136,121,236,357
2428,-0.645953270361,0.929241202634,018-DCG,0.141643966136,121,285,406
2429,-0.645953270361,0.929241202634,018-DCI,0.141643966136,126,187,313
2430,-0.645953270361,0.929241202634,018-DCK,0.141643966136,149,237,386
2431,-0.645953270361,0.929241202634,018-DCM,0.141643966136,143,336,479
2432,-0.645953270361,0.929241202634,018-DCN,0.141643966136,193,392,585
2433,-0.645953270361,0.929241202634,018-DCO,0.141643966136,218,347,565
2434,-0.645953270361,0.929241202634,018-DCQ,0.141643966136,278,44,322
2435,-0.645953270361,0.929241202634,018-DCS,0.141643966136,244,6,250
2436,-0.645953270361,0.929241202634,018-DCU,0.141643966136,116,154,270
2437,-0.645953270361,0.929241202634,018-DCW,0.141643966136,224,32,256
2438,-0.645953270361,0.929241202634,018-DDR,0.141643966136,129,24,153
2439,-0.645953270361,0.929241202634,018-DDS,0.141643966136,84,2,86
2440,-0.645953270361,0.929241202634,018-DDT,0.141643966136,164,9,173
2441,-0.645953270361,0.929241202634,018-DDX,0.141643966136,50,1,51
2442,-0.645953270361,0.929241202634,018-DDY,0.141643966136,72,0,72
2443,-0.645953270361,0.929241202634,018-DDZ,0.141643966136,165,5,170
2444,-0.645953270361,0.929241202634,018-DEA,0.141643966136,130,45,175
2445,-0.645953270361,0.929241202634,018-DEC,0.141643966136,182,301,483
2446,-0.645953270361,0.929241202634,018-DEH,0.141643966136,150,333,483
2447,-0.645953270361,0.929241202634,018-DEI,0.141643966136,422,13,435
2448,-0.645953270361,0.929241202634,018-DEJ,0.141643966136,398,12,410
2449,-0.645953270361,0.929241202634,018-DEK,0.141643966136,374,5,379
2450,-0.645953270361,0.929241202634,018-DEL,0.141643966136,315,4,319
2451,-0.645953270361,0.929241202634,018-DEM,0.141643966136,282,8,290
2452,-0.645953270361,0.929241202634,018-DEN,0.141643966136,296,19,315
2453,-0.645953270361,0.929241202634,018-DEO,0.141643966136,279,7,286
2454,-0.645953270361,0.929241202634,018-DEP,0.141643966136,347,10,357
2455,-0.645953270361,0.929241202634,018-DER,0.141643966136,298,21,319
2456,-0.645953270361,0.929241202634,018-DES,0.141643966136,294,4,298
2457,-0.645953270361,0.929241202634,018-DET,0.141643966136,263,2,265
2458,-0.645953270361,0.929241202634,018-DEU,0.141643966136,190,18,208
2459,-0.645953270361,0.929241202634,018-DEV,0.141643966136,251,5,256
2460,-0.645953270361,0.929241202634,018-DEX,0.141643966136,472,45,517
2461,-0.645953270361,0.929241202634,018-DFD,0.141643966136,146,323,469
2462,-0.645953270361,0.929241202634,018-DFF,0.141643966136,143,161,304
2463,-0.645953270361,0.929241202634,018-DFI,0.141643966136,200,569,769
2464,-0.645953270361,0.929241202634,019-AAA,0.141643966136,93,207,300
2465,-0.645953270361,0.929241202634,019-AAB,0.141643966136,99,249,348
2466,-0.645953270361,0.929241202634,019-AAC,0.141643966136,75,281,356
2467,-0.645953270361,0.929241202634,019-AAD,0.141643966136,92,177,269
2468,-0.645953270361,0.929241202634,019-AAE,0.141643966136,75,215,290
2469,-0.645953270361,0.929241202634,019-AAF,0.141643966136,93,222,315
2470,-0.645953270361,0.929241202634,019-AAG,0.141643966136,90,204,294
2471,-0.645953270361,0.929241202634,019-AAH,0.141643966136,94,212,306
2472,-0.645953270361,0.929241202634,019-AAI,0.141643966136,136,391,527
2473,-0.645953270361,0.929241202634,019-AAJ,0.141643966136,62,172,234
2474,-0.645953270361,0.929241202634,019-AAK,0.141643966136,126,410,536
2475,-0.645953270361,0.929241202634,019-AAL,0.141643966136,65,186,251
2476,-0.645953270361,0.929241202634,019-AAM,0.141643966136,100,346,446
2477,-0.645953270361,0.929241202634,019-AAN,0.141643966136,118,454,572
2478,-0.645953270361,0.929241202634,019-AAO,0.141643966136,67,329,396
2479,-0.645953270361,0.929241202634,019-AAR,0.141643966136,149,445,594
2480,-0.645953270361,0.929241202634,019-AAS,0.141643966136,76,416,492
2481,-0.645953270361,0.929241202634,019-AAT,0.141643966136,63,306,369
2482,-0.645953270361,0.929241202634,019-AAU,0.141643966136,89,288,377
2483,-0.645953270361,0.929241202634,019-AAV,0.141643966136,79,416,495
2484,-0.645953270361,0.929241202634,019-AAW,0.141643966136,110,428,538
2485,-0.645953270361,0.929241202634,019-AAX,0.141643966136,65,318,383
2486,-0.645953270361,0.929241202634,019-AAZ,0.141643966136,114,387,501
2487,-0.645953270361,0.929241202634,019-ABA,0.141643966136,55,261,316
2488,-0.645953270361,0.929241202634,019-ABC,0.141643966136,103,273,376
2489,-0.645953270361,0.929241202634,019-ABD,0.141643966136,108,177,285
2490,-0.645953270361,0.929241202634,019-ABF,0.141643966136,79,228,307
2491,-0.645953270361,0.929241202634,019-ABG,0.141643966136,68,209,277
2492,-0.645953270361,0.929241202634,019-ABH,0.141643966136,104,571,675
2493,-0.645953270361,0.929241202634,019-ABJ,0.141643966136,100,357,457
2494,-0.645953270361,0.929241202634,019-ABK,0.141643966136,81,191,272
2495,-0.645953270361,0.929241202634,019-ABL,0.141643966136,70,454,524
2496,-0.645953270361,0.929241202634,019-ABN,0.141643966136,66,264,330
2497,-0.645953270361,0.929241202634,019-ABP,0.141643966136,136,654,790
2498,-0.645953270361,0.929241202634,019-ABQ,0.141643966136,87,408,495
2499,-0.645953270361,0.929241202634,019-ABR,0.141643966136,59,271,330
2500,-0.645953270361,0.929241202634,019-ABS,0.141643966136,90,499,589
2501,-0.645953270361,0.929241202634,019-ABT,0.141643966136,81,352,433
2502,-0.645953270361,0.929241202634,019-ABU,0.141643966136,100,337,437
2503,-0.645953270361,0.929241202634,019-ABV,0.141643966136,110,597,707
2504,-0.645953270361,0.929241202634,019-ABX,0.141643966136,117,356,473
2505,-0.645953270361,0.929241202634,019-ABY,0.141643966136,87,421,508
2506,-0.645953270361,0.929241202634,019-ACA,0.141643966136,48,153,201
2507,-0.645953270361,0.929241202634,020-AAA,0.141643966136,110,237,347
2508,-0.645953270361,0.929241202634,020-AAB,0.141643966136,170,358,528
2509,-0.645953270361,0.929241202634,020-AAD,0.141643966136,131,221,352
2510,-0.645953270361,0.929241202634,020-AAE,0.141643966136,178,206,384
2511,-0.645953270361,0.929241202634,020-AAF,0.141643966136,109,190,299
2512,-0.645953270361,0.929241202634,020-AAH,0.141643966136,71,88,159
2513,-0.645953270361,0.929241202634,020-AAI,0.141643966136,132,178,310
2514,-0.645953270361,0.929241202634,020-AAJ,0.141643966136,112,164,276
2515,-0.645953270361,0.929241202634,020-AAK,0.141643966136,90,107,197
2516,-0.645953270361,0.929241202634,020-AAL,0.141643966136,174,239,413
2517,-0.645953270361,0.929241202634,020-AAM,0.141643966136,85,128,213
2518,-0.645953270361,0.929241202634,020-AAN,0.141643966136,97,316,413
2519,-0.645953270361,0.929241202634,020-AAP,0.141643966136,82,95,177
2520,-0.645953270361,0.929241202634,020-AAQ,0.141643966136,72,124,196
2521,-0.645953270361,0.929241202634,020-AAR,0.141643966136,146,242,388
2522,-0.645953270361,0.929241202634,020-AAS,0.141643966136,81,148,229
2523,-0.645953270361,0.929241202634,020-AAT,0.141643966136,103,313,416
2524,-0.645953270361,0.929241202634,020-AAU,0.141643966136,87,177,264
2525,-0.645953270361,0.929241202634,020-AAV,0.141643966136,134,289,423
2526,-0.645953270361,0.929241202634,020-AAW,0.141643966136,147,307,454
2527,-0.645953270361,0.929241202634,020-AAY,0.141643966136,75,153,228
2528,-0.645953270361,0.929241202634,020-AAZ,0.141643966136,86,243,329
2529,-0.645953270361,0.929241202634,020-ABA,0.141643966136,105,371,476
2530,-0.645953270361,0.929241202634,020-ABB,0.141643966136,70,175,245
2531,-0.645953270361,0.929241202634,020-ABC,0.141643966136,69,187,256
2532,-0.645953270361,0.929241202634,020-ABD,0.141643966136,81,226,307
2533,-0.645953270361,0.929241202634,020-ABG,0.141643966136,133,283,416
2534,-0.645953270361,0.929241202634,020-ABH,0.141643966136,149,301,450
2535,-0.645953270361,0.929241202634,020-ABJ,0.141643966136,86,169,255
2536,-0.645953270361,0.929241202634,020-ABK,0.141643966136,61,226,287
2537,-0.645953270361,0.929241202634,020-ABL,0.141643966136,131,210,341
2538,-0.645953270361,0.929241202634,020-ABM,0.141643966136,145,334,479
2539,-0.645953270361,0.929241202634,020-ABN,0.141643966136,92,152,244
2540,-0.645953270361,0.929241202634,020-ABO,0.141643966136,103,238,341
2541,-0.645953270361,0.929241202634,020-ABQ,0.141643966136,104,163,267
2542,-0.645953270361,0.929241202634,020-ABR,0.141643966136,58,159,217
2543,-0.645953270361,0.929241202634,020-ABS,0.141643966136,27,54,81
2544,-0.645953270361,0.929241202634,020-ABT,0.141643966136,126,296,422
2545,-0.645953270361,0.929241202634,021-AAA,0.141643966136,197,374,571
2546,-0.645953270361,0.929241202634,021-AAB,0.141643966136,118,185,303
2547,-0.645953270361,0.929241202634,021-AAC,0.141643966136,177,344,521
2548,-0.645953270361,0.929241202634,021-AAD,0.141643966136,101,218,319
2549,-0.645953270361,0.929241202634,021-AAE,0.141643966136,102,191,293
2550,-0.645953270361,0.929241202634,021-AAF,0.141643966136,118,247,365
2551,-0.645953270361,0.929241202634,021-AAG,0.141643966136,67,152,219
2552,-0.645953270361,0.929241202634,021-AAH,0.141643966136,151,314,465
2553,-0.645953270361,0.929241202634,021-AAI,0.141643966136,225,551,776
2554,-0.645953270361,0.929241202634,021-AAJ,0.141643966136,174,374,548
2555,-0.645953270361,0.929241202634,021-AAK,0.141643966136,106,209,315
2556,-0.645953270361,0.929241202634,021-AAL,0.141643966136,133,186,319
2557,-0.645953270361,0.929241202634,021-AAM,0.141643966136,80,95,175
2558,-0.645953270361,0.929241202634,021-AAN,0.141643966136,76,139,215
2559,-0.645953270361,0.929241202634,021-AAO,0.141643966136,88,159,247
2560,-0.645953270361,0.929241202634,021-AAP,0.141643966136,141,289,430
2561,-0.645953270361,0.929241202634,021-AAQ,0.141643966136,152,296,448
2562,-0.645953270361,0.929241202634,021-AAR,0.141643966136,208,242,450
2563,-0.645953270361,0.929241202634,021-AAS,0.141643966136,214,227,441
2564,-0.645953270361,0.929241202634,021-AAT,0.141643966136,205,214,419
2565,-0.645953270361,0.929241202634,021-AAU,0.141643966136,94,128,222
2566,-0.645953270361,0.929241202634,021-AAV,0.141643966136,159,395,554
2567,-0.645953270361,0.929241202634,021-AAW,0.141643966136,87,141,228
2568,-0.645953270361,0.929241202634,021-AAY,0.141643966136,99,349,448
2569,-0.645953270361,0.929241202634,021-AAZ,0.141643966136,82,344,426
2570,-0.645953270361,0.929241202634,021-ABA,0.141643966136,131,469,600
2571,-0.645953270361,0.929241202634,021-ABB,0.141643966136,117,487,604
2572,-0.645953270361,0.929241202634,021-ABC,0.141643966136,125,266,391
2573,-0.645953270361,0.929241202634,021-ABD,0.141643966136,212,555,767
2574,-0.645953270361,0.929241202634,021-ABE,0.141643966136,110,332,442
2575,-0.645953270361,0.929241202634,021-ABF,0.141643966136,154,389,543
2576,-0.645953270361,0.929241202634,021-ABG,0.141643966136,161,395,556
2577,-0.645953270361,0.929241202634,021-ABH,0.141643966136,71,184,255
2578,-0.645953270361,0.929241202634,021-ABI,0.141643966136,99,330,429
2579,-0.645953270361,0.929241202634,021-ABJ,0.141643966136,183,604,787
2580,-0.645953270361,0.929241202634,021-ABK,0.141643966136,139,408,547
2581,-0.645953270361,0.929241202634,021-ABL,0.141643966136,91,311,402
2582,-0.645953270361,0.929241202634,021-ABM,0.141643966136,122,274,396
2583,-0.645953270361,0.929241202634,021-ABN,0.141643966136,134,416,550
2584,-0.645953270361,0.929241202634,021-ABO,0.141643966136,105,435,540
2585,-0.645953270361,0.929241202634,021-ABP,0.141643966136,74,200,274
2586,-0.645953270361,0.929241202634,021-ABQ,0.141643966136,147,458,605
2587,-0.645953270361,0.929241202634,021-ABS,0.141643966136,135,385,520
2588,-0.645953270361,0.929241202634,021-ABT,0.141643966136,157,735,892
2589,-0.645953270361,0.929241202634,021-ABU,0.141643966136,155,553,708
2590,-0.645953270361,0.929241202634,021-ABV,0.141643966136,48,199,247
2591,-0.645953270361,0.929241202634,021-ABW,0.141643966136,97,190,287
2592,-0.645953270361,0.929241202634,021-ABX,0.141643966136,72,206,278
2593,-0.645953270361,0.929241202634,021-ABY,0.141643966136,114,420,534
2594,-0.645953270361,0.929241202634,021-ABZ,0.141643966136,125,383,508
2595,-0.645953270361,0.929241202634,021-ACA,0.141643966136,90,317,407
2596,-0.645953270361,0.929241202634,021-ACB,0.141643966136,138,456,594
2597,-0.645953270361,0.929241202634,021-ACC,0.141643966136,202,352,554
2598,-0.645953270361,0.929241202634,021-ACD,0.141643966136,137,705,842
2599,-0.645953270361,0.929241202634,021-ACE,0.141643966136,130,379,509
2600,-0.645953270361,0.929241202634,021-ACF,0.141643966136,144,375,519
2601,-0.645953270361,0.929241202634,021-ACG,0.141643966136,221,521,742
2602,-0.645953270361,0.929241202634,021-ACH,0.141643966136,96,401,497
2603,-0.645953270361,0.929241202634,021-ACI,0.141643966136,144,438,582
2604,-0.645953270361,0.929241202634,021-ACJ,0.141643966136,113,379,492
2605,-0.645953270361,0.929241202634,021-ACK,0.141643966136,70,156,226
2606,-0.645953270361,0.929241202634,021-ACL,0.141643966136,101,371,472
2607,-0.645953270361,0.929241202634,021-ACM,0.141643966136,88,369,457
2608,-0.645953270361,0.929241202634,021-ACN,0.141643966136,126,398,524
2609,-0.645953270361,0.929241202634,021-ACO,0.141643966136,136,382,518
2610,-0.645953270361,0.929241202634,021-ACP,0.141643966136,161,513,674
2611,-0.645953270361,0.929241202634,021-ACQ,0.141643966136,107,318,425
2612,-0.645953270361,0.929241202634,021-ACR,0.141643966136,73,396,469
2613,-0.645953270361,0.929241202634,021-ACS,0.141643966136,89,411,500
2614,-0.645953270361,0.929241202634,021-ACT,0.141643966136,150,367,517
2615,-0.645953270361,0.929241202634,021-ACU,0.141643966136,131,477,608
2616,-0.645953270361,0.929241202634,021-ACV,0.141643966136,131,327,458
2617,-0.645953270361,0.929241202634,021-ACW,0.141643966136,106,351,457
2618,-0.645953270361,0.929241202634,021-ACX,0.141643966136,169,524,693
2619,-0.645953270361,0.929241202634,021-ACY,0.141643966136,111,350,461
2620,-0.645953270361,0.929241202634,021-ACZ,0.141643966136,196,411,607
2621,-0.645953270361,0.929241202634,021-ADA,0.141643966136,22,104,126
2622,-0.645953270361,0.929241202634,021-ADB,0.141643966136,169,450,619
2623,-0.645953270361,0.929241202634,021-ADC,0.141643966136,211,519,730
2624,-0.645953270361,0.929241202634,021-ADD,0.141643966136,106,265,371
2625,-0.645953270361,0.929241202634,021-ADE,0.141643966136,171,512,683
2626,-0.645953270361,0.929241202634,021-ADF,0.141643966136,125,263,388
2627,-0.645953270361,0.929241202634,021-ADG,0.141643966136,112,397,509
2628,-0.645953270361,0.929241202634,021-ADH,0.141643966136,147,226,373
2629,-0.645953270361,0.929241202634,021-ADI,0.141643966136,212,463,675
2630,-0.645953270361,0.929241202634,021-ADJ,0.141643966136,79,240,319
2631,-0.645953270361,0.929241202634,021-ADK,0.141643966136,92,218,310
2632,-0.645953270361,0.929241202634,021-ADM,0.141643966136,97,336,433
2633,-0.645953270361,0.929241202634,021-ADN,0.141643966136,131,377,508
2634,-0.645953270361,0.929241202634,021-ADO,0.141643966136,160,543,703
2635,-0.645953270361,0.929241202634,021-ADQ,0.141643966136,64,139,203
2636,-0.645953270361,0.929241202634,021-ADR,0.141643966136,133,379,512
2637,-0.645953270361,0.929241202634,021-ADS,0.141643966136,128,371,499
2638,-0.645953270361,0.929241202634,021-ADT,0.141643966136,51,220,271
2639,-0.645953270361,0.929241202634,021-ADU,0.141643966136,108,371,479
2640,-0.645953270361,0.929241202634,021-ADV,0.141643966136,126,431,557
2641,-0.645953270361,0.929241202634,021-ADW,0.141643966136,94,284,378
2642,-0.645953270361,0.929241202634,021-ADX,0.141643966136,114,286,400
2643,-0.645953270361,0.929241202634,021-ADZ,0.141643966136,152,599,751
2644,-0.645953270361,0.929241202634,021-AEA,0.141643966136,155,455,610
2645,-0.645953270361,0.929241202634,021-AEB,0.141643966136,115,256,371
2646,-0.645953270361,0.929241202634,021-AEC,0.141643966136,108,230,338
2647,-0.645953270361,0.929241202634,021-AED,0.141643966136,135,294,429
2648,-0.645953270361,0.929241202634,021-AEE,0.141643966136,113,325,438
2649,-0.645953270361,0.929241202634,021-AEF,0.141643966136,174,529,703
2650,-0.645953270361,0.929241202634,021-AEG,0.141643966136,80,237,317
2651,-0.645953270361,0.929241202634,021-AEH,0.141643966136,233,333,566
2652,-0.645953270361,0.929241202634,021-AEI,0.141643966136,125,528,653
2653,-0.645953270361,0.929241202634,021-AEJ,0.141643966136,193,436,629
2654,-0.645953270361,0.929241202634,021-AEK,0.141643966136,124,328,452
2655,-0.645953270361,0.929241202634,021-AEL,0.141643966136,234,646,880
2656,-0.645953270361,0.929241202634,021-AEM,0.141643966136,113,288,401
2657,-0.645953270361,0.929241202634,021-AEN,0.141643966136,150,353,503
2658,-0.645953270361,0.929241202634,021-AEO,0.141643966136,93,250,343
2659,-0.645953270361,0.929241202634,021-AEP,0.141643966136,112,319,431
2660,-0.645953270361,0.929241202634,021-AEQ,0.141643966136,129,410,539
2661,-0.645953270361,0.929241202634,021-AER,0.141643966136,127,516,643
2662,-0.645953270361,0.929241202634,021-AES,0.141643966136,90,59,149
2663,-0.645953270361,0.929241202634,021-AET,0.141643966136,111,39,150
2664,-0.645953270361,0.929241202634,021-AEU,0.141643966136,189,467,656
2665,-0.645953270361,0.929241202634,021-AEV,0.141643966136,109,199,308
2666,-0.645953270361,0.929241202634,021-AEW,0.141643966136,149,463,612
2667,-0.645953270361,0.929241202634,021-AEX,0.141643966136,128,375,503
2668,-0.645953270361,0.929241202634,021-AEY,0.141643966136,218,682,900
2669,-0.645953270361,0.929241202634,021-AEZ,0.141643966136,231,506,737
2670,-0.645953270361,0.929241202634,021-AFA,0.141643966136,119,328,447
2671,-0.645953270361,0.929241202634,021-AFB,0.141643966136,126,257,383
2672,-0.645953270361,0.929241202634,021-AFC,0.141643966136,87,379,466
2673,-0.645953270361,0.929241202634,021-AFE,0.141643966136,110,286,396
2674,-0.645953270361,0.929241202634,021-AFF,0.141643966136,136,540,676
2675,-0.645953270361,0.929241202634,021-AFG,0.141643966136,133,246,379
2676,-0.645953270361,0.929241202634,021-AFH,0.141643966136,138,339,477
2677,-0.645953270361,0.929241202634,021-AFI,0.141643966136,89,279,368
2678,-0.645953270361,0.929241202634,021-AFJ,0.141643966136,148,283,431
2679,-0.645953270361,0.929241202634,021-AFK,0.141643966136,130,290,420
2680,-0.645953270361,0.929241202634,021-AFL,0.141643966136,104,440,544
2681,-0.645953270361,0.929241202634,021-AFM,0.141643966136,88,280,368
2682,-0.645953270361,0.929241202634,022-AAA,0.141643966136,197,367,564
2683,-0.645953270361,0.929241202634,022-AAB,0.141643966136,160,221,381
2684,-0.645953270361,0.929241202634,022-AAC,0.141643966136,150,337,487
2685,-0.645953270361,0.929241202634,022-AAE,0.141643966136,203,238,441
2686,-0.645953270361,0.929241202634,022-AAI,0.141643966136,130,202,332
2687,-0.645953270361,0.929241202634,022-AAJ,0.141643966136,169,364,533
2688,-0.645953270361,0.929241202634,022-ABV,0.141643966136,116,230,346
2689,-0.645953270361,0.929241202634,022-ABX,0.141643966136,141,132,273
2690,-0.645953270361,0.929241202634,022-ABY,0.141643966136,180,215,395
2691,-0.645953270361,0.929241202634,022-ACA,0.141643966136,162,185,347
2692,-0.645953270361,0.929241202634,022-ACB,0.141643966136,147,183,330
2693,-0.645953270361,0.929241202634,022-ACC,0.141643966136,125,157,282
2694,-0.645953270361,0.929241202634,022-ACD,0.141643966136,236,404,640
2695,-0.645953270361,0.929241202634,022-ACF,0.141643966136,194,272,466
2696,-0.645953270361,0.929241202634,022-ACG,0.141643966136,190,250,440
2697,-0.645953270361,0.929241202634,022-ACH,0.141643966136,220,347,567
2698,-0.645953270361,0.929241202634,022-ACI,0.141643966136,187,326,513
2699,-0.645953270361,0.929241202634,022-ACK,0.141643966136,155,441,596
2700,-0.645953270361,0.929241202634,022-ACL,0.141643966136,158,340,498
2701,-0.645953270361,0.929241202634,022-ACM,0.141643966136,170,399,569
2702,-0.645953270361,0.929241202634,022-ACN,0.141643966136,72,146,218
2703,-0.645953270361,0.929241202634,022-ACO,0.141643966136,111,128,239
2704,-0.645953270361,0.929241202634,022-ACP,0.141643966136,140,159,299
2705,-0.645953270361,0.929241202634,022-ACQ,0.141643966136,227,326,553
2706,-0.645953270361,0.929241202634,022-ACR,0.141643966136,181,164,345
2707,-0.645953270361,0.929241202634,022-ACS,0.141643966136,263,274,537
2708,-0.645953270361,0.929241202634,022-ACT,0.141643966136,151,176,327
2709,-0.645953270361,0.929241202634,022-ACW,0.141643966136,133,270,403
2710,-0.645953270361,0.929241202634,022-ACX,0.141643966136,201,486,687
2711,-0.645953270361,0.929241202634,022-ADA,0.141643966136,220,283,503
2712,-0.645953270361,0.929241202634,022-ADB,0.141643966136,262,457,719
2713,-0.645953270361,0.929241202634,022-ADC,0.141643966136,239,329,568
2714,-0.645953270361,0.929241202634,022-ADD,0.141643966136,237,288,525
2715,-0.645953270361,0.929241202634,022-ADE,0.141643966136,218,209,427
2716,-0.645953270361,0.929241202634,022-ADF,0.141643966136,290,259,549
2717,-0.645953270361,0.929241202634,022-ADH,0.141643966136,275,341,616
2718,-0.645953270361,0.929241202634,022-ADJ,0.141643966136,202,241,443
2719,-0.645953270361,0.929241202634,022-ADM,0.141643966136,193,366,559
2720,-0.645953270361,0.929241202634,022-ADN,0.141643966136,79,58,137
2721,-0.645953270361,0.929241202634,022-ADO,0.141643966136,278,417,695
2722,-0.645953270361,0.929241202634,022-ADS,0.141643966136,120,236,356
2723,-0.645953270361,0.929241202634,022-ADT,0.141643966136,211,320,531
2724,-0.645953270361,0.929241202634,022-ADU,0.141643966136,137,217,354
2725,-0.645953270361,0.929241202634,022-ADV,0.141643966136,95,142,237
2726,-0.645953270361,0.929241202634,022-ADW,0.141643966136,158,186,344
2727,-0.645953270361,0.929241202634,022-ADX,0.141643966136,80,226,306
2728,-0.645953270361,0.929241202634,022-ADY,0.141643966136,316,175,491
2729,-0.645953270361,0.929241202634,022-ADZ,0.141643966136,281,100,381
2730,-0.645953270361,0.929241202634,022-AEA,0.141643966136,209,179,388
2731,-0.645953270361,0.929241202634,022-AEB,0.141643966136,275,145,420
2732,-0.645953270361,0.929241202634,022-AEC,0.141643966136,278,190,468
2733,-0.645953270361,0.929241202634,022-AED,0.141643966136,274,187,461
2734,-0.645953270361,0.929241202634,022-AEE,0.141643966136,247,182,429
2735,-0.645953270361,0.929241202634,022-AEF,0.141643966136,275,221,496
2736,-0.645953270361,0.929241202634,022-AEG,0.141643966136,264,142,406
2737,-0.645953270361,0.929241202634,022-AEH,0.141643966136,241,187,428
2738,-0.645953270361,0.929241202634,022-AEI,0.141643966136,196,120,316
2739,-0.645953270361,0.929241202634,022-AEJ,0.141643966136,207,108,315
2740,-0.645953270361,0.929241202634,022-AEK,0.141643966136,266,128,394
2741,-0.645953270361,0.929241202634,022-AEL,0.141643966136,226,157,383
2742,-0.645953270361,0.929241202634,022-AEM,0.141643966136,331,303,634
2743,-0.645953270361,0.929241202634,022-AEN,0.141643966136,129,283,412
2744,-0.645953270361,0.929241202634,023-AAA,0.141643966136,144,260,404
2745,-0.645953270361,0.929241202634,023-AAB,0.141643966136,79,162,241
2746,-0.645953270361,0.929241202634,023-AAC,0.141643966136,168,274,442
2747,-0.645953270361,0.929241202634,023-AAD,0.141643966136,79,218,297
2748,-0.645953270361,0.929241202634,023-AAE,0.141643966136,90,197,287
2749,-0.645953270361,0.929241202634,023-AAF,0.141643966136,115,379,494
2750,-0.645953270361,0.929241202634,023-AAG,0.141643966136,87,140,227
2751,-0.645953270361,0.929241202634,023-AAH,0.141643966136,113,321,434
2752,-0.645953270361,0.929241202634,023-AAI,0.141643966136,76,171,247
2753,-0.645953270361,0.929241202634,023-AAJ,0.141643966136,110,190,300
2754,-0.645953270361,0.929241202634,023-AAL,0.141643966136,155,313,468
2755,-0.645953270361,0.929241202634,023-AAM,0.141643966136,91,206,297
2756,-0.645953270361,0.929241202634,023-AAN,0.141643966136,122,242,364
2757,-0.645953270361,0.929241202634,023-AAO,0.141643966136,139,249,388
2758,-0.645953270361,0.929241202634,023-AAP,0.141643966136,69,178,247
2759,-0.645953270361,0.929241202634,023-AAQ,0.141643966136,88,275,363
2760,-0.645953270361,0.929241202634,023-AAR,0.141643966136,86,400,486
2761,-0.645953270361,0.929241202634,023-AAS,0.141643966136,90,182,272
2762,-0.645953270361,0.929241202634,023-AAT,0.141643966136,79,154,233
2763,-0.645953270361,0.929241202634,023-AAU,0.141643966136,85,154,239
2764,-0.645953270361,0.929241202634,023-AAV,0.141643966136,98,180,278
2765,-0.645953270361,0.929241202634,023-AAW,0.141643966136,100,189,289
2766,-0.645953270361,0.929241202634,023-AAX,0.141643966136,119,167,286
2767,-0.645953270361,0.929241202634,023-AAY,0.141643966136,105,114,219
2768,-0.645953270361,0.929241202634,023-AAZ,0.141643966136,88,118,206
2769,-0.645953270361,0.929241202634,023-ABA,0.141643966136,147,181,328
2770,-0.645953270361,0.929241202634,023-ABB,0.141643966136,134,193,327
2771,-0.645953270361,0.929241202634,023-ABC,0.141643966136,115,241,356
2772,-0.645953270361,0.929241202634,023-ABD,0.141643966136,150,331,481
2773,-0.645953270361,0.929241202634,023-ABE,0.141643966136,98,299,397
2774,-0.645953270361,0.929241202634,023-ABF,0.141643966136,101,251,352
2775,-0.645953270361,0.929241202634,023-ABG,0.141643966136,101,262,363
2776,-0.645953270361,0.929241202634,023-ABH,0.141643966136,262,473,735
2777,-0.645953270361,0.929241202634,023-ABI,0.141643966136,178,386,564
2778,-0.645953270361,0.929241202634,023-ABJ,0.141643966136,125,304,429
2779,-0.645953270361,0.929241202634,023-ABK,0.141643966136,107,214,321
2780,-0.645953270361,0.929241202634,023-ABL,0.141643966136,71,261,332
2781,-0.645953270361,0.929241202634,023-ABM,0.141643966136,160,429,589
2782,-0.645953270361,0.929241202634,023-ABO,0.141643966136,126,281,407
2783,-0.645953270361,0.929241202634,023-ABP,0.141643966136,118,283,401
2784,-0.645953270361,0.929241202634,023-ABQ,0.141643966136,121,258,379
2785,-0.645953270361,0.929241202634,023-ABR,0.141643966136,126,259,385
2786,-0.645953270361,0.929241202634,023-ABT,0.141643966136,118,358,476
2787,-0.645953270361,0.929241202634,023-ABU,0.141643966136,184,637,821
2788,-0.645953270361,0.929241202634,023-ABV,0.141643966136,157,431,588
2789,-0.645953270361,0.929241202634,023-ABW,0.141643966136,179,518,697
2790,-0.645953270361,0.929241202634,023-ABX,0.141643966136,112,476,588
2791,-0.645953270361,0.929241202634,023-ACA,0.141643966136,91,280,371
2792,-0.645953270361,0.929241202634,023-ACB,0.141643966136,201,441,642
2793,-0.645953270361,0.929241202634,023-ACC,0.141643966136,202,429,631
2794,-0.645953270361,0.929241202634,023-ACF,0.141643966136,144,394,538
2795,-0.645953270361,0.929241202634,023-ACG,0.141643966136,149,579,728
2796,-0.645953270361,0.929241202634,023-ACH,0.141643966136,72,312,384
2797,-0.645953270361,0.929241202634,023-ACI,0.141643966136,117,275,392
2798,-0.645953270361,0.929241202634,023-ACK,0.141643966136,103,313,416
2799,-0.645953270361,0.929241202634,023-ACL,0.141643966136,123,285,408
2800,-0.645953270361,0.929241202634,023-ACM,0.141643966136,118,285,403
2801,-0.645953270361,0.929241202634,023-ACN,0.141643966136,113,411,524
2802,-0.645953270361,0.929241202634,023-ACO,0.141643966136,132,504,636
2803,-0.645953270361,0.929241202634,023-ACP,0.141643966136,105,290,395
2804,-0.645953270361,0.929241202634,023-ACQ,0.141643966136,110,410,520
2805,-0.645953270361,0.929241202634,023-ACR,0.141643966136,128,321,449
2806,-0.645953270361,0.929241202634,023-ACS,0.141643966136,137,268,405
2807,-0.645953270361,0.929241202634,023-ACV,0.141643966136,119,400,519
2808,-0.645953270361,0.929241202634,023-ACW,0.141643966136,155,531,686
2809,-0.645953270361,0.929241202634,023-ACX,0.141643966136,129,321,450
2810,-0.645953270361,0.929241202634,023-ACY,0.141643966136,91,300,391
2811,-0.645953270361,0.929241202634,023-ACZ,0.141643966136,87,305,392
2812,-0.645953270361,0.929241202634,023-ADA,0.141643966136,145,436,581
2813,-0.645953270361,0.929241202634,023-ADE,0.141643966136,51,230,281
2814,-0.645953270361,0.929241202634,023-ADF,0.141643966136,86,297,383
2815,-0.645953270361,0.929241202634,023-ADG,0.141643966136,68,260,328
2816,-0.645953270361,0.929241202634,023-ADH,0.141643966136,108,364,472
2817,-0.645953270361,0.929241202634,023-ADI,0.141643966136,114,290,404
2818,-0.645953270361,0.929241202634,023-ADK,0.141643966136,137,294,431
2819,-0.645953270361,0.929241202634,023-ADL,0.141643966136,120,341,461
2820,-0.645953270361,0.929241202634,023-ADM,0.141643966136,167,466,633
2821,-0.645953270361,0.929241202634,023-ADN,0.141643966136,141,380,521
2822,-0.645953270361,0.929241202634,023-ADO,0.141643966136,137,340,477
2823,-0.645953270361,0.929241202634,023-ADP,0.141643966136,199,431,630
2824,-0.645953270361,0.929241202634,023-ADQ,0.141643966136,152,319,471
2825,-0.645953270361,0.929241202634,023-ADR,0.141643966136,86,211,297
2826,-0.645953270361,0.929241202634,023-ADS,0.141643966136,165,519,684
2827,-0.645953270361,0.929241202634,023-ADT,0.141643966136,106,326,432
2828,-0.645953270361,0.929241202634,023-ADU,0.141643966136,150,303,453
2829,-0.645953270361,0.929241202634,023-ADV,0.141643966136,161,326,487
2830,-0.645953270361,0.929241202634,023-ADW,0.141643966136,105,331,436
2831,-0.645953270361,0.929241202634,023-ADX,0.141643966136,169,338,507
2832,-0.645953270361,0.929241202634,023-ADY,0.141643966136,167,349,516
2833,-0.645953270361,0.929241202634,023-ADZ,0.141643966136,114,318,432
2834,-0.645953270361,0.929241202634,023-AED,0.141643966136,164,416,580
2835,-0.645953270361,0.929241202634,023-AEE,0.141643966136,141,283,424
2836,-0.645953270361,0.929241202634,023-AEF,0.141643966136,149,416,565
2837,-0.645953270361,0.929241202634,023-AEG,0.141643966136,112,329,441
2838,-0.645953270361,0.929241202634,023-AEJ,0.141643966136,180,190,370
2839,-0.645953270361,0.929241202634,023-AEK,0.141643966136,186,239,425
2840,-0.645953270361,0.929241202634,023-AEL,0.141643966136,174,134,308
2841,-0.645953270361,0.929241202634,023-AEM,0.141643966136,113,170,283
2842,-0.645953270361,0.929241202634,023-AEN,0.141643966136,137,415,552
2843,-0.645953270361,0.929241202634,023-AEO,0.141643966136,165,292,457
2844,-0.645953270361,0.929241202634,023-AEP,0.141643966136,124,164,288
2845,-0.645953270361,0.929241202634,023-AEQ,0.141643966136,209,80,289
2846,-0.645953270361,0.929241202634,023-AER,0.141643966136,323,213,536
2847,-0.645953270361,0.929241202634,023-AES,0.141643966136,86,282,368
2848,-0.645953270361,0.929241202634,023-AET,0.141643966136,43,80,123
2849,-0.645953270361,0.929241202634,023-AEU,0.141643966136,95,199,294
2850,-0.645953270361,0.929241202634,023-AEV,0.141643966136,230,269,499
2851,-0.645953270361,0.929241202634,023-AEW,0.141643966136,254,399,653
2852,-0.645953270361,0.929241202634,023-AEX,0.141643966136,142,274,416
2853,-0.645953270361,0.929241202634,023-AEY,0.141643966136,123,263,386
2854,-0.645953270361,0.929241202634,024-AAA,0.141643966136,71,142,213
2855,-0.645953270361,0.929241202634,024-AAB,0.141643966136,81,136,217
2856,-0.645953270361,0.929241202634,024-AAE,0.141643966136,51,117,168
2857,-0.645953270361,0.929241202634,024-AAG,0.141643966136,69,182,251
2858,-0.645953270361,0.929241202634,024-AAH,0.141643966136,69,161,230
2859,-0.645953270361,0.929241202634,024-AAK,0.141643966136,103,318,421
2860,-0.645953270361,0.929241202634,024-AAM,0.141643966136,95,391,486
2861,-0.645953270361,0.929241202634,024-AAN,0.141643966136,103,303,406
2862,-0.645953270361,0.929241202634,024-AAO,0.141643966136,81,211,292
2863,-0.645953270361,0.929241202634,024-AAP,0.141643966136,72,129,201
2864,-0.645953270361,0.929241202634,024-AAQ,0.141643966136,63,89,152
2865,-0.645953270361,0.929241202634,024-AAS,0.141643966136,66,242,308
2866,-0.645953270361,0.929241202634,024-AAT,0.141643966136,25,99,124
2867,-0.645953270361,0.929241202634,024-AAU,0.141643966136,58,191,249
2868,-0.645953270361,0.929241202634,024-AAX,0.141643966136,33,162,195
2869,-0.645953270361,0.929241202634,024-AAY,0.141643966136,83,178,261
2870,-0.645953270361,0.929241202634,024-AAZ,0.141643966136,96,150,246
2871,-0.645953270361,0.929241202634,024-ABB,0.141643966136,79,255,334
2872,-0.645953270361,0.929241202634,024-ABC,0.141643966136,72,209,281
2873,-0.645953270361,0.929241202634,024-ABE,0.141643966136,56,100,156
2874,-0.645953270361,0.929241202634,024-ABG,0.141643966136,65,221,286
2875,-0.645953270361,0.929241202634,024-ABH,0.141643966136,65,278,343
2876,-0.645953270361,0.929241202634,024-ABI,0.141643966136,59,211,270
2877,-0.645953270361,0.929241202634,024-ABJ,0.141643966136,89,206,295
2878,-0.645953270361,0.929241202634,024-ABK,0.141643966136,93,370,463
2879,-0.645953270361,0.929241202634,024-ABM,0.141643966136,111,371,482
2880,-0.645953270361,0.929241202634,025-AAA,0.141643966136,290,212,502
2881,-0.645953270361,0.929241202634,025-AAB,0.141643966136,456,516,972
2882,-0.645953270361,0.929241202634,025-AAD,0.141643966136,412,325,737
2883,-0.645953270361,0.929241202634,025-AAE,0.141643966136,420,382,802
2884,-0.645953270361,0.929241202634,025-AAG,0.141643966136,347,280,627
2885,-0.645953270361,0.929241202634,025-AAH,0.141643966136,293,194,487
2886,-0.645953270361,0.929241202634,025-AAI,0.141643966136,243,232,475
2887,-0.645953270361,0.929241202634,025-AAJ,0.141643966136,200,135,335
2888,-0.645953270361,0.929241202634,025-AAK,0.141643966136,288,266,554
2889,-0.645953270361,0.929241202634,025-AAL,0.141643966136,259,187,446
2890,-0.645953270361,0.929241202634,025-AAN,0.141643966136,252,158,410
2891,-0.645953270361,0.929241202634,025-AAO,0.141643966136,193,112,305
2892,-0.645953270361,0.929241202634,025-AAP,0.141643966136,335,211,546
2893,-0.645953270361,0.929241202634,025-AAQ,0.141643966136,192,67,259
2894,-0.645953270361,0.929241202634,025-AAR,0.141643966136,288,152,440
2895,-0.645953270361,0.929241202634,025-AAS,0.141643966136,317,185,502
2896,-0.645953270361,0.929241202634,025-AAT,0.141643966136,283,210,493
2897,-0.645953270361,0.929241202634,025-AAU,0.141643966136,345,189,534
2898,-0.645953270361,0.929241202634,025-AAV,0.141643966136,260,190,450
2899,-0.645953270361,0.929241202634,025-AAW,0.141643966136,219,16,235
2900,-0.645953270361,0.929241202634,025-AAX,0.141643966136,315,50,365
2901,-0.645953270361,0.929241202634,025-AAY,0.141643966136,360,69,429
2902,-0.645953270361,0.929241202634,025-AAZ,0.141643966136,252,100,352
2903,-0.645953270361,0.929241202634,025-ABA,0.141643966136,229,22,251
2904,-0.645953270361,0.929241202634,025-ABB,0.141643966136,202,24,226
2905,-0.645953270361,0.929241202634,025-ABC,0.141643966136,218,18,236
2906,-0.645953270361,0.929241202634,025-ABD,0.141643966136,229,24,253
2907,-0.645953270361,0.929241202634,025-ABE,0.141643966136,274,20,294
2908,-0.645953270361,0.929241202634,025-ABF,0.141643966136,428,26,454
2909,-0.645953270361,0.929241202634,025-ABG,0.141643966136,257,11,268
2910,-0.645953270361,0.929241202634,025-ABI,0.141643966136,289,19,308
2911,-0.645953270361,0.929241202634,025-ABJ,0.141643966136,465,41,506
2912,-0.645953270361,0.929241202634,025-ABK,0.141643966136,352,28,380
2913,-0.645953270361,0.929241202634,025-ABL,0.141643966136,296,35,331
2914,-0.645953270361,0.929241202634,025-ABM,0.141643966136,251,21,272
2915,-0.645953270361,0.929241202634,025-ABN,0.141643966136,312,14,326
2916,-0.645953270361,0.929241202634,025-ABO,0.141643966136,204,20,224
2917,-0.645953270361,0.929241202634,025-ABP,0.141643966136,275,22,297
2918,-0.645953270361,0.929241202634,025-ABQ,0.141643966136,332,16,348
2919,-0.645953270361,0.929241202634,025-ABR,0.141643966136,288,34,322
2920,-0.645953270361,0.929241202634,025-ABS,0.141643966136,108,2,110
2921,-0.645953270361,0.929241202634,025-ABT,0.141643966136,332,153,485
2922,-0.645953270361,0.929241202634,025-ABU,0.141643966136,251,93,344
2923,-0.645953270361,0.929241202634,025-ABV,0.141643966136,264,165,429
2924,-0.645953270361,0.929241202634,025-ABW,0.141643966136,301,207,508
2925,-0.645953270361,0.929241202634,025-ABX,0.141643966136,170,137,307
2926,-0.645953270361,0.929241202634,025-ABY,0.141643966136,115,89,204
2927,-0.645953270361,0.929241202634,025-ABZ,0.141643966136,62,62,124
2928,-0.645953270361,0.929241202634,025-ACA,0.141643966136,57,28,85
2929,-0.645953270361,0.929241202634,025-ACB,0.141643966136,334,108,442
2930,-0.645953270361,0.929241202634,025-ACC,0.141643966136,254,198,452
2931,-0.645953270361,0.929241202634,025-ACD,0.141643966136,207,362,569
2932,-0.645953270361,0.929241202634,025-ACN,0.141643966136,129,95,224
2933,-0.645953270361,0.929241202634,025-ACO,0.141643966136,160,175,335
2934,-0.645953270361,0.929241202634,025-ACP,0.141643966136,233,272,505
2935,-0.645953270361,0.929241202634,025-ACQ,0.141643966136,210,193,403
2936,-0.645953270361,0.929241202634,025-ACR,0.141643966136,207,270,477
2937,-0.645953270361,0.929241202634,025-ACS,0.141643966136,183,41,224
2938,-0.645953270361,0.929241202634,025-ACT,0.141643966136,209,36,245
2939,-0.645953270361,0.929241202634,025-ACU,0.141643966136,325,78,403
2940,-0.645953270361,0.929241202634,025-ACV,0.141643966136,347,102,449
2941,-0.645953270361,0.929241202634,025-ACW,0.141643966136,96,10,106
2942,-0.645953270361,0.929241202634,025-ACX,0.141643966136,235,18,253
2943,-0.645953270361,0.929241202634,025-ACY,0.141643966136,204,7,211
2944,-0.645953270361,0.929241202634,025-ACZ,0.141643966136,266,14,280
2945,-0.645953270361,0.929241202634,025-ADA,0.141643966136,245,181,426
2946,-0.645953270361,0.929241202634,025-ADB,0.141643966136,361,117,478
2947,-0.645953270361,0.929241202634,025-ADC,0.141643966136,317,103,420
2948,-0.645953270361,0.929241202634,025-ADD,0.141643966136,441,153,594
2949,-0.645953270361,0.929241202634,025-ADE,0.141643966136,135,72,207
2950,-0.645953270361,0.929241202634,025-ADF,0.141643966136,260,249,509
2951,-0.645953270361,0.929241202634,025-ADG,0.141643966136,241,59,300
2952,-0.645953270361,0.929241202634,025-ADH,0.141643966136,181,85,266
2953,-0.645953270361,0.929241202634,025-ADI,0.141643966136,200,54,254
2954,-0.645953270361,0.929241202634,025-ADJ,0.141643966136,98,41,139
2955,-0.645953270361,0.929241202634,025-ADK,0.141643966136,99,45,144
2956,-0.645953270361,0.929241202634,025-ADL,0.141643966136,372,52,424
2957,-0.645953270361,0.929241202634,025-ADM,0.141643966136,243,7,250
2958,-0.645953270361,0.929241202634,025-ADN,0.141643966136,238,7,245
2959,-0.645953270361,0.929241202634,025-ADO,0.141643966136,195,7,202
2960,-0.645953270361,0.929241202634,025-ADP,0.141643966136,249,12,261
2961,-0.645953270361,0.929241202634,025-ADQ,0.141643966136,286,68,354
2962,-0.645953270361,0.929241202634,025-ADR,0.141643966136,389,121,510
2963,-0.645953270361,0.929241202634,025-ADS,0.141643966136,397,90,487
2964,-0.645953270361,0.929241202634,025-ADT,0.141643966136,309,93,402
2965,-0.645953270361,0.929241202634,025-ADU,0.141643966136,402,111,513
2966,-0.645953270361,0.929241202634,025-ADV,0.141643966136,291,72,363
2967,-0.645953270361,0.929241202634,025-ADW,0.141643966136,285,222,507
2968,-0.645953270361,0.929241202634,025-ADX,0.141643966136,362,265,627
2969,-0.645953270361,0.929241202634,025-ADY,0.141643966136,364,266,630
2970,-0.645953270361,0.929241202634,025-ADZ,0.141643966136,389,302,691
2971,-0.645953270361,0.929241202634,025-AEA,0.141643966136,350,188,538
2972,-0.645953270361,0.929241202634,025-AEB,0.141643966136,419,204,623
2973,-0.645953270361,0.929241202634,025-AEC,0.141643966136,335,245,580
2974,-0.645953270361,0.929241202634,025-AED,0.141643966136,510,165,675
2975,-0.645953270361,0.929241202634,025-AEE,0.141643966136,573,384,957
2976,-0.645953270361,0.929241202634,025-AEF,0.141643966136,438,100,538
2977,-0.645953270361,0.929241202634,025-AEG,0.141643966136,381,149,530
2978,-0.645953270361,0.929241202634,025-AEH,0.141643966136,306,256,562
2979,-0.645953270361,0.929241202634,025-AEI,0.141643966136,475,322,797
2980,-0.645953270361,0.929241202634,025-AEJ,0.141643966136,304,216,520
2981,-0.645953270361,0.929241202634,025-AEK,0.141643966136,177,91,268
2982,-0.645953270361,0.929241202634,025-AEL,0.141643966136,399,322,721
2983,-0.645953270361,0.929241202634,025-AEM,0.141643966136,340,279,619
2984,-0.645953270361,0.929241202634,025-AEN,0.141643966136,335,322,657
2985,-0.645953270361,0.929241202634,025-AEO,0.141643966136,299,200,499
2986,-0.645953270361,0.929241202634,025-AEP,0.141643966136,349,268,617
2987,-0.645953270361,0.929241202634,025-AEQ,0.141643966136,317,359,676
2988,-0.645953270361,0.929241202634,025-AER,0.141643966136,190,250,440
2989,-0.645953270361,0.929241202634,025-AES,0.141643966136,231,192,423
2990,-0.645953270361,0.929241202634,025-AET,0.141643966136,318,255,573
2991,-0.645953270361,0.929241202634,025-AEV,0.141643966136,259,91,350
2992,-0.645953270361,0.929241202634,025-AEW,0.141643966136,303,94,397
2993,-0.645953270361,0.929241202634,025-AEX,0.141643966136,353,180,533
2994,-0.645953270361,0.929241202634,025-AEY,0.141643966136,335,172,507
2995,-0.645953270361,0.929241202634,025-AEZ,0.141643966136,203,76,279
2996,-0.645953270361,0.929241202634,025-AFA,0.141643966136,214,124,338
2997,-0.645953270361,0.929241202634,025-AFB,0.141643966136,215,123,338
2998,-0.645953270361,0.929241202634,025-AFC,0.141643966136,298,55,353
2999,-0.645953270361,0.929241202634,025-AFD,0.141643966136,183,159,342
3000,-0.645953270361,0.929241202634,025-AFE,0.141643966136,343,36,379
3001,-0.645953270361,0.929241202634,025-AFF,0.141643966136,293,35,328
3002,-0.645953270361,0.929241202634,025-AFG,0.141643966136,451,17,468
3003,-0.645953270361,0.929241202634,025-AFH,0.141643966136,429,15,444
3004,-0.645953270361,0.929241202634,025-AFI,0.141643966136,442,16,458
3005,-0.645953270361,0.929241202634,025-AFJ,0.141643966136,325,28,353
3006,-0.645953270361,0.929241202634,025-AFK,0.141643966136,235,12,247
3007,-0.645953270361,0.929241202634,025-AFL,0.141643966136,283,31,314
3008,-0.645953270361,0.929241202634,025-AFM,0.141643966136,155,22,177
3009,-0.645953270361,0.929241202634,025-AFN,0.141643966136,170,19,189
3010,-0.645953270361,0.929241202634,025-AFO,0.141643966136,261,60,321
3011,-0.645953270361,0.929241202634,025-AFQ,0.141643966136,273,56,329
3012,-0.645953270361,0.929241202634,025-AFR,0.141643966136,201,47,248
3013,-0.645953270361,0.929241202634,025-AFS,0.141643966136,250,234,484
3014,-0.645953270361,0.929241202634,025-AFT,0.141643966136,255,118,373
3015,-0.645953270361,0.929241202634,025-AFU,0.141643966136,276,108,384
3016,-0.645953270361,0.929241202634,025-AFV,0.141643966136,302,371,673
3017,-0.645953270361,0.929241202634,025-AFW,0.141643966136,396,35,431
3018,-0.645953270361,0.929241202634,025-AFX,0.141643966136,369,34,403
3019,-0.645953270361,0.929241202634,025-AFY,0.141643966136,393,77,470
3020,-0.645953270361,0.929241202634,025-AFZ,0.141643966136,356,157,513
3021,-0.645953270361,0.929241202634,025-AGA,0.141643966136,759,110,869
3022,-0.645953270361,0.929241202634,025-AGB,0.141643966136,351,148,499
3023,-0.645953270361,0.929241202634,025-AGC,0.141643966136,144,72,216
3024,-0.645953270361,0.929241202634,025-AGD,0.141643966136,121,48,169
3025,-0.645953270361,0.929241202634,025-AGE,0.141643966136,131,174,305
3026,-0.645953270361,0.929241202634,025-AGF,0.141643966136,187,206,393
3027,-0.645953270361,0.929241202634,025-AGG,0.141643966136,394,394,788
3028,-0.645953270361,0.929241202634,025-AGH,0.141643966136,127,114,241
3029,-0.645953270361,0.929241202634,025-AGI,0.141643966136,306,324,630
3030,-0.645953270361,0.929241202634,025-AGJ,0.141643966136,182,182,364
3031,-0.645953270361,0.929241202634,025-AGM,0.141643966136,276,66,342
3032,-0.645953270361,0.929241202634,025-AGN,0.141643966136,177,141,318
3033,-0.645953270361,0.929241202634,025-AGO,0.141643966136,129,111,240
3034,-0.645953270361,0.929241202634,025-AGP,0.141643966136,103,40,143
3035,-0.645953270361,0.929241202634,025-AGQ,0.141643966136,106,83,189
3036,-0.645953270361,0.929241202634,025-AGR,0.141643966136,359,323,682
3037,-0.645953270361,0.929241202634,025-AGS,0.141643966136,234,177,411
3038,-0.645953270361,0.929241202634,025-AGT,0.141643966136,226,172,398
3039,-0.645953270361,0.929241202634,025-AGU,0.141643966136,226,200,426
3040,-0.645953270361,0.929241202634,025-AGV,0.141643966136,167,80,247
3041,-0.645953270361,0.929241202634,025-AGW,0.141643966136,265,109,374
3042,-0.645953270361,0.929241202634,025-AGX,0.141643966136,233,150,383
3043,-0.645953270361,0.929241202634,025-AGY,0.141643966136,284,146,430
3044,-0.645953270361,0.929241202634,025-AGZ,0.141643966136,325,110,435
3045,-0.645953270361,0.929241202634,025-AHA,0.141643966136,197,139,336
3046,-0.645953270361,0.929241202634,025-AHB,0.141643966136,244,150,394
3047,-0.645953270361,0.929241202634,025-AHC,0.141643966136,210,73,283
3048,-0.645953270361,0.929241202634,025-AHD,0.141643966136,359,137,496
3049,-0.645953270361,0.929241202634,025-AHE,0.141643966136,299,133,432
3050,-0.645953270361,0.929241202634,025-AHF,0.141643966136,172,54,226
3051,-0.645953270361,0.929241202634,025-AHG,0.141643966136,266,157,423
3052,-0.645953270361,0.929241202634,025-AHH,0.141643966136,195,100,295
3053,-0.645953270361,0.929241202634,025-AHI,0.141643966136,362,185,547
3054,-0.645953270361,0.929241202634,025-AHJ,0.141643966136,312,38,350
3055,-0.645953270361,0.929241202634,025-AHK,0.141643966136,401,18,419
3056,-0.645953270361,0.929241202634,025-AHL,0.141643966136,421,13,434
3057,-0.645953270361,0.929241202634,025-AHM,0.141643966136,373,33,406
3058,-0.645953270361,0.929241202634,025-AHN,0.141643966136,165,275,440
3059,-0.645953270361,0.929241202634,025-AHO,0.141643966136,228,234,462
3060,-0.645953270361,0.929241202634,025-AHP,0.141643966136,226,192,418
3061,-0.645953270361,0.929241202634,025-AHQ,0.141643966136,128,225,353
3062,-0.645953270361,0.929241202634,025-AHR,0.141643966136,184,211,395
3063,-0.645953270361,0.929241202634,025-AHS,0.141643966136,159,79,238
3064,-0.645953270361,0.929241202634,025-AHT,0.141643966136,82,50,132
3065,-0.645953270361,0.929241202634,025-AHU,0.141643966136,153,135,288
3066,-0.645953270361,0.929241202634,025-AHV,0.141643966136,119,174,293
3067,-0.645953270361,0.929241202634,025-AHW,0.141643966136,207,166,373
3068,-0.645953270361,0.929241202634,025-AHX,0.141643966136,163,47,210
3069,-0.645953270361,0.929241202634,025-AHY,0.141643966136,152,138,290
3070,-0.645953270361,0.929241202634,025-AHZ,0.141643966136,173,75,248
3071,-0.645953270361,0.929241202634,025-AIA,0.141643966136,188,70,258
3072,-0.645953270361,0.929241202634,025-AIB,0.141643966136,179,71,250
3073,-0.645953270361,0.929241202634,025-AIC,0.141643966136,182,60,242
3074,-0.645953270361,0.929241202634,025-AID,0.141643966136,421,98,519
3075,-0.645953270361,0.929241202634,025-AIE,0.141643966136,85,44,129
3076,-0.645953270361,0.929241202634,025-AIF,0.141643966136,160,92,252
3077,-0.645953270361,0.929241202634,025-AIG,0.141643966136,88,65,153
3078,-0.645953270361,0.929241202634,025-AIH,0.141643966136,99,62,161
3079,-0.645953270361,0.929241202634,025-AII,0.141643966136,99,48,147
3080,-0.645953270361,0.929241202634,025-AIJ,0.141643966136,340,193,533
3081,-0.645953270361,0.929241202634,025-AIK,0.141643966136,76,22,98
3082,-0.645953270361,0.929241202634,025-AIL,0.141643966136,198,158,356
3083,-0.645953270361,0.929241202634,025-AIM,0.141643966136,204,59,263
3084,-0.645953270361,0.929241202634,025-AIO,0.141643966136,396,303,699
3085,-0.645953270361,0.929241202634,025-AIP,0.141643966136,208,239,447
3086,-0.645953270361,0.929241202634,025-AIQ,0.141643966136,209,140,349
3087,-0.645953270361,0.929241202634,025-AIR,0.141643966136,207,200,407
3088,-0.645953270361,0.929241202634,025-AIT,0.141643966136,391,48,439
3089,-0.645953270361,0.929241202634,025-AIU,0.141643966136,256,38,294
3090,-0.645953270361,0.929241202634,025-AIV,0.141643966136,355,42,397
3091,-0.645953270361,0.929241202634,025-AIW,0.141643966136,332,60,392
3092,-0.645953270361,0.929241202634,025-AIX,0.141643966136,355,61,416
3093,-0.645953270361,0.929241202634,025-AIY,0.141643966136,242,109,351
3094,-0.645953270361,0.929241202634,025-AIZ,0.141643966136,259,21,280
3095,-0.645953270361,0.929241202634,025-AJE,0.141643966136,252,125,377
3096,-0.645953270361,0.929241202634,025-AJF,0.141643966136,214,84,298
3097,-0.645953270361,0.929241202634,025-AJG,0.141643966136,499,120,619
3098,-0.645953270361,0.929241202634,025-AJH,0.141643966136,203,137,340
3099,-0.645953270361,0.929241202634,025-AJI,0.141643966136,215,112,327
3100,-0.645953270361,0.929241202634,025-AJJ,0.141643966136,228,137,365
3101,-0.645953270361,0.929241202634,025-AJK,0.141643966136,140,143,283
3102,-0.645953270361,0.929241202634,025-AJL,0.141643966136,594,56,650
3103,-0.645953270361,0.929241202634,025-AJM,0.141643966136,226,183,409
3104,-0.645953270361,0.929241202634,025-AJN,0.141643966136,272,143,415
3105,-0.645953270361,0.929241202634,025-AJO,0.141643966136,320,210,530
3106,-0.645953270361,0.929241202634,025-AJP,0.141643966136,318,117,435
3107,-0.645953270361,0.929241202634,025-AJQ,0.141643966136,339,203,542
3108,-0.645953270361,0.929241202634,025-AJR,0.141643966136,223,198,421
3109,-0.645953270361,0.929241202634,025-AJS,0.141643966136,357,308,665
3110,-0.645953270361,0.929241202634,025-AJT,0.141643966136,248,229,477
3111,-0.645953270361,0.929241202634,025-AJU,0.141643966136,265,349,614
3112,-0.645953270361,0.929241202634,025-AJV,0.141643966136,287,243,530
3113,-0.645953270361,0.929241202634,025-AJY,0.141643966136,342,120,462
3114,-0.645953270361,0.929241202634,025-AJZ,0.141643966136,280,47,327
3115,-0.645953270361,0.929241202634,025-AKA,0.141643966136,269,127,396
3116,-0.645953270361,0.929241202634,025-AKB,0.141643966136,296,112,408
3117,-0.645953270361,0.929241202634,025-AKC,0.141643966136,259,111,370
3118,-0.645953270361,0.929241202634,025-AKD,0.141643966136,208,64,272
3119,-0.645953270361,0.929241202634,025-AKE,0.141643966136,297,87,384
3120,-0.645953270361,0.929241202634,025-AKF,0.141643966136,219,35,254
3121,-0.645953270361,0.929241202634,025-AKG,0.141643966136,416,59,475
3122,-0.645953270361,0.929241202634,025-AKH,0.141643966136,387,71,458
3123,-0.645953270361,0.929241202634,025-AKI,0.141643966136,404,54,458
3124,-0.645953270361,0.929241202634,025-AKK,0.141643966136,147,136,283
3125,-0.645953270361,0.929241202634,025-AKL,0.141643966136,179,245,424
3126,-0.645953270361,0.929241202634,025-AKM,0.141643966136,204,73,277
3127,-0.645953270361,0.929241202634,025-AKN,0.141643966136,178,298,476
3128,-0.645953270361,0.929241202634,025-AKO,0.141643966136,105,95,200
3129,-0.645953270361,0.929241202634,025-AKP,0.141643966136,346,19,365
3130,-0.645953270361,0.929241202634,025-AKQ,0.141643966136,437,27,464
3131,-0.645953270361,0.929241202634,025-AKR,0.141643966136,394,104,498
3132,-0.645953270361,0.929241202634,025-AKS,0.141643966136,419,38,457
3133,-0.645953270361,0.929241202634,025-AKT,0.141643966136,290,58,348
3134,-0.645953270361,0.929241202634,025-AKU,0.141643966136,390,45,435
3135,-0.645953270361,0.929241202634,025-AKV,0.141643966136,247,25,272
3136,-0.645953270361,0.929241202634,025-AKW,0.141643966136,308,259,567
3137,-0.645953270361,0.929241202634,025-AKX,0.141643966136,317,213,530
3138,-0.645953270361,0.929241202634,025-AKY,0.141643966136,374,279,653
3139,-0.645953270361,0.929241202634,025-AKZ,0.141643966136,297,68,365
3140,-0.645953270361,0.929241202634,025-ALA,0.141643966136,221,38,259
3141,-0.645953270361,0.929241202634,025-ALB,0.141643966136,423,152,575
3142,-0.645953270361,0.929241202634,025-ALD,0.141643966136,357,433,790
3143,-0.645953270361,0.929241202634,025-ALE,0.141643966136,144,256,400
3144,-0.645953270361,0.929241202634,025-ALF,0.141643966136,197,294,491
3145,-0.645953270361,0.929241202634,025-ALG,0.141643966136,279,207,486
3146,-0.645953270361,0.929241202634,025-ALH,0.141643966136,233,217,450
3147,-0.645953270361,0.929241202634,025-ALI,0.141643966136,136,48,184
3148,-0.645953270361,0.929241202634,025-ALJ,0.141643966136,203,122,325
3149,-0.645953270361,0.929241202634,025-ALK,0.141643966136,90,51,141
3150,-0.645953270361,0.929241202634,025-ALM,0.141643966136,270,136,406
3151,-0.645953270361,0.929241202634,025-ALN,0.141643966136,221,163,384
3152,-0.645953270361,0.929241202634,025-ALO,0.141643966136,224,156,380
3153,-0.645953270361,0.929241202634,025-ALP,0.141643966136,268,183,451
3154,-0.645953270361,0.929241202634,025-ALQ,0.141643966136,218,168,386
3155,-0.645953270361,0.929241202634,025-ALR,0.141643966136,285,126,411
3156,-0.645953270361,0.929241202634,025-ALS,0.141643966136,278,71,349
3157,-0.645953270361,0.929241202634,025-ALT,0.141643966136,258,53,311
3158,-0.645953270361,0.929241202634,025-ALU,0.141643966136,330,44,374
3159,-0.645953270361,0.929241202634,025-ALV,0.141643966136,294,63,357
3160,-0.645953270361,0.929241202634,025-ALW,0.141643966136,241,42,283
3161,-0.645953270361,0.929241202634,025-ALX,0.141643966136,236,35,271
3162,-0.645953270361,0.929241202634,025-ALY,0.141643966136,339,34,373
3163,-0.645953270361,0.929241202634,025-ALZ,0.141643966136,658,34,692
3164,-0.645953270361,0.929241202634,025-AMF,0.141643966136,145,110,255
3165,-0.645953270361,0.929241202634,025-AMG,0.141643966136,155,144,299
3166,-0.645953270361,0.929241202634,025-AMH,0.141643966136,174,143,317
3167,-0.645953270361,0.929241202634,025-AMI,0.141643966136,331,397,728
3168,-0.645953270361,0.929241202634,025-AMJ,0.141643966136,200,202,402
3169,-0.645953270361,0.929241202634,025-AMK,0.141643966136,245,332,577
3170,-0.645953270361,0.929241202634,025-AMN,0.141643966136,347,277,624
3171,-0.645953270361,0.929241202634,025-AMO,0.141643966136,241,332,573
3172,-0.645953270361,0.929241202634,025-AMP,0.141643966136,153,263,416
3173,-0.645953270361,0.929241202634,025-AMQ,0.141643966136,163,190,353
3174,-0.645953270361,0.929241202634,025-AMR,0.141643966136,159,260,419
3175,-0.645953270361,0.929241202634,025-AMS,0.141643966136,142,225,367
3176,-0.645953270361,0.929241202634,025-AMT,0.141643966136,222,198,420
3177,-0.645953270361,0.929241202634,025-AMU,0.141643966136,174,294,468
3178,-0.645953270361,0.929241202634,025-AMV,0.141643966136,201,258,459
3179,-0.645953270361,0.929241202634,025-AMW,0.141643966136,235,291,526
3180,-0.645953270361,0.929241202634,025-AMX,0.141643966136,258,348,606
3181,-0.645953270361,0.929241202634,025-AMY,0.141643966136,165,155,320
3182,-0.645953270361,0.929241202634,025-AMZ,0.141643966136,182,182,364
3183,-0.645953270361,0.929241202634,025-ANB,0.141643966136,214,228,442
3184,-0.645953270361,0.929241202634,025-ANC,0.141643966136,195,326,521
3185,-0.645953270361,0.929241202634,025-AND,0.141643966136,237,443,680
3186,-0.645953270361,0.929241202634,025-ANE,0.141643966136,251,328,579
3187,-0.645953270361,0.929241202634,025-ANF,0.141643966136,133,190,323
3188,-0.645953270361,0.929241202634,025-ANG,0.141643966136,198,435,633
3189,-0.645953270361,0.929241202634,025-ANH,0.141643966136,151,335,486
3190,-0.645953270361,0.929241202634,025-ANI,0.141643966136,185,139,324
3191,-0.645953270361,0.929241202634,025-ANJ,0.141643966136,275,80,355
3192,-0.645953270361,0.929241202634,025-ANK,0.141643966136,203,93,296
3193,-0.645953270361,0.929241202634,025-ANL,0.141643966136,284,267,551
3194,-0.645953270361,0.929241202634,025-ANM,0.141643966136,197,243,440
3195,-0.645953270361,0.929241202634,025-ANN,0.141643966136,255,190,445
3196,-0.645953270361,0.929241202634,025-ANO,0.141643966136,260,202,462
3197,-0.645953270361,0.929241202634,025-ANP,0.141643966136,234,243,477
3198,-0.645953270361,0.929241202634,025-ANQ,0.141643966136,178,215,393
3199,-0.645953270361,0.929241202634,025-ANV,0.141643966136,278,476,754
3200,-0.645953270361,0.929241202634,025-ANW,0.141643966136,192,270,462
3201,-0.645953270361,0.929241202634,025-ANX,0.141643966136,344,466,810
3202,-0.645953270361,0.929241202634,025-ANY,0.141643966136,236,265,501
3203,-0.645953270361,0.929241202634,025-ANZ,0.141643966136,183,288,471
3204,-0.645953270361,0.929241202634,025-AOA,0.141643966136,225,207,432
3205,-0.645953270361,0.929241202634,025-AOB,0.141643966136,124,264,388
3206,-0.645953270361,0.929241202634,025-AOC,0.141643966136,168,118,286
3207,-0.645953270361,0.929241202634,025-AOF,0.141643966136,163,342,505
3208,-0.645953270361,0.929241202634,025-AOG,0.141643966136,222,233,455
3209,-0.645953270361,0.929241202634,025-AOH,0.141643966136,312,331,643
3210,-0.645953270361,0.929241202634,025-AOI,0.141643966136,270,299,569
3211,-0.645953270361,0.929241202634,025-AOJ,0.141643966136,225,299,524
3212,-0.645953270361,0.929241202634,025-AOK,0.141643966136,217,351,568
3213,-0.645953270361,0.929241202634,025-AOL,0.141643966136,176,228,404
3214,-0.645953270361,0.929241202634,025-AOM,0.141643966136,146,276,422
3215,-0.645953270361,0.929241202634,025-AON,0.141643966136,199,282,481
3216,-0.645953270361,0.929241202634,025-AOO,0.141643966136,236,262,498
3217,-0.645953270361,0.929241202634,025-AOP,0.141643966136,196,290,486
3218,-0.645953270361,0.929241202634,025-AOQ,0.141643966136,169,249,418
3219,-0.645953270361,0.929241202634,025-AOR,0.141643966136,201,375,576
3220,-0.645953270361,0.929241202634,025-AOS,0.141643966136,222,140,362
3221,-0.645953270361,0.929241202634,025-AOT,0.141643966136,204,102,306
3222,-0.645953270361,0.929241202634,025-AOU,0.141643966136,277,321,598
3223,-0.645953270361,0.929241202634,025-AOV,0.141643966136,184,249,433
3224,-0.645953270361,0.929241202634,025-AOW,0.141643966136,169,247,416
3225,-0.645953270361,0.929241202634,025-AOX,0.141643966136,142,257,399
3226,-0.645953270361,0.929241202634,025-AOY,0.141643966136,170,212,382
3227,-0.645953270361,0.929241202634,025-AOZ,0.141643966136,168,158,326
3228,-0.645953270361,0.929241202634,025-APA,0.141643966136,80,76,156
3229,-0.645953270361,0.929241202634,025-APB,0.141643966136,149,162,311
3230,-0.645953270361,0.929241202634,025-APC,0.141643966136,65,100,165
3231,-0.645953270361,0.929241202634,025-APD,0.141643966136,220,303,523
3232,-0.645953270361,0.929241202634,025-APE,0.141643966136,121,148,269
3233,-0.645953270361,0.929241202634,025-APF,0.141643966136,164,186,350
3234,-0.645953270361,0.929241202634,025-APH,0.141643966136,365,134,499
3235,-0.645953270361,0.929241202634,025-API,0.141643966136,175,38,213
3236,-0.645953270361,0.929241202634,025-APJ,0.141643966136,210,68,278
3237,-0.645953270361,0.929241202634,025-APL,0.141643966136,161,225,386
3238,-0.645953270361,0.929241202634,025-APM,0.141643966136,148,196,344
3239,-0.645953270361,0.929241202634,025-APN,0.141643966136,142,240,382
3240,-0.645953270361,0.929241202634,025-APO,0.141643966136,199,379,578
3241,-0.645953270361,0.929241202634,025-APP,0.141643966136,174,295,469
3242,-0.645953270361,0.929241202634,025-APQ,0.141643966136,163,309,472
3243,-0.645953270361,0.929241202634,025-APR,0.141643966136,130,187,317
3244,-0.645953270361,0.929241202634,025-APU,0.141643966136,228,288,516
3245,-0.645953270361,0.929241202634,025-APV,0.141643966136,191,291,482
3246,-0.645953270361,0.929241202634,025-APW,0.141643966136,244,270,514
3247,-0.645953270361,0.929241202634,025-APX,0.141643966136,261,377,638
3248,-0.645953270361,0.929241202634,025-APY,0.141643966136,204,152,356
3249,-0.645953270361,0.929241202634,025-APZ,0.141643966136,162,261,423
3250,-0.645953270361,0.929241202634,025-AQA,0.141643966136,126,186,312
3251,-0.645953270361,0.929241202634,025-AQB,0.141643966136,255,282,537
3252,-0.645953270361,0.929241202634,025-AQC,0.141643966136,150,196,346
3253,-0.645953270361,0.929241202634,025-AQD,0.141643966136,215,308,523
3254,-0.645953270361,0.929241202634,025-AQE,0.141643966136,79,79,158
3255,-0.645953270361,0.929241202634,025-AQL,0.141643966136,198,351,549
3256,-0.645953270361,0.929241202634,025-AQM,0.141643966136,150,345,495
3257,-0.645953270361,0.929241202634,025-AQN,0.141643966136,198,384,582
3258,-0.645953270361,0.929241202634,025-AQO,0.141643966136,239,316,555
3259,-0.645953270361,0.929241202634,025-AQP,0.141643966136,305,553,858
3260,-0.645953270361,0.929241202634,025-AQQ,0.141643966136,225,444,669
3261,-0.645953270361,0.929241202634,025-AQR,0.141643966136,129,200,329
3262,-0.645953270361,0.929241202634,025-AQS,0.141643966136,133,132,265
3263,-0.645953270361,0.929241202634,025-AQT,0.141643966136,214,320,534
3264,-0.645953270361,0.929241202634,025-AQU,0.141643966136,281,293,574
3265,-0.645953270361,0.929241202634,025-AQV,0.141643966136,181,221,402
3266,-0.645953270361,0.929241202634,025-AQW,0.141643966136,244,283,527
3267,-0.645953270361,0.929241202634,025-AQX,0.141643966136,208,352,560
3268,-0.645953270361,0.929241202634,025-AQY,0.141643966136,167,302,469
3269,-0.645953270361,0.929241202634,025-AQZ,0.141643966136,151,264,415
3270,-0.645953270361,0.929241202634,025-ARA,0.141643966136,208,353,561
3271,-0.645953270361,0.929241202634,025-ARB,0.141643966136,119,175,294
3272,-0.645953270361,0.929241202634,025-ARC,0.141643966136,255,320,575
3273,-0.645953270361,0.929241202634,025-ARD,0.141643966136,130,165,295
3274,-0.645953270361,0.929241202634,025-ARE,0.141643966136,234,306,540
3275,-0.645953270361,0.929241202634,025-ARG,0.141643966136,222,460,682
3276,-0.645953270361,0.929241202634,025-ARH,0.141643966136,94,281,375
3277,-0.645953270361,0.929241202634,025-ARI,0.141643966136,180,507,687
3278,-0.645953270361,0.929241202634,025-ARJ,0.141643966136,142,379,521
3279,-0.645953270361,0.929241202634,025-ARK,0.141643966136,170,537,707
3280,-0.645953270361,0.929241202634,025-ARL,0.141643966136,150,303,453
3281,-0.645953270361,0.929241202634,025-ARM,0.141643966136,116,203,319
3282,-0.645953270361,0.929241202634,025-ARN,0.141643966136,108,171,279
3283,-0.645953270361,0.929241202634,025-ARO,0.141643966136,160,307,467
3284,-0.645953270361,0.929241202634,025-ARP,0.141643966136,196,342,538
3285,-0.645953270361,0.929241202634,025-ARQ,0.141643966136,196,699,895
3286,-0.645953270361,0.929241202634,025-ARR,0.141643966136,201,430,631
3287,-0.645953270361,0.929241202634,025-ARS,0.141643966136,106,299,405
3288,-0.645953270361,0.929241202634,025-ART,0.141643966136,155,265,420
3289,-0.645953270361,0.929241202634,025-ARU,0.141643966136,233,441,674
3290,-0.645953270361,0.929241202634,025-ARV,0.141643966136,152,367,519
3291,-0.645953270361,0.929241202634,025-ARW,0.141643966136,136,228,364
3292,-0.645953270361,0.929241202634,025-ARX,0.141643966136,176,292,468
3293,-0.645953270361,0.929241202634,025-ARY,0.141643966136,174,220,394
3294,-0.645953270361,0.929241202634,025-ARZ,0.141643966136,157,195,352
3295,-0.645953270361,0.929241202634,025-ASA,0.141643966136,243,337,580
3296,-0.645953270361,0.929241202634,025-ASB,0.141643966136,199,202,401
3297,-0.645953270361,0.929241202634,025-ASC,0.141643966136,180,313,493
3298,-0.645953270361,0.929241202634,025-ASD,0.141643966136,148,177,325
3299,-0.645953270361,0.929241202634,025-ASE,0.141643966136,193,310,503
3300,-0.645953270361,0.929241202634,025-ASF,0.141643966136,117,201,318
3301,-0.645953270361,0.929241202634,025-ASG,0.141643966136,183,283,466
3302,-0.645953270361,0.929241202634,025-ASH,0.141643966136,185,221,406
3303,-0.645953270361,0.929241202634,025-ASI,0.141643966136,134,311,445
3304,-0.645953270361,0.929241202634,025-ASJ,0.141643966136,251,350,601
3305,-0.645953270361,0.929241202634,025-ASK,0.141643966136,220,406,626
3306,-0.645953270361,0.929241202634,025-ASL,0.141643966136,184,378,562
3307,-0.645953270361,0.929241202634,025-ASM,0.141643966136,196,223,419
3308,-0.645953270361,0.929241202634,025-ASN,0.141643966136,167,280,447
3309,-0.645953270361,0.929241202634,025-ASO,0.141643966136,318,541,859
3310,-0.645953270361,0.929241202634,025-ASP,0.141643966136,167,273,440
3311,-0.645953270361,0.929241202634,025-ASQ,0.141643966136,263,530,793
3312,-0.645953270361,0.929241202634,025-ASR,0.141643966136,264,403,667
3313,-0.645953270361,0.929241202634,025-ASS,0.141643966136,195,336,531
3314,-0.645953270361,0.929241202634,025-ASU,0.141643966136,359,335,694
3315,-0.645953270361,0.929241202634,025-ASV,0.141643966136,332,302,634
3316,-0.645953270361,0.929241202634,025-ASW,0.141643966136,281,218,499
3317,-0.645953270361,0.929241202634,025-ASX,0.141643966136,275,168,443
3318,-0.645953270361,0.929241202634,025-ASY,0.141643966136,500,333,833
3319,-0.645953270361,0.929241202634,025-ASZ,0.141643966136,143,270,413
3320,-0.645953270361,0.929241202634,025-ATA,0.141643966136,167,335,502
3321,-0.645953270361,0.929241202634,025-ATB,0.141643966136,101,275,376
3322,-0.645953270361,0.929241202634,025-ATC,0.141643966136,73,103,176
3323,-0.645953270361,0.929241202634,025-ATD,0.141643966136,154,291,445
3324,-0.645953270361,0.929241202634,025-ATE,0.141643966136,180,372,552
3325,-0.645953270361,0.929241202634,025-ATF,0.141643966136,150,259,409
3326,-0.645953270361,0.929241202634,025-ATG,0.141643966136,208,716,924
3327,-0.645953270361,0.929241202634,025-ATH,0.141643966136,221,582,803
3328,-0.645953270361,0.929241202634,025-ATI,0.141643966136,199,639,838
3329,-0.645953270361,0.929241202634,025-ATJ,0.141643966136,175,424,599
3330,-0.645953270361,0.929241202634,025-ATK,0.141643966136,95,396,491
3331,-0.645953270361,0.929241202634,025-ATM,0.141643966136,165,342,507
3332,-0.645953270361,0.929241202634,025-ATN,0.141643966136,121,326,447
3333,-0.645953270361,0.929241202634,025-ATO,0.141643966136,185,358,543
3334,-0.645953270361,0.929241202634,025-ATP,0.141643966136,213,406,619
3335,-0.645953270361,0.929241202634,025-ATQ,0.141643966136,117,313,430
3336,-0.645953270361,0.929241202634,025-ATR,0.141643966136,91,189,280
3337,-0.645953270361,0.929241202634,025-ATS,0.141643966136,157,323,480
3338,-0.645953270361,0.929241202634,025-ATT,0.141643966136,140,304,444
3339,-0.645953270361,0.929241202634,025-ATU,0.141643966136,220,391,611
3340,-0.645953270361,0.929241202634,025-ATV,0.141643966136,194,408,602
3341,-0.645953270361,0.929241202634,025-ATW,0.141643966136,194,491,685
3342,-0.645953270361,0.929241202634,025-ATX,0.141643966136,166,378,544
3343,-0.645953270361,0.929241202634,025-ATY,0.141643966136,235,489,724
3344,-0.645953270361,0.929241202634,025-ATZ,0.141643966136,148,240,388
3345,-0.645953270361,0.929241202634,025-AUA,0.141643966136,145,288,433
3346,-0.645953270361,0.929241202634,025-AUB,0.141643966136,105,194,299
3347,-0.645953270361,0.929241202634,025-AUC,0.141643966136,171,320,491
3348,-0.645953270361,0.929241202634,025-AUD,0.141643966136,233,438,671
3349,-0.645953270361,0.929241202634,025-AUE,0.141643966136,230,397,627
3350,-0.645953270361,0.929241202634,025-AUF,0.141643966136,219,461,680
3351,-0.645953270361,0.929241202634,025-AUG,0.141643966136,183,423,606
3352,-0.645953270361,0.929241202634,025-AUH,0.141643966136,213,196,409
3353,-0.645953270361,0.929241202634,025-AUI,0.141643966136,238,341,579
3354,-0.645953270361,0.929241202634,025-AUJ,0.141643966136,253,207,460
3355,-0.645953270361,0.929241202634,025-AUK,0.141643966136,207,364,571
3356,-0.645953270361,0.929241202634,025-AUL,0.141643966136,140,185,325
3357,-0.645953270361,0.929241202634,025-AUM,0.141643966136,331,540,871
3358,-0.645953270361,0.929241202634,025-AUN,0.141643966136,248,338,586
3359,-0.645953270361,0.929241202634,025-AUO,0.141643966136,88,140,228
3360,-0.645953270361,0.929241202634,025-AUP,0.141643966136,121,183,304
3361,-0.645953270361,0.929241202634,025-AUQ,0.141643966136,60,154,214
3362,-0.645953270361,0.929241202634,025-AUR,0.141643966136,251,363,614
3363,-0.645953270361,0.929241202634,025-AUS,0.141643966136,79,98,177
3364,-0.645953270361,0.929241202634,025-AUT,0.141643966136,242,402,644
3365,-0.645953270361,0.929241202634,025-AUU,0.141643966136,304,416,720
3366,-0.645953270361,0.929241202634,025-AUW,0.141643966136,149,117,266
3367,-0.645953270361,0.929241202634,025-AUX,0.141643966136,359,174,533
3368,-0.645953270361,0.929241202634,025-AUY,0.141643966136,192,221,413
3369,-0.645953270361,0.929241202634,025-AUZ,0.141643966136,147,257,404
3370,-0.645953270361,0.929241202634,025-AVA,0.141643966136,238,306,544
3371,-0.645953270361,0.929241202634,025-AVB,0.141643966136,277,284,561
3372,-0.645953270361,0.929241202634,025-AVC,0.141643966136,130,265,395
3373,-0.645953270361,0.929241202634,025-AVD,0.141643966136,150,233,383
3374,-0.645953270361,0.929241202634,025-AVE,0.141643966136,226,375,601
3375,-0.645953270361,0.929241202634,025-AVF,0.141643966136,148,373,521
3376,-0.645953270361,0.929241202634,025-AVG,0.141643966136,180,421,601
3377,-0.645953270361,0.929241202634,025-AVH,0.141643966136,82,388,470
3378,-0.645953270361,0.929241202634,025-AVI,0.141643966136,206,313,519
3379,-0.645953270361,0.929241202634,025-AVJ,0.141643966136,168,297,465
3380,-0.645953270361,0.929241202634,025-AVK,0.141643966136,193,226,419
3381,-0.645953270361,0.929241202634,025-AVL,0.141643966136,177,378,555
3382,-0.645953270361,0.929241202634,025-AVM,0.141643966136,355,510,865
3383,-0.645953270361,0.929241202634,025-AVN,0.141643966136,241,330,571
3384,-0.645953270361,0.929241202634,025-AVO,0.141643966136,235,360,595
3385,-0.645953270361,0.929241202634,025-AVQ,0.141643966136,195,282,477
3386,-0.645953270361,0.929241202634,025-AVR,0.141643966136,251,297,548
3387,-0.645953270361,0.929241202634,025-AVS,0.141643966136,227,291,518
3388,-0.645953270361,0.929241202634,025-AVT,0.141643966136,181,312,493
3389,-0.645953270361,0.929241202634,025-AVU,0.141643966136,202,380,582
3390,-0.645953270361,0.929241202634,025-AVV,0.141643966136,255,317,572
3391,-0.645953270361,0.929241202634,025-AVW,0.141643966136,200,446,646
3392,-0.645953270361,0.929241202634,025-AVX,0.141643966136,200,373,573
3393,-0.645953270361,0.929241202634,025-AVY,0.141643966136,164,288,452
3394,-0.645953270361,0.929241202634,025-AVZ,0.141643966136,297,596,893
3395,-0.645953270361,0.929241202634,025-AWB,0.141643966136,200,412,612
3396,-0.645953270361,0.929241202634,025-AWC,0.141643966136,219,367,586
3397,-0.645953270361,0.929241202634,025-AWD,0.141643966136,164,344,508
3398,-0.645953270361,0.929241202634,025-AWE,0.141643966136,326,627,953
3399,-0.645953270361,0.929241202634,025-AWF,0.141643966136,155,426,581
3400,-0.645953270361,0.929241202634,025-AWG,0.141643966136,124,408,532
3401,-0.645953270361,0.929241202634,025-AWI,0.141643966136,178,268,446
3402,-0.645953270361,0.929241202634,025-AWJ,0.141643966136,213,389,602
3403,-0.645953270361,0.929241202634,025-AWK,0.141643966136,145,325,470
3404,-0.645953270361,0.929241202634,025-AWL,0.141643966136,114,209,323
3405,-0.645953270361,0.929241202634,025-AWM,0.141643966136,169,323,492
3406,-0.645953270361,0.929241202634,025-AWN,0.141643966136,166,415,581
3407,-0.645953270361,0.929241202634,025-AWO,0.141643966136,269,489,758
3408,-0.645953270361,0.929241202634,025-AWP,0.141643966136,99,288,387
3409,-0.645953270361,0.929241202634,025-AWQ,0.141643966136,126,304,430
3410,-0.645953270361,0.929241202634,025-AWR,0.141643966136,195,392,587
3411,-0.645953270361,0.929241202634,025-AWS,0.141643966136,181,384,565
3412,-0.645953270361,0.929241202634,025-AWT,0.141643966136,292,554,846
3413,-0.645953270361,0.929241202634,025-AWU,0.141643966136,110,151,261
3414,-0.645953270361,0.929241202634,025-AWV,0.141643966136,157,243,400
3415,-0.645953270361,0.929241202634,025-AWW,0.141643966136,211,260,471
3416,-0.645953270361,0.929241202634,025-AWY,0.141643966136,182,421,603
3417,-0.645953270361,0.929241202634,025-AWZ,0.141643966136,300,578,878
3418,-0.645953270361,0.929241202634,025-AXA,0.141643966136,172,400,572
3419,-0.645953270361,0.929241202634,025-AXC,0.141643966136,188,242,430
3420,-0.645953270361,0.929241202634,025-AXD,0.141643966136,231,160,391
3421,-0.645953270361,0.929241202634,025-AXE,0.141643966136,136,309,445
3422,-0.645953270361,0.929241202634,025-AXF,0.141643966136,146,297,443
3423,-0.645953270361,0.929241202634,025-AXG,0.141643966136,163,398,561
3424,-0.645953270361,0.929241202634,025-AXH,0.141643966136,314,263,577
3425,-0.645953270361,0.929241202634,025-AXI,0.141643966136,233,256,489
3426,-0.645953270361,0.929241202634,025-AXK,0.141643966136,159,176,335
3427,-0.645953270361,0.929241202634,025-AXL,0.141643966136,145,178,323
3428,-0.645953270361,0.929241202634,025-AXM,0.141643966136,145,86,231
3429,-0.645953270361,0.929241202634,025-AXN,0.141643966136,180,243,423
3430,-0.645953270361,0.929241202634,025-AXO,0.141643966136,128,186,314
3431,-0.645953270361,0.929241202634,025-AXP,0.141643966136,171,177,348
3432,-0.645953270361,0.929241202634,025-AXR,0.141643966136,174,141,315
3433,-0.645953270361,0.929241202634,025-AXS,0.141643966136,235,179,414
3434,-0.645953270361,0.929241202634,025-AXT,0.141643966136,264,136,400
3435,-0.645953270361,0.929241202634,025-AXU,0.141643966136,285,318,603
3436,-0.645953270361,0.929241202634,025-AXV,0.141643966136,226,331,557
3437,-0.645953270361,0.929241202634,025-AXW,0.141643966136,225,385,610
3438,-0.645953270361,0.929241202634,025-AXX,0.141643966136,114,226,340
3439,-0.645953270361,0.929241202634,025-AXY,0.141643966136,318,257,575
3440,-0.645953270361,0.929241202634,025-AXZ,0.141643966136,283,234,517
3441,-0.645953270361,0.929241202634,025-AYA,0.141643966136,279,233,512
3442,-0.645953270361,0.929241202634,025-AYB,0.141643966136,488,521,1009
3443,-0.645953270361,0.929241202634,025-AYC,0.141643966136,405,620,1025
3444,-0.645953270361,0.929241202634,025-AYF,0.141643966136,211,205,416
3445,-0.645953270361,0.929241202634,025-AYG,0.141643966136,235,279,514
3446,-0.645953270361,0.929241202634,025-AYH,0.141643966136,152,243,395
3447,-0.645953270361,0.929241202634,025-AYI,0.141643966136,105,204,309
3448,-0.645953270361,0.929241202634,025-AYJ,0.141643966136,130,214,344
3449,-0.645953270361,0.929241202634,025-AYK,0.141643966136,62,183,245
3450,-0.645953270361,0.929241202634,025-AYL,0.141643966136,177,257,434
3451,-0.645953270361,0.929241202634,025-AYM,0.141643966136,277,395,672
3452,-0.645953270361,0.929241202634,025-AYN,0.141643966136,136,207,343
3453,-0.645953270361,0.929241202634,025-AYO,0.141643966136,140,264,404
3454,-0.645953270361,0.929241202634,025-AYQ,0.141643966136,240,394,634
3455,-0.645953270361,0.929241202634,025-AYR,0.141643966136,172,539,711
3456,-0.645953270361,0.929241202634,025-AYS,0.141643966136,105,290,395
3457,-0.645953270361,0.929241202634,025-AYT,0.141643966136,158,193,351
3458,-0.645953270361,0.929241202634,025-AYU,0.141643966136,190,159,349
3459,-0.645953270361,0.929241202634,025-AYV,0.141643966136,156,108,264
3460,-0.645953270361,0.929241202634,025-AYW,0.141643966136,169,277,446
3461,-0.645953270361,0.929241202634,025-AYX,0.141643966136,118,209,327
3462,-0.645953270361,0.929241202634,025-AYY,0.141643966136,142,284,426
3463,-0.645953270361,0.929241202634,025-AYZ,0.141643966136,116,228,344
3464,-0.645953270361,0.929241202634,025-AZA,0.141643966136,130,190,320
3465,-0.645953270361,0.929241202634,025-AZB,0.141643966136,50,13,63
3466,-0.645953270361,0.929241202634,025-AZC,0.141643966136,161,202,363
3467,-0.645953270361,0.929241202634,025-AZD,0.141643966136,74,113,187
3468,-0.645953270361,0.929241202634,025-AZE,0.141643966136,193,392,585
3469,-0.645953270361,0.929241202634,025-AZF,0.141643966136,79,204,283
3470,-0.645953270361,0.929241202634,025-AZG,0.141643966136,254,441,695
3471,-0.645953270361,0.929241202634,025-AZJ,0.141643966136,135,215,350
3472,-0.645953270361,0.929241202634,025-AZK,0.141643966136,182,315,497
3473,-0.645953270361,0.929241202634,025-AZL,0.141643966136,101,160,261
3474,-0.645953270361,0.929241202634,025-AZM,0.141643966136,119,329,448
3475,-0.645953270361,0.929241202634,025-AZN,0.141643966136,104,239,343
3476,-0.645953270361,0.929241202634,025-AZO,0.141643966136,100,330,430
3477,-0.645953270361,0.929241202634,025-AZP,0.141643966136,119,445,564
3478,-0.645953270361,0.929241202634,025-AZQ,0.141643966136,145,11,156
3479,-0.645953270361,0.929241202634,025-AZR,0.141643966136,181,526,707
3480,-0.645953270361,0.929241202634,025-AZS,0.141643966136,118,437,555
3481,-0.645953270361,0.929241202634,025-AZT,0.141643966136,143,430,573
3482,-0.645953270361,0.929241202634,025-AZU,0.141643966136,192,465,657
3483,-0.645953270361,0.929241202634,025-AZV,0.141643966136,171,431,602
3484,-0.645953270361,0.929241202634,025-AZW,0.141643966136,103,270,373
3485,-0.645953270361,0.929241202634,025-AZX,0.141643966136,46,120,166
3486,-0.645953270361,0.929241202634,025-AZY,0.141643966136,274,394,668
3487,-0.645953270361,0.929241202634,025-AZZ,0.141643966136,184,372,556
3488,-0.645953270361,0.929241202634,025-BAA,0.141643966136,108,207,315
3489,-0.645953270361,0.929241202634,025-BAB,0.141643966136,114,365,479
3490,-0.645953270361,0.929241202634,025-BAC,0.141643966136,111,374,485
3491,-0.645953270361,0.929241202634,025-BAD,0.141643966136,198,339,537
3492,-0.645953270361,0.929241202634,025-BAE,0.141643966136,249,271,520
3493,-0.645953270361,0.929241202634,025-BAF,0.141643966136,86,199,285
3494,-0.645953270361,0.929241202634,025-BAG,0.141643966136,199,259,458
3495,-0.645953270361,0.929241202634,025-BAH,0.141643966136,142,194,336
3496,-0.645953270361,0.929241202634,025-BAI,0.141643966136,195,247,442
3497,-0.645953270361,0.929241202634,025-BAJ,0.141643966136,184,107,291
3498,-0.645953270361,0.929241202634,025-BAK,0.141643966136,164,104,268
3499,-0.645953270361,0.929241202634,025-BAL,0.141643966136,139,352,491
3500,-0.645953270361,0.929241202634,025-BAM,0.141643966136,177,369,546
3501,-0.645953270361,0.929241202634,025-BAN,0.141643966136,152,342,494
3502,-0.645953270361,0.929241202634,025-BAO,0.141643966136,122,238,360
3503,-0.645953270361,0.929241202634,025-BAP,0.141643966136,196,336,532
3504,-0.645953270361,0.929241202634,025-BAQ,0.141643966136,201,397,598
3505,-0.645953270361,0.929241202634,025-BAR,0.141643966136,63,139,202
3506,-0.645953270361,0.929241202634,025-BAS,0.141643966136,260,462,722
3507,-0.645953270361,0.929241202634,025-BAT,0.141643966136,135,277,412
3508,-0.645953270361,0.929241202634,025-BAU,0.141643966136,134,428,562
3509,-0.645953270361,0.929241202634,025-BAV,0.141643966136,55,132,187
3510,-0.645953270361,0.929241202634,025-BAW,0.141643966136,167,485,652
3511,-0.645953270361,0.929241202634,025-BAZ,0.141643966136,105,274,379
3512,-0.645953270361,0.929241202634,025-BBA,0.141643966136,112,377,489
3513,-0.645953270361,0.929241202634,025-BBB,0.141643966136,180,374,554
3514,-0.645953270361,0.929241202634,025-BBC,0.141643966136,142,382,524
3515,-0.645953270361,0.929241202634,025-BBD,0.141643966136,85,276,361
3516,-0.645953270361,0.929241202634,025-BBE,0.141643966136,135,231,366
3517,-0.645953270361,0.929241202634,025-BBF,0.141643966136,127,290,417
3518,-0.645953270361,0.929241202634,025-BBG,0.141643966136,175,358,533
3519,-0.645953270361,0.929241202634,025-BBH,0.141643966136,125,311,436
3520,-0.645953270361,0.929241202634,025-BBI,0.141643966136,172,277,449
3521,-0.645953270361,0.929241202634,025-BBJ,0.141643966136,148,311,459
3522,-0.645953270361,0.929241202634,025-BBK,0.141643966136,199,280,479
3523,-0.645953270361,0.929241202634,025-BBL,0.141643966136,142,248,390
3524,-0.645953270361,0.929241202634,025-BBM,0.141643966136,159,156,315
3525,-0.645953270361,0.929241202634,025-BBN,0.141643966136,163,228,391
3526,-0.645953270361,0.929241202634,025-BBO,0.141643966136,85,93,178
3527,-0.645953270361,0.929241202634,025-BBP,0.141643966136,67,223,290
3528,-0.645953270361,0.929241202634,025-BBQ,0.141643966136,161,143,304
3529,-0.645953270361,0.929241202634,025-BBR,0.141643966136,169,300,469
3530,-0.645953270361,0.929241202634,025-BBS,0.141643966136,219,234,453
3531,-0.645953270361,0.929241202634,025-BBT,0.141643966136,22,53,75
3532,-0.645953270361,0.929241202634,025-BBU,0.141643966136,150,159,309
3533,-0.645953270361,0.929241202634,025-BBV,0.141643966136,86,225,311
3534,-0.645953270361,0.929241202634,025-BBX,0.141643966136,413,267,680
3535,-0.645953270361,0.929241202634,025-BCA,0.141643966136,242,267,509
3536,-0.645953270361,0.929241202634,025-BCC,0.141643966136,106,198,304
3537,-0.645953270361,0.929241202634,025-BCD,0.141643966136,151,270,421
3538,-0.645953270361,0.929241202634,025-BCE,0.141643966136,196,472,668
3539,-0.645953270361,0.929241202634,025-BCF,0.141643966136,140,422,562
3540,-0.645953270361,0.929241202634,025-BCG,0.141643966136,205,304,509
3541,-0.645953270361,0.929241202634,025-BCJ,0.141643966136,162,213,375
3542,-0.645953270361,0.929241202634,025-BCK,0.141643966136,158,430,588
3543,-0.645953270361,0.929241202634,025-BCS,0.141643966136,219,78,297
3544,-0.645953270361,0.929241202634,025-BCV,0.141643966136,187,176,363
3545,-0.645953270361,0.929241202634,025-BDA,0.141643966136,117,290,407
3546,-0.645953270361,0.929241202634,025-BDB,0.141643966136,162,335,497
3547,-0.645953270361,0.929241202634,025-BDC,0.141643966136,262,436,698
3548,-0.645953270361,0.929241202634,025-BDD,0.141643966136,116,323,439
3549,-0.645953270361,0.929241202634,025-BDE,0.141643966136,217,569,786
3550,-0.645953270361,0.929241202634,025-BDL,0.141643966136,242,299,541
3551,-0.645953270361,0.929241202634,025-BDO,0.141643966136,129,363,492
3552,-0.645953270361,0.929241202634,025-BDP,0.141643966136,131,263,394
3553,-0.645953270361,0.929241202634,025-BDQ,0.141643966136,156,481,637
3554,-0.645953270361,0.929241202634,025-BDS,0.141643966136,182,497,679
3555,-0.645953270361,0.929241202634,025-BDT,0.141643966136,163,400,563
3556,-0.645953270361,0.929241202634,025-BDU,0.141643966136,164,582,746
3557,-0.645953270361,0.929241202634,025-BDV,0.141643966136,49,85,134
3558,-0.645953270361,0.929241202634,025-BDW,0.141643966136,241,378,619
3559,-0.645953270361,0.929241202634,025-BDX,0.141643966136,105,190,295
3560,-0.645953270361,0.929241202634,025-BDY,0.141643966136,315,417,732
3561,-0.645953270361,0.929241202634,025-BDZ,0.141643966136,249,292,541
3562,-0.645953270361,0.929241202634,025-BEC,0.141643966136,195,525,720
3563,-0.645953270361,0.929241202634,025-BEG,0.141643966136,112,237,349
3564,-0.645953270361,0.929241202634,025-BEJ,0.141643966136,166,252,418
3565,-0.645953270361,0.929241202634,025-BEM,0.141643966136,300,357,657
3566,-0.645953270361,0.929241202634,025-BEQ,0.141643966136,129,107,236
3567,-0.645953270361,0.929241202634,025-BER,0.141643966136,384,132,516
3568,-0.645953270361,0.929241202634,025-BET,0.141643966136,327,45,372
3569,-0.645953270361,0.929241202634,025-BFN,0.141643966136,82,66,148
3570,-0.645953270361,0.929241202634,025-BFQ,0.141643966136,115,297,412
3571,-0.645953270361,0.929241202634,025-BFR,0.141643966136,199,347,546
3572,-0.645953270361,0.929241202634,025-BFS,0.141643966136,136,358,494
3573,-0.645953270361,0.929241202634,025-BFT,0.141643966136,235,579,814
3574,-0.645953270361,0.929241202634,025-BFU,0.141643966136,292,423,715
3575,-0.645953270361,0.929241202634,025-BFV,0.141643966136,148,447,595
3576,-0.645953270361,0.929241202634,025-BFW,0.141643966136,100,232,332
3577,-0.645953270361,0.929241202634,025-BFX,0.141643966136,229,531,760
3578,-0.645953270361,0.929241202634,025-BFZ,0.141643966136,198,363,561
3579,-0.645953270361,0.929241202634,025-BGA,0.141643966136,211,401,612
3580,-0.645953270361,0.929241202634,025-BGB,0.141643966136,125,226,351
3581,-0.645953270361,0.929241202634,025-BGC,0.141643966136,192,271,463
3582,-0.645953270361,0.929241202634,025-BGD,0.141643966136,110,142,252
3583,-0.645953270361,0.929241202634,025-BGE,0.141643966136,125,75,200
3584,-0.645953270361,0.929241202634,025-BGF,0.141643966136,183,297,480
3585,-0.645953270361,0.929241202634,025-BGG,0.141643966136,331,138,469
3586,-0.645953270361,0.929241202634,025-BGH,0.141643966136,201,236,437
3587,-0.645953270361,0.929241202634,025-BGI,0.141643966136,306,72,378
3588,-0.645953270361,0.929241202634,025-BGJ,0.141643966136,492,455,947
3589,-0.645953270361,0.929241202634,025-BGK,0.141643966136,369,157,526
3590,-0.645953270361,0.929241202634,025-BGL,0.141643966136,266,126,392
3591,-0.645953270361,0.929241202634,025-BGM,0.141643966136,143,233,376
3592,-0.645953270361,0.929241202634,025-BGN,0.141643966136,136,187,323
3593,-0.645953270361,0.929241202634,025-BGO,0.141643966136,285,423,708
3594,-0.645953270361,0.929241202634,025-BGP,0.141643966136,276,445,721
3595,-0.645953270361,0.929241202634,025-BGQ,0.141643966136,146,201,347
3596,-0.645953270361,0.929241202634,025-BGR,0.141643966136,195,193,388
3597,-0.645953270361,0.929241202634,025-BGU,0.141643966136,118,163,281
3598,-0.645953270361,0.929241202634,025-BGV,0.141643966136,194,328,522
3599,-0.645953270361,0.929241202634,025-BGW,0.141643966136,196,361,557
3600,-0.645953270361,0.929241202634,025-BGX,0.141643966136,127,90,217
3601,-0.645953270361,0.929241202634,025-BGY,0.141643966136,223,362,585
3602,-0.645953270361,0.929241202634,025-BGZ,0.141643966136,130,154,284
3603,-0.645953270361,0.929241202634,025-BHA,0.141643966136,147,190,337
3604,-0.645953270361,0.929241202634,025-BHB,0.141643966136,112,178,290
3605,-0.645953270361,0.929241202634,025-BHC,0.141643966136,276,453,729
3606,-0.645953270361,0.929241202634,025-BHD,0.141643966136,196,406,602
3607,-0.645953270361,0.929241202634,025-BHE,0.141643966136,275,432,707
3608,-0.645953270361,0.929241202634,025-BHF,0.141643966136,116,270,386
3609,-0.645953270361,0.929241202634,025-BHG,0.141643966136,165,202,367
3610,-0.645953270361,0.929241202634,025-BHH,0.141643966136,180,274,454
3611,-0.645953270361,0.929241202634,025-BHI,0.141643966136,155,140,295
3612,-0.645953270361,0.929241202634,025-BHJ,0.141643966136,216,297,513
3613,-0.645953270361,0.929241202634,025-BHK,0.141643966136,173,330,503
3614,-0.645953270361,0.929241202634,025-BHL,0.141643966136,179,281,460
3615,-0.645953270361,0.929241202634,025-BHM,0.141643966136,197,239,436
3616,-0.645953270361,0.929241202634,025-BHN,0.141643966136,106,134,240
3617,-0.645953270361,0.929241202634,025-BHO,0.141643966136,221,301,522
3618,-0.645953270361,0.929241202634,025-BHP,0.141643966136,136,210,346
3619,-0.645953270361,0.929241202634,025-BHQ,0.141643966136,270,375,645
3620,-0.645953270361,0.929241202634,025-BHR,0.141643966136,196,161,357
3621,-0.645953270361,0.929241202634,025-BHS,0.141643966136,280,246,526
3622,-0.645953270361,0.929241202634,025-BHT,0.141643966136,244,156,400
3623,-0.645953270361,0.929241202634,025-BHU,0.141643966136,216,243,459
3624,-0.645953270361,0.929241202634,025-BHV,0.141643966136,98,208,306
3625,-0.645953270361,0.929241202634,025-BHW,0.141643966136,272,388,660
3626,-0.645953270361,0.929241202634,025-BHX,0.141643966136,208,379,587
3627,-0.645953270361,0.929241202634,025-BHY,0.141643966136,218,253,471
3628,-0.645953270361,0.929241202634,025-BHZ,0.141643966136,220,373,593
3629,-0.645953270361,0.929241202634,025-BIA,0.141643966136,176,341,517
3630,-0.645953270361,0.929241202634,025-BIB,0.141643966136,347,237,584
3631,-0.645953270361,0.929241202634,025-BIC,0.141643966136,674,47,721
3632,-0.645953270361,0.929241202634,025-BID,0.141643966136,550,70,620
3633,-0.645953270361,0.929241202634,025-BIE,0.141643966136,544,39,583
3634,-0.645953270361,0.929241202634,025-BIF,0.141643966136,515,28,543
3635,-0.645953270361,0.929241202634,025-BIH,0.141643966136,398,333,731
3636,-0.645953270361,0.929241202634,025-BII,0.141643966136,325,155,480
3637,-0.645953270361,0.929241202634,025-BIJ,0.141643966136,281,216,497
3638,-0.645953270361,0.929241202634,025-BIK,0.141643966136,411,374,785
3639,-0.645953270361,0.929241202634,025-BIL,0.141643966136,189,239,428
3640,-0.645953270361,0.929241202634,025-BIM,0.141643966136,213,61,274
3641,-0.645953270361,0.929241202634,025-BIN,0.141643966136,100,171,271
3642,-0.645953270361,0.929241202634,025-BIO,0.141643966136,216,223,439
3643,-0.645953270361,0.929241202634,025-BIP,0.141643966136,259,289,548
3644,-0.645953270361,0.929241202634,025-BIQ,0.141643966136,273,322,595
3645,-0.645953270361,0.929241202634,025-BIR,0.141643966136,313,249,562
3646,-0.645953270361,0.929241202634,025-BIS,0.141643966136,153,104,257
3647,-0.645953270361,0.929241202634,025-BIT,0.141643966136,288,222,510
3648,-0.645953270361,0.929241202634,025-BIU,0.141643966136,195,187,382
3649,-0.645953270361,0.929241202634,025-BIV,0.141643966136,309,342,651
3650,-0.645953270361,0.929241202634,025-BIW,0.141643966136,240,363,603
3651,-0.645953270361,0.929241202634,025-BIX,0.141643966136,130,195,325
3652,-0.645953270361,0.929241202634,025-BIY,0.141643966136,159,170,329
3653,-0.645953270361,0.929241202634,025-BJA,0.141643966136,172,353,525
3654,-0.645953270361,0.929241202634,025-BJB,0.141643966136,133,459,592
3655,-0.645953270361,0.929241202634,025-BJC,0.141643966136,135,276,411
3656,-0.645953270361,0.929241202634,025-BJD,0.141643966136,158,353,511
3657,-0.645953270361,0.929241202634,025-BJE,0.141643966136,140,279,419
3658,-0.645953270361,0.929241202634,025-BJF,0.141643966136,181,139,320
3659,-0.645953270361,0.929241202634,025-BJI,0.141643966136,219,88,307
3660,-0.645953270361,0.929241202634,025-BJJ,0.141643966136,105,136,241
3661,-0.645953270361,0.929241202634,025-BJL,0.141643966136,185,191,376
3662,-0.645953270361,0.929241202634,025-BJN,0.141643966136,73,68,141
3663,-0.645953270361,0.929241202634,025-BJO,0.141643966136,316,535,851
3664,-0.645953270361,0.929241202634,025-BJP,0.141643966136,102,271,373
3665,-0.645953270361,0.929241202634,025-BJQ,0.141643966136,138,249,387
3666,-0.645953270361,0.929241202634,025-BJS,0.141643966136,370,63,433
3667,-0.645953270361,0.929241202634,025-BJT,0.141643966136,212,305,517
3668,-0.645953270361,0.929241202634,025-BJU,0.141643966136,113,163,276
3669,-0.645953270361,0.929241202634,025-BJV,0.141643966136,85,141,226
3670,-0.645953270361,0.929241202634,025-BJX,0.141643966136,137,302,439
3671,-0.645953270361,0.929241202634,025-BJY,0.141643966136,199,305,504
3672,-0.645953270361,0.929241202634,025-BJZ,0.141643966136,192,597,789
3673,-0.645953270361,0.929241202634,025-BKA,0.141643966136,110,246,356
3674,-0.645953270361,0.929241202634,025-BKB,0.141643966136,123,189,312
3675,-0.645953270361,0.929241202634,025-BKC,0.141643966136,157,168,325
3676,-0.645953270361,0.929241202634,025-BKE,0.141643966136,173,177,350
3677,-0.645953270361,0.929241202634,025-BKF,0.141643966136,94,287,381
3678,-0.645953270361,0.929241202634,025-BKI,0.141643966136,192,355,547
3679,-0.645953270361,0.929241202634,025-BKJ,0.141643966136,165,211,376
3680,-0.645953270361,0.929241202634,025-BKK,0.141643966136,256,451,707
3681,-0.645953270361,0.929241202634,025-BKL,0.141643966136,156,244,400
3682,-0.645953270361,0.929241202634,025-YYY,0.141643966136,57,9,66
3683,-0.645953270361,0.929241202634,026-AAA,0.141643966136,174,249,423
3684,-0.645953270361,0.929241202634,026-AAB,0.141643966136,93,79,172
3685,-0.645953270361,0.929241202634,026-AAC,0.141643966136,84,202,286
3686,-0.645953270361,0.929241202634,026-AAD,0.141643966136,102,325,427
3687,-0.645953270361,0.929241202634,026-AAE,0.141643966136,116,467,583
3688,-0.645953270361,0.929241202634,026-AAF,0.141643966136,137,355,492
3689,-0.645953270361,0.929241202634,026-AAG,0.141643966136,127,358,485
3690,-0.645953270361,0.929241202634,026-AAH,0.141643966136,121,237,358
3691,-0.645953270361,0.929241202634,026-AAI,0.141643966136,102,237,339
3692,-0.645953270361,0.929241202634,026-AAJ,0.141643966136,162,339,501
3693,-0.645953270361,0.929241202634,026-AAK,0.141643966136,161,374,535
3694,-0.645953270361,0.929241202634,026-AAL,0.141643966136,45,191,236
3695,-0.645953270361,0.929241202634,026-AAM,0.141643966136,178,337,515
3696,-0.645953270361,0.929241202634,026-AAN,0.141643966136,66,389,455
3697,-0.645953270361,0.929241202634,026-AAO,0.141643966136,79,378,457
3698,-0.645953270361,0.929241202634,026-AAP,0.141643966136,79,440,519
3699,-0.645953270361,0.929241202634,026-AAQ,0.141643966136,88,350,438
3700,-0.645953270361,0.929241202634,026-AAR,0.141643966136,68,216,284
3701,-0.645953270361,0.929241202634,026-AAS,0.141643966136,92,192,284
3702,-0.645953270361,0.929241202634,026-AAU,0.141643966136,236,430,666
3703,-0.645953270361,0.929241202634,026-AAV,0.141643966136,50,121,171
3704,-0.645953270361,0.929241202634,026-AAW,0.141643966136,112,187,299
3705,-0.645953270361,0.929241202634,026-AAX,0.141643966136,197,274,471
3706,-0.645953270361,0.929241202634,026-AAY,0.141643966136,224,323,547
3707,-0.645953270361,0.929241202634,026-AAZ,0.141643966136,150,277,427
3708,-0.645953270361,0.929241202634,026-ABA,0.141643966136,85,147,232
3709,-0.645953270361,0.929241202634,026-ABB,0.141643966136,118,157,275
3710,-0.645953270361,0.929241202634,026-ABC,0.141643966136,91,169,260
3711,-0.645953270361,0.929241202634,026-ABD,0.141643966136,136,190,326
3712,-0.645953270361,0.929241202634,026-ABE,0.141643966136,96,111,207
3713,-0.645953270361,0.929241202634,026-ABF,0.141643966136,99,275,374
3714,-0.645953270361,0.929241202634,026-ABG,0.141643966136,79,170,249
3715,-0.645953270361,0.929241202634,026-ABH,0.141643966136,177,320,497
3716,-0.645953270361,0.929241202634,026-ABI,0.141643966136,123,196,319
3717,-0.645953270361,0.929241202634,026-ABJ,0.141643966136,82,159,241
3718,-0.645953270361,0.929241202634,026-ABK,0.141643966136,141,285,426
3719,-0.645953270361,0.929241202634,027-AAA,0.141643966136,91,186,277
3720,-0.645953270361,0.929241202634,027-AAB,0.141643966136,68,106,174
3721,-0.645953270361,0.929241202634,027-AAC,0.141643966136,55,103,158
3722,-0.645953270361,0.929241202634,027-AAD,0.141643966136,32,60,92
3723,-0.645953270361,0.929241202634,027-AAE,0.141643966136,108,206,314
3724,-0.645953270361,0.929241202634,027-AAF,0.141643966136,104,158,262
3725,-0.645953270361,0.929241202634,027-AAG,0.141643966136,140,260,400
3726,-0.645953270361,0.929241202634,027-AAI,0.141643966136,129,163,292
3727,-0.645953270361,0.929241202634,027-AAJ,0.141643966136,80,158,238
3728,-0.645953270361,0.929241202634,027-AAK,0.141643966136,104,242,346
3729,-0.645953270361,0.929241202634,027-AAL,0.141643966136,68,178,246
3730,-0.645953270361,0.929241202634,027-AAM,0.141643966136,101,169,270
3731,-0.645953270361,0.929241202634,027-AAN,0.141643966136,102,202,304
3732,-0.645953270361,0.929241202634,027-AAO,0.141643966136,77,188,265
3733,-0.645953270361,0.929241202634,027-AAP,0.141643966136,113,189,302
3734,-0.645953270361,0.929241202634,027-AAQ,0.141643966136,112,298,410
3735,-0.645953270361,0.929241202634,027-AAR,0.141643966136,67,169,236
3736,-0.645953270361,0.929241202634,027-AAS,0.141643966136,101,176,277
3737,-0.645953270361,0.929241202634,027-AAT,0.141643966136,68,71,139
3738,-0.645953270361,0.929241202634,027-AAU,0.141643966136,40,112,152
3739,-0.645953270361,0.929241202634,027-AAV,0.141643966136,54,185,239
3740,-0.645953270361,0.929241202634,027-AAW,0.141643966136,114,174,288
3741,-0.645953270361,0.929241202634,027-AAX,0.141643966136,94,105,199
3742,-0.645953270361,0.929241202634,027-AAY,0.141643966136,66,103,169
3743,-0.645953270361,0.929241202634,027-AAZ,0.141643966136,131,229,360
3744,-0.645953270361,0.929241202634,027-ABA,0.141643966136,83,147,230
3745,-0.645953270361,0.929241202634,027-ABB,0.141643966136,134,239,373
3746,-0.645953270361,0.929241202634,027-ABC,0.141643966136,141,206,347
3747,-0.645953270361,0.929241202634,027-ABD,0.141643966136,73,118,191
3748,-0.645953270361,0.929241202634,027-ABE,0.141643966136,43,68,111
3749,-0.645953270361,0.929241202634,027-ABF,0.141643966136,120,137,257
3750,-0.645953270361,0.929241202634,027-ABG,0.141643966136,68,168,236
3751,-0.645953270361,0.929241202634,027-ABH,0.141643966136,121,242,363
3752,-0.645953270361,0.929241202634,027-ABI,0.141643966136,53,83,136
3753,-0.645953270361,0.929241202634,027-ABJ,0.141643966136,94,155,249
3754,-0.645953270361,0.929241202634,028-AAA,0.141643966136,125,396,521
3755,-0.645953270361,0.929241202634,028-AAB,0.141643966136,125,372,497
3756,-0.645953270361,0.929241202634,028-AAC,0.141643966136,96,328,424
3757,-0.645953270361,0.929241202634,028-AAD,0.141643966136,110,294,404
3758,-0.645953270361,0.929241202634,028-AAE,0.141643966136,275,247,522
3759,-0.645953270361,0.929241202634,028-AAF,0.141643966136,83,208,291
3760,-0.645953270361,0.929241202634,028-AAG,0.141643966136,150,377,527
3761,-0.645953270361,0.929241202634,028-AAH,0.141643966136,107,376,483
3762,-0.645953270361,0.929241202634,028-AAI,0.141643966136,155,221,376
3763,-0.645953270361,0.929241202634,028-AAJ,0.141643966136,112,289,401
3764,-0.645953270361,0.929241202634,028-AAK,0.141643966136,93,232,325
3765,-0.645953270361,0.929241202634,028-AAL,0.141643966136,99,244,343
3766,-0.645953270361,0.929241202634,028-AAM,0.141643966136,161,296,457
3767,-0.645953270361,0.929241202634,028-AAN,0.141643966136,115,311,426
3768,-0.645953270361,0.929241202634,028-AAO,0.141643966136,138,276,414
3769,-0.645953270361,0.929241202634,028-AAP,0.141643966136,129,280,409
3770,-0.645953270361,0.929241202634,028-AAQ,0.141643966136,91,244,335
3771,-0.645953270361,0.929241202634,028-AAR,0.141643966136,90,177,267
3772,-0.645953270361,0.929241202634,028-AAS,0.141643966136,85,270,355
3773,-0.645953270361,0.929241202634,028-AAT,0.141643966136,81,198,279
3774,-0.645953270361,0.929241202634,028-AAU,0.141643966136,79,118,197
3775,-0.645953270361,0.929241202634,028-AAV,0.141643966136,96,306,402
3776,-0.645953270361,0.929241202634,028-AAW,0.141643966136,120,322,442
3777,-0.645953270361,0.929241202634,028-AAX,0.141643966136,133,281,414
3778,-0.645953270361,0.929241202634,028-AAY,0.141643966136,142,288,430
3779,-0.645953270361,0.929241202634,028-AAZ,0.141643966136,111,220,331
3780,-0.645953270361,0.929241202634,028-ABA,0.141643966136,129,230,359
3781,-0.645953270361,0.929241202634,028-ABB,0.141643966136,80,152,232
3782,-0.645953270361,0.929241202634,028-ABC,0.141643966136,101,222,323
3783,-0.645953270361,0.929241202634,028-ABD,0.141643966136,159,389,548
3784,-0.645953270361,0.929241202634,028-ABE,0.141643966136,110,270,380
3785,-0.645953270361,0.929241202634,028-ABF,0.141643966136,97,214,311
3786,-0.645953270361,0.929241202634,028-ABG,0.141643966136,134,270,404
3787,-0.645953270361,0.929241202634,028-ABH,0.141643966136,103,216,319
3788,-0.645953270361,0.929241202634,028-ABI,0.141643966136,98,198,296
3789,-0.645953270361,0.929241202634,028-ABJ,0.141643966136,87,183,270
3790,-0.645953270361,0.929241202634,028-ABK,0.141643966136,76,188,264
3791,-0.645953270361,0.929241202634,028-ABL,0.141643966136,141,290,431
3792,-0.645953270361,0.929241202634,028-ABM,0.141643966136,157,300,457
3793,-0.645953270361,0.929241202634,028-ABN,0.141643966136,90,167,257
3794,-0.645953270361,0.929241202634,028-ABO,0.141643966136,105,266,371
3795,-0.645953270361,0.929241202634,028-ABP,0.141643966136,95,223,318
3796,-0.645953270361,0.929241202634,028-ABQ,0.141643966136,92,233,325
3797,-0.645953270361,0.929241202634,028-ABS,0.141643966136,35,65,100
3798,-0.645953270361,0.929241202634,028-ABT,0.141643966136,64,286,350
3799,-0.645953270361,0.929241202634,028-ABU,0.141643966136,111,347,458
3800,-0.645953270361,0.929241202634,028-ABV,0.141643966136,65,186,251
3801,-0.645953270361,0.929241202634,028-ABW,0.141643966136,133,325,458
3802,-0.645953270361,0.929241202634,028-ABX,0.141643966136,95,264,359
3803,-0.645953270361,0.929241202634,028-ABY,0.141643966136,106,371,477
3804,-0.645953270361,0.929241202634,028-ABZ,0.141643966136,118,393,511
3805,-0.645953270361,0.929241202634,028-ACA,0.141643966136,58,206,264
3806,-0.645953270361,0.929241202634,028-ACB,0.141643966136,51,167,218
3807,-0.645953270361,0.929241202634,028-ACC,0.141643966136,52,178,230
3808,-0.645953270361,0.929241202634,028-ACD,0.141643966136,68,150,218
3809,-0.645953270361,0.929241202634,028-ACE,0.141643966136,140,343,483
3810,-0.645953270361,0.929241202634,028-ACF,0.141643966136,110,267,377
3811,-0.645953270361,0.929241202634,028-ACG,0.141643966136,104,277,381
3812,-0.645953270361,0.929241202634,028-ACH,0.141643966136,110,242,352
3813,-0.645953270361,0.929241202634,028-ACI,0.141643966136,118,331,449
3814,-0.645953270361,0.929241202634,028-ACJ,0.141643966136,153,459,612
3815,-0.645953270361,0.929241202634,028-ACK,0.141643966136,110,326,436
3816,-0.645953270361,0.929241202634,028-ACL,0.141643966136,106,229,335
3817,-0.645953270361,0.929241202634,028-ACM,0.141643966136,144,244,388
3818,-0.645953270361,0.929241202634,028-ACN,0.141643966136,103,279,382
3819,-0.645953270361,0.929241202634,028-ACO,0.141643966136,110,209,319
3820,-0.645953270361,0.929241202634,028-ACP,0.141643966136,101,162,263
3821,-0.645953270361,0.929241202634,028-ACQ,0.141643966136,124,321,445
3822,-0.645953270361,0.929241202634,028-ACR,0.141643966136,141,342,483
3823,-0.645953270361,0.929241202634,028-ACS,0.141643966136,122,193,315
3824,-0.645953270361,0.929241202634,028-ACT,0.141643966136,139,310,449
3825,-0.645953270361,0.929241202634,028-ACU,0.141643966136,81,265,346
3826,-0.645953270361,0.929241202634,028-ACV,0.141643966136,82,283,365
3827,-0.645953270361,0.929241202634,028-ACW,0.141643966136,112,308,420
3828,-0.645953270361,0.929241202634,028-ACX,0.141643966136,123,240,363
3829,-0.645953270361,0.929241202634,028-ACY,0.141643966136,114,215,329
3830,-0.645953270361,0.929241202634,028-ACZ,0.141643966136,145,285,430
3831,-0.645953270361,0.929241202634,028-ADA,0.141643966136,84,208,292
3832,-0.645953270361,0.929241202634,028-ADB,0.141643966136,114,218,332
3833,-0.645953270361,0.929241202634,028-ADC,0.141643966136,88,232,320
3834,-0.645953270361,0.929241202634,028-ADD,0.141643966136,115,225,340
3835,-0.645953270361,0.929241202634,028-ADE,0.141643966136,94,221,315
3836,-0.645953270361,0.929241202634,028-ADF,0.141643966136,144,432,576
3837,-0.645953270361,0.929241202634,028-ADG,0.141643966136,152,302,454
3838,-0.645953270361,0.929241202634,028-ADH,0.141643966136,129,328,457
3839,-0.645953270361,0.929241202634,028-ADI,0.141643966136,92,270,362
3840,-0.645953270361,0.929241202634,028-ADJ,0.141643966136,107,211,318
3841,-0.645953270361,0.929241202634,028-ADK,0.141643966136,67,186,253
3842,-0.645953270361,0.929241202634,028-ADL,0.141643966136,62,108,170
3843,-0.645953270361,0.929241202634,028-ADM,0.141643966136,107,221,328
3844,-0.645953270361,0.929241202634,028-ADN,0.141643966136,131,256,387
3845,-0.645953270361,0.929241202634,028-ADO,0.141643966136,18,62,80
3846,-0.645953270361,0.929241202634,028-ADP,0.141643966136,128,279,407
3847,-0.645953270361,0.929241202634,028-ADQ,0.141643966136,137,320,457
3848,-0.645953270361,0.929241202634,028-ADR,0.141643966136,129,306,435
3849,-0.645953270361,0.929241202634,028-ADS,0.141643966136,128,337,465
3850,-0.645953270361,0.929241202634,029-AAA,0.141643966136,155,353,508
3851,-0.645953270361,0.929241202634,029-AAB,0.141643966136,168,280,448
3852,-0.645953270361,0.929241202634,029-AAC,0.141643966136,127,307,434
3853,-0.645953270361,0.929241202634,029-AAD,0.141643966136,95,270,365
3854,-0.645953270361,0.929241202634,029-AAE,0.141643966136,108,294,402
3855,-0.645953270361,0.929241202634,029-AAF,0.141643966136,140,424,564
3856,-0.645953270361,0.929241202634,029-AAG,0.141643966136,129,338,467
3857,-0.645953270361,0.929241202634,029-AAH,0.141643966136,121,314,435
3858,-0.645953270361,0.929241202634,029-AAI,0.141643966136,114,313,427
3859,-0.645953270361,0.929241202634,029-AAJ,0.141643966136,154,327,481
3860,-0.645953270361,0.929241202634,029-AAK,0.141643966136,169,398,567
3861,-0.645953270361,0.929241202634,029-AAL,0.141643966136,138,205,343
3862,-0.645953270361,0.929241202634,029-AAM,0.141643966136,90,288,378
3863,-0.645953270361,0.929241202634,029-AAN,0.141643966136,114,376,490
3864,-0.645953270361,0.929241202634,029-AAO,0.141643966136,136,304,440
3865,-0.645953270361,0.929241202634,029-AAP,0.141643966136,104,346,450
3866,-0.645953270361,0.929241202634,029-AAQ,0.141643966136,135,347,482
3867,-0.645953270361,0.929241202634,029-AAR,0.141643966136,135,374,509
3868,-0.645953270361,0.929241202634,029-AAS,0.141643966136,147,423,570
3869,-0.645953270361,0.929241202634,029-AAT,0.141643966136,133,284,417
3870,-0.645953270361,0.929241202634,029-AAU,0.141643966136,102,244,346
3871,-0.645953270361,0.929241202634,029-AAV,0.141643966136,230,434,664
3872,-0.645953270361,0.929241202634,029-AAW,0.141643966136,153,434,587
3873,-0.645953270361,0.929241202634,029-AAX,0.141643966136,117,442,559
3874,-0.645953270361,0.929241202634,029-AAY,0.141643966136,94,285,379
3875,-0.645953270361,0.929241202634,029-AAZ,0.141643966136,113,359,472
3876,-0.645953270361,0.929241202634,029-ABA,0.141643966136,90,215,305
3877,-0.645953270361,0.929241202634,029-ABB,0.141643966136,118,273,391
3878,-0.645953270361,0.929241202634,029-ABC,0.141643966136,107,280,387
3879,-0.645953270361,0.929241202634,029-ABD,0.141643966136,84,273,357
3880,-0.645953270361,0.929241202634,029-ABE,0.141643966136,117,307,424
3881,-0.645953270361,0.929241202634,029-ABF,0.141643966136,160,412,572
3882,-0.645953270361,0.929241202634,029-ABG,0.141643966136,107,338,445
3883,-0.645953270361,0.929241202634,029-ABH,0.141643966136,118,270,388
3884,-0.645953270361,0.929241202634,029-ABS,0.141643966136,101,301,402
3885,-0.645953270361,0.929241202634,029-ACD,0.141643966136,100,307,407
3886,-0.645953270361,0.929241202634,029-ACO,0.141643966136,70,220,290
3887,-0.645953270361,0.929241202634,029-ACP,0.141643966136,90,359,449
3888,-0.645953270361,0.929241202634,029-ACQ,0.141643966136,24,125,149
3889,-0.645953270361,0.929241202634,029-ACR,0.141643966136,121,285,406
3890,-0.645953270361,0.929241202634,029-ACS,0.141643966136,140,534,674
3891,-0.645953270361,0.929241202634,029-ACT,0.141643966136,85,300,385
3892,-0.645953270361,0.929241202634,029-ACU,0.141643966136,134,290,424
3893,-0.645953270361,0.929241202634,029-ACV,0.141643966136,123,305,428
3894,-0.645953270361,0.929241202634,029-ACW,0.141643966136,107,257,364
3895,-0.645953270361,0.929241202634,029-ACX,0.141643966136,90,242,332
3896,-0.645953270361,0.929241202634,029-ADF,0.141643966136,115,257,372
3897,-0.645953270361,0.929241202634,029-ADG,0.141643966136,101,170,271
3898,-0.645953270361,0.929241202634,029-ADH,0.141643966136,100,145,245
3899,-0.645953270361,0.929241202634,029-ADI,0.141643966136,86,232,318
3900,-0.645953270361,0.929241202634,029-ADJ,0.141643966136,106,295,401
3901,-0.645953270361,0.929241202634,029-ADK,0.141643966136,121,215,336
3902,-0.645953270361,0.929241202634,029-ADL,0.141643966136,118,213,331
3903,-0.645953270361,0.929241202634,029-ADM,0.141643966136,80,151,231
3904,-0.645953270361,0.929241202634,029-ADO,0.141643966136,96,165,261
3905,-0.645953270361,0.929241202634,029-ADP,0.141643966136,102,168,270
3906,-0.645953270361,0.929241202634,029-ADQ,0.141643966136,141,350,491
3907,-0.645953270361,0.929241202634,029-ADR,0.141643966136,123,312,435
3908,-0.645953270361,0.929241202634,029-ADS,0.141643966136,129,243,372
3909,-0.645953270361,0.929241202634,029-ADT,0.141643966136,158,306,464
3910,-0.645953270361,0.929241202634,029-ADU,0.141643966136,113,177,290
3911,-0.645953270361,0.929241202634,029-ADV,0.141643966136,109,262,371
3912,-0.645953270361,0.929241202634,029-ADW,0.141643966136,66,87,153
3913,-0.645953270361,0.929241202634,029-ADX,0.141643966136,74,124,198
3914,-0.645953270361,0.929241202634,029-ADY,0.141643966136,118,203,321
3915,-0.645953270361,0.929241202634,029-ADZ,0.141643966136,94,136,230
3916,-0.645953270361,0.929241202634,029-AEA,0.141643966136,71,96,167
3917,-0.645953270361,0.929241202634,029-AEB,0.141643966136,72,117,189
3918,-0.645953270361,0.929241202634,029-AEC,0.141643966136,160,149,309
3919,-0.645953270361,0.929241202634,029-AED,0.141643966136,86,239,325
3920,-0.645953270361,0.929241202634,029-AEY,0.141643966136,92,156,248
3921,-0.645953270361,0.929241202634,029-AEZ,0.141643966136,98,238,336
3922,-0.645953270361,0.929241202634,029-AFA,0.141643966136,75,158,233
3923,-0.645953270361,0.929241202634,029-AFB,0.141643966136,118,222,340
3924,-0.645953270361,0.929241202634,029-AFC,0.141643966136,114,164,278
3925,-0.645953270361,0.929241202634,029-AFD,0.141643966136,127,243,370
3926,-0.645953270361,0.929241202634,029-AFE,0.141643966136,109,219,328
3927,-0.645953270361,0.929241202634,029-AFF,0.141643966136,92,182,274
3928,-0.645953270361,0.929241202634,029-AFG,0.141643966136,133,374,507
3929,-0.645953270361,0.929241202634,029-AFH,0.141643966136,94,208,302
3930,-0.645953270361,0.929241202634,029-AFI,0.141643966136,106,202,308
3931,-0.645953270361,0.929241202634,029-AFJ,0.141643966136,125,262,387
3932,-0.645953270361,0.929241202634,029-AFK,0.141643966136,104,229,333
3933,-0.645953270361,0.929241202634,029-AFL,0.141643966136,87,153,240
3934,-0.645953270361,0.929241202634,029-AFM,0.141643966136,99,300,399
3935,-0.645953270361,0.929241202634,029-AFN,0.141643966136,109,148,257
3936,-0.645953270361,0.929241202634,029-AFO,0.141643966136,150,21,171
3937,-0.645953270361,0.929241202634,029-AFP,0.141643966136,113,262,375
3938,-0.645953270361,0.929241202634,029-AFQ,0.141643966136,139,86,225
3939,-0.645953270361,0.929241202634,029-AFR,0.141643966136,111,259,370
3940,-0.645953270361,0.929241202634,029-AFS,0.141643966136,154,296,450
3941,-0.645953270361,0.929241202634,029-AFT,0.141643966136,146,327,473
3942,-0.645953270361,0.929241202634,029-AGJ,0.141643966136,41,74,115
3943,-0.645953270361,0.929241202634,029-AGK,0.141643966136,103,298,401
3944,-0.645953270361,0.929241202634,029-AGL,0.141643966136,137,344,481
3945,-0.645953270361,0.929241202634,029-AGM,0.141643966136,106,203,309
3946,-0.645953270361,0.929241202634,029-AGQ,0.141643966136,133,370,503
3947,-0.645953270361,0.929241202634,029-AGR,0.141643966136,64,279,343
3948,-0.645953270361,0.929241202634,029-AGS,0.141643966136,73,181,254
3949,-0.645953270361,0.929241202634,029-AGT,0.141643966136,97,396,493
3950,-0.645953270361,0.929241202634,029-AGW,0.141643966136,41,171,212
3951,-0.645953270361,0.929241202634,029-AGX,0.141643966136,56,279,335
3952,-0.645953270361,0.929241202634,029-AGY,0.141643966136,64,341,405
3953,-0.645953270361,0.929241202634,029-AGZ,0.141643966136,38,271,309
3954,-0.645953270361,0.929241202634,029-AHA,0.141643966136,14,261,275
3955,-0.645953270361,0.929241202634,029-AHB,0.141643966136,46,313,359
3956,-0.645953270361,0.929241202634,029-AHD,0.141643966136,65,277,342
3957,-0.645953270361,0.929241202634,029-AHE,0.141643966136,20,73,93
3958,-0.645953270361,0.929241202634,029-AHF,0.141643966136,96,193,289
3959,-0.645953270361,0.929241202634,029-AHG,0.141643966136,208,138,346
3960,-0.645953270361,0.929241202634,029-AHH,0.141643966136,469,62,531
3961,-0.645953270361,0.929241202634,029-AHI,0.141643966136,362,55,417
3962,-0.645953270361,0.929241202634,029-AHJ,0.141643966136,386,32,418
3963,-0.645953270361,0.929241202634,029-AHK,0.141643966136,394,84,478
3964,-0.645953270361,0.929241202634,029-AHQ,0.141643966136,52,193,245
3965,-0.645953270361,0.929241202634,029-AHR,0.141643966136,60,370,430
3966,-0.645953270361,0.929241202634,029-AHS,0.141643966136,60,301,361
3967,-0.645953270361,0.929241202634,029-AHU,0.141643966136,57,295,352
3968,-0.645953270361,0.929241202634,029-AHV,0.141643966136,50,192,242
3969,-0.645953270361,0.929241202634,029-AHW,0.141643966136,109,290,399
3970,-0.645953270361,0.929241202634,029-AHX,0.141643966136,89,249,338
3971,-0.645953270361,0.929241202634,029-AHY,0.141643966136,55,168,223
3972,-0.645953270361,0.929241202634,029-AHZ,0.141643966136,130,376,506
3973,-0.645953270361,0.929241202634,029-AIA,0.141643966136,98,387,485
3974,-0.645953270361,0.929241202634,029-AIC,0.141643966136,51,134,185
3975,-0.645953270361,0.929241202634,029-AID,0.141643966136,91,212,303
3976,-0.645953270361,0.929241202634,029-AIE,0.141643966136,151,538,689
3977,-0.645953270361,0.929241202634,029-AIF,0.141643966136,91,504,595
3978,-0.645953270361,0.929241202634,029-AIG,0.141643966136,104,454,558
3979,-0.645953270361,0.929241202634,029-AIH,0.141643966136,47,262,309
3980,-0.645953270361,0.929241202634,029-AII,0.141643966136,115,414,529
3981,-0.645953270361,0.929241202634,029-AIK,0.141643966136,102,289,391
3982,-0.645953270361,0.929241202634,029-AIL,0.141643966136,76,250,326
3983,-0.645953270361,0.929241202634,029-AIM,0.141643966136,113,65,178
3984,-0.645953270361,0.929241202634,029-AIN,0.141643966136,145,17,162
3985,-0.645953270361,0.929241202634,029-AIO,0.141643966136,130,119,249
3986,-0.645953270361,0.929241202634,029-AIP,0.141643966136,79,336,415
3987,-0.645953270361,0.929241202634,029-AIQ,0.141643966136,87,336,423
3988,-0.645953270361,0.929241202634,029-AIR,0.141643966136,90,270,360
3989,-0.645953270361,0.929241202634,029-AIW,0.141643966136,74,347,421
3990,-0.645953270361,0.929241202634,029-AIX,0.141643966136,191,561,752
3991,-0.645953270361,0.929241202634,029-AIZ,0.141643966136,120,491,611
3992,-0.645953270361,0.929241202634,029-AJA,0.141643966136,85,575,660
3993,-0.645953270361,0.929241202634,029-AJB,0.141643966136,156,624,780
3994,-0.645953270361,0.929241202634,029-AJC,0.141643966136,131,394,525
3995,-0.645953270361,0.929241202634,029-AJD,0.141643966136,56,173,229
3996,-0.645953270361,0.929241202634,029-AND,0.141643966136,106,268,374
3997,-0.645953270361,0.929241202634,030-AAA,0.141643966136,153,190,343
3998,-0.645953270361,0.929241202634,030-AAD,0.141643966136,76,98,174
3999,-0.645953270361,0.929241202634,030-AAG,0.141643966136,90,95,185
4000,-0.645953270361,0.929241202634,030-AAJ,0.141643966136,104,147,251
4001,-0.645953270361,0.929241202634,030-AAN,0.141643966136,159,198,357
4002,-0.645953270361,0.929241202634,030-AAP,0.141643966136,162,287,449
4003,-0.645953270361,0.929241202634,030-AAW,0.141643966136,154,239,393
4004,-0.645953270361,0.929241202634,030-AAX,0.141643966136,136,215,351
4005,-0.645953270361,0.929241202634,030-ABA,0.141643966136,99,315,414
4006,-0.645953270361,0.929241202634,030-ABB,0.141643966136,77,171,248
4007,-0.645953270361,0.929241202634,030-ABC,0.141643966136,146,346,492
4008,-0.645953270361,0.929241202634,030-ABE,0.141643966136,171,270,441
4009,-0.645953270361,0.929241202634,030-ABG,0.141643966136,93,255,348
4010,-0.645953270361,0.929241202634,030-ABH,0.141643966136,78,197,275
4011,-0.645953270361,0.929241202634,030-ABI,0.141643966136,128,183,311
4012,-0.645953270361,0.929241202634,030-ABK,0.141643966136,162,200,362
4013,-0.645953270361,0.929241202634,030-ABL,0.141643966136,141,194,335
4014,-0.645953270361,0.929241202634,030-ABM,0.141643966136,104,101,205
4015,-0.645953270361,0.929241202634,030-ABO,0.141643966136,158,199,357
4016,-0.645953270361,0.929241202634,030-ABQ,0.141643966136,90,239,329
4017,-0.645953270361,0.929241202634,030-ABR,0.141643966136,68,110,178
4018,-0.645953270361,0.929241202634,030-ABS,0.141643966136,108,216,324
4019,-0.645953270361,0.929241202634,030-ABU,0.141643966136,111,219,330
4020,-0.645953270361,0.929241202634,030-ABX,0.141643966136,112,238,350
4021,-0.645953270361,0.929241202634,030-ACA,0.141643966136,134,280,414
4022,-0.645953270361,0.929241202634,030-ACB,0.141643966136,74,127,201
4023,-0.645953270361,0.929241202634,030-ACD,0.141643966136,44,45,89
4024,-0.645953270361,0.929241202634,030-ACE,0.141643966136,181,343,524
4025,-0.645953270361,0.929241202634,030-ACF,0.141643966136,63,56,119
4026,-0.645953270361,0.929241202634,030-ACG,0.141643966136,135,256,391
4027,-0.645953270361,0.929241202634,030-ACI,0.141643966136,161,151,312
4028,-0.645953270361,0.929241202634,030-ACK,0.141643966136,148,173,321
4029,-0.645953270361,0.929241202634,030-ACO,0.141643966136,97,217,314
4030,-0.645953270361,0.929241202634,030-ACP,0.141643966136,103,250,353
4031,-0.645953270361,0.929241202634,030-ACR,0.141643966136,154,342,496
4032,-0.645953270361,0.929241202634,031-AAA,0.141643966136,86,322,408
4033,-0.645953270361,0.929241202634,031-AAB,0.141643966136,119,313,432
4034,-0.645953270361,0.929241202634,031-AAC,0.141643966136,62,110,172
4035,-0.645953270361,0.929241202634,031-AAD,0.141643966136,117,272,389
4036,-0.645953270361,0.929241202634,031-AAE,0.141643966136,118,298,416
4037,-0.645953270361,0.929241202634,031-AAF,0.141643966136,193,123,316
4038,-0.645953270361,0.929241202634,031-AAG,0.141643966136,166,375,541
4039,-0.645953270361,0.929241202634,031-AAH,0.141643966136,96,201,297
4040,-0.645953270361,0.929241202634,031-AAI,0.141643966136,188,376,564
4041,-0.645953270361,0.929241202634,031-AAK,0.141643966136,159,293,452
4042,-0.645953270361,0.929241202634,031-AAM,0.141643966136,236,516,752
4043,-0.645953270361,0.929241202634,031-AAN,0.141643966136,141,257,398
4044,-0.645953270361,0.929241202634,031-AAP,0.141643966136,74,123,197
4045,-0.645953270361,0.929241202634,031-AAQ,0.141643966136,123,305,428
4046,-0.645953270361,0.929241202634,031-AAS,0.141643966136,36,135,171
4047,-0.645953270361,0.929241202634,031-AAT,0.141643966136,134,317,451
4048,-0.645953270361,0.929241202634,031-AAV,0.141643966136,135,348,483
4049,-0.645953270361,0.929241202634,031-AAY,0.141643966136,54,175,229
4050,-0.645953270361,0.929241202634,031-AAZ,0.141643966136,138,306,444
4051,-0.645953270361,0.929241202634,031-ABB,0.141643966136,38,94,132
4052,-0.645953270361,0.929241202634,031-ABC,0.141643966136,108,169,277
4053,-0.645953270361,0.929241202634,031-ABD,0.141643966136,152,220,372
4054,-0.645953270361,0.929241202634,031-ABE,0.141643966136,126,119,245
4055,-0.645953270361,0.929241202634,031-ABF,0.141643966136,116,142,258
4056,-0.645953270361,0.929241202634,031-ABG,0.141643966136,77,177,254
4057,-0.645953270361,0.929241202634,031-ABH,0.141643966136,115,168,283
4058,-0.645953270361,0.929241202634,031-ABI,0.141643966136,103,228,331
4059,-0.645953270361,0.929241202634,031-ABJ,0.141643966136,127,261,388
4060,-0.645953270361,0.929241202634,031-ABK,0.141643966136,194,302,496
4061,-0.645953270361,0.929241202634,031-ABL,0.141643966136,173,262,435
4062,-0.645953270361,0.929241202634,031-ABM,0.141643966136,114,151,265
4063,-0.645953270361,0.929241202634,031-ABN,0.141643966136,173,378,551
4064,-0.645953270361,0.929241202634,031-ABO,0.141643966136,74,165,239
4065,-0.645953270361,0.929241202634,031-ABP,0.141643966136,97,207,304
4066,-0.645953270361,0.929241202634,031-ABQ,0.141643966136,84,240,324
4067,-0.645953270361,0.929241202634,031-ABR,0.141643966136,194,330,524
4068,-0.645953270361,0.929241202634,031-ABY,0.141643966136,361,139,500
4069,-0.645953270361,0.929241202634,031-ACA,0.141643966136,259,31,290
4070,-0.645953270361,0.929241202634,031-ACB,0.141643966136,127,111,238
4071,-0.645953270361,0.929241202634,031-ACC,0.141643966136,211,127,338
4072,-0.645953270361,0.929241202634,031-ACD,0.141643966136,355,25,380
4073,-0.645953270361,0.929241202634,031-ACE,0.141643966136,373,82,455
4074,-0.645953270361,0.929241202634,031-ACF,0.141643966136,220,61,281
4075,-0.645953270361,0.929241202634,031-ACG,0.141643966136,212,113,325
4076,-0.645953270361,0.929241202634,031-ACH,0.141643966136,347,187,534
4077,-0.645953270361,0.929241202634,031-ACI,0.141643966136,169,189,358
4078,-0.645953270361,0.929241202634,031-ACJ,0.141643966136,171,160,331
4079,-0.645953270361,0.929241202634,031-ACK,0.141643966136,154,305,459
4080,-0.645953270361,0.929241202634,031-ACL,0.141643966136,111,121,232
4081,-0.645953270361,0.929241202634,031-ACM,0.141643966136,134,374,508
4082,-0.645953270361,0.929241202634,031-ACN,0.141643966136,201,145,346
4083,-0.645953270361,0.929241202634,031-ACZ,0.141643966136,244,10,254
4084,-0.645953270361,0.929241202634,031-ADA,0.141643966136,177,101,278
4085,-0.645953270361,0.929241202634,031-ADB,0.141643966136,210,65,275
4086,-0.645953270361,0.929241202634,031-ADC,0.141643966136,199,10,209
4087,-0.645953270361,0.929241202634,031-ADD,0.141643966136,207,5,212
4088,-0.645953270361,0.929241202634,031-ADE,0.141643966136,204,74,278
4089,-0.645953270361,0.929241202634,031-ADF,0.141643966136,210,9,219
4090,-0.645953270361,0.929241202634,031-ADG,0.141643966136,168,96,264
4091,-0.645953270361,0.929241202634,031-ADH,0.141643966136,241,7,248
4092,-0.645953270361,0.929241202634,031-ADI,0.141643966136,241,13,254
4093,-0.645953270361,0.929241202634,031-ADJ,0.141643966136,151,14,165
4094,-0.645953270361,0.929241202634,031-ADP,0.141643966136,260,252,512
4095,-0.645953270361,0.929241202634,031-ADQ,0.141643966136,202,289,491
4096,-0.645953270361,0.929241202634,031-ADR,0.141643966136,187,177,364
4097,-0.645953270361,0.929241202634,031-ADS,0.141643966136,226,288,514
4098,-0.645953270361,0.929241202634,031-ADT,0.141643966136,195,294,489
4099,-0.645953270361,0.929241202634,031-ADU,0.141643966136,181,258,439
4100,-0.645953270361,0.929241202634,031-ADV,0.141643966136,197,487,684
4101,-0.645953270361,0.929241202634,031-ADW,0.141643966136,170,220,390
4102,-0.645953270361,0.929241202634,031-ADX,0.141643966136,93,128,221
4103,-0.645953270361,0.929241202634,031-AEF,0.141643966136,168,431,599
4104,-0.645953270361,0.929241202634,031-AEG,0.141643966136,187,354,541
4105,-0.645953270361,0.929241202634,031-AEH,0.141643966136,322,178,500
4106,-0.645953270361,0.929241202634,031-AEI,0.141643966136,243,463,706
4107,-0.645953270361,0.929241202634,031-AEJ,0.141643966136,168,94,262
4108,-0.645953270361,0.929241202634,031-AEK,0.141643966136,164,265,429
4109,-0.645953270361,0.929241202634,031-AEL,0.141643966136,64,89,153
4110,-0.645953270361,0.929241202634,031-AEM,0.141643966136,164,374,538
4111,-0.645953270361,0.929241202634,031-AEN,0.141643966136,111,324,435
4112,-0.645953270361,0.929241202634,031-AEO,0.141643966136,203,333,536
4113,-0.645953270361,0.929241202634,031-AEP,0.141643966136,99,247,346
4114,-0.645953270361,0.929241202634,031-AFA,0.141643966136,116,88,204
4115,-0.645953270361,0.929241202634,031-AFB,0.141643966136,153,150,303
4116,-0.645953270361,0.929241202634,031-AFC,0.141643966136,165,16,181
4117,-0.645953270361,0.929241202634,031-AFD,0.141643966136,158,18,176
4118,-0.645953270361,0.929241202634,031-AFE,0.141643966136,153,131,284
4119,-0.645953270361,0.929241202634,031-AFF,0.141643966136,316,33,349
4120,-0.645953270361,0.929241202634,031-AFG,0.141643966136,303,23,326
4121,-0.645953270361,0.929241202634,031-AFH,0.141643966136,502,37,539
4122,-0.645953270361,0.929241202634,031-AFI,0.141643966136,284,11,295
4123,-0.645953270361,0.929241202634,031-AFJ,0.141643966136,352,7,359
4124,-0.645953270361,0.929241202634,031-AFK,0.141643966136,427,20,447
4125,-0.645953270361,0.929241202634,031-AFL,0.141643966136,347,35,382
4126,-0.645953270361,0.929241202634,031-AFM,0.141643966136,257,11,268
4127,-0.645953270361,0.929241202634,031-AFN,0.141643966136,312,33,345
4128,-0.645953270361,0.929241202634,031-AFO,0.141643966136,305,30,335
4129,-0.645953270361,0.929241202634,031-AFP,0.141643966136,195,27,222
4130,-0.645953270361,0.929241202634,031-AFQ,0.141643966136,256,20,276
4131,-0.645953270361,0.929241202634,031-AFR,0.141643966136,277,21,298
4132,-0.645953270361,0.929241202634,031-AFS,0.141643966136,296,32,328
4133,-0.645953270361,0.929241202634,031-AFT,0.141643966136,254,20,274
4134,-0.645953270361,0.929241202634,031-AFU,0.141643966136,307,18,325
4135,-0.645953270361,0.929241202634,031-AGD,0.141643966136,166,6,172
4136,-0.645953270361,0.929241202634,031-AGE,0.141643966136,152,13,165
4137,-0.645953270361,0.929241202634,031-AGF,0.141643966136,154,222,376
4138,-0.645953270361,0.929241202634,031-AGG,0.141643966136,232,18,250
4139,-0.645953270361,0.929241202634,031-AGH,0.141643966136,166,87,253
4140,-0.645953270361,0.929241202634,031-AGI,0.141643966136,154,7,161
4141,-0.645953270361,0.929241202634,031-AGJ,0.141643966136,125,258,383
4142,-0.645953270361,0.929241202634,031-AGK,0.141643966136,140,50,190
4143,-0.645953270361,0.929241202634,031-AGN,0.141643966136,174,10,184
4144,-0.645953270361,0.929241202634,031-AGO,0.141643966136,109,89,198
4145,-0.645953270361,0.929241202634,031-AGP,0.141643966136,239,14,253
4146,-0.645953270361,0.929241202634,031-AGQ,0.141643966136,137,14,151
4147,-0.645953270361,0.929241202634,031-AGR,0.141643966136,207,17,224
4148,-0.645953270361,0.929241202634,031-AGS,0.141643966136,165,6,171
4149,-0.645953270361,0.929241202634,031-AGT,0.141643966136,194,97,291
4150,-0.645953270361,0.929241202634,031-AGU,0.141643966136,136,21,157
4151,-0.645953270361,0.929241202634,031-AGY,0.141643966136,88,82,170
4152,-0.645953270361,0.929241202634,031-AGZ,0.141643966136,204,52,256
4153,-0.645953270361,0.929241202634,031-AHA,0.141643966136,216,60,276
4154,-0.645953270361,0.929241202634,031-AHB,0.141643966136,108,11,119
4155,-0.645953270361,0.929241202634,031-AHC,0.141643966136,93,12,105
4156,-0.645953270361,0.929241202634,031-AHD,0.141643966136,64,6,70
4157,-0.645953270361,0.929241202634,031-AHE,0.141643966136,122,63,185
4158,-0.645953270361,0.929241202634,031-AHF,0.141643966136,131,46,177
4159,-0.645953270361,0.929241202634,031-AHG,0.141643966136,118,42,160
4160,-0.645953270361,0.929241202634,031-AHH,0.141643966136,136,26,162
4161,-0.645953270361,0.929241202634,031-AHI,0.141643966136,88,46,134
4162,-0.645953270361,0.929241202634,031-AHJ,0.141643966136,162,52,214
4163,-0.645953270361,0.929241202634,031-AHK,0.141643966136,50,24,74
4164,-0.645953270361,0.929241202634,031-AHO,0.141643966136,62,56,118
4165,-0.645953270361,0.929241202634,031-AHP,0.141643966136,146,78,224
4166,-0.645953270361,0.929241202634,031-AHQ,0.141643966136,146,23,169
4167,-0.645953270361,0.929241202634,031-AHR,0.141643966136,125,42,167
4168,-0.645953270361,0.929241202634,031-AHS,0.141643966136,136,35,171
4169,-0.645953270361,0.929241202634,031-AHT,0.141643966136,93,20,113
4170,-0.645953270361,0.929241202634,031-AHU,0.141643966136,115,29,144
4171,-0.645953270361,0.929241202634,031-AHV,0.141643966136,39,37,76
4172,-0.645953270361,0.929241202634,031-AHW,0.141643966136,64,16,80
4173,-0.645953270361,0.929241202634,031-AIA,0.141643966136,148,1,149
4174,-0.645953270361,0.929241202634,031-AIB,0.141643966136,99,47,146
4175,-0.645953270361,0.929241202634,031-AIC,0.141643966136,214,12,226
4176,-0.645953270361,0.929241202634,031-AID,0.141643966136,187,16,203
4177,-0.645953270361,0.929241202634,031-AIE,0.141643966136,125,5,130
4178,-0.645953270361,0.929241202634,031-AIF,0.141643966136,149,17,166
4179,-0.645953270361,0.929241202634,031-AIG,0.141643966136,237,16,253
4180,-0.645953270361,0.929241202634,031-AIH,0.141643966136,141,3,144
4181,-0.645953270361,0.929241202634,031-AII,0.141643966136,137,18,155
4182,-0.645953270361,0.929241202634,031-AIJ,0.141643966136,280,49,329
4183,-0.645953270361,0.929241202634,031-AIK,0.141643966136,281,13,294
4184,-0.645953270361,0.929241202634,031-AIL,0.141643966136,213,6,219
4185,-0.645953270361,0.929241202634,031-AIM,0.141643966136,203,34,237
4186,-0.645953270361,0.929241202634,031-AIN,0.141643966136,318,108,426
4187,-0.645953270361,0.929241202634,031-AIO,0.141643966136,250,87,337
4188,-0.645953270361,0.929241202634,031-AIS,0.141643966136,204,93,297
4189,-0.645953270361,0.929241202634,031-AIT,0.141643966136,337,20,357
4190,-0.645953270361,0.929241202634,031-AIU,0.141643966136,146,139,285
4191,-0.645953270361,0.929241202634,031-AIV,0.141643966136,390,89,479
4192,-0.645953270361,0.929241202634,031-AIW,0.141643966136,291,15,306
4193,-0.645953270361,0.929241202634,031-AIX,0.141643966136,483,106,589
4194,-0.645953270361,0.929241202634,031-AIY,0.141643966136,189,121,310
4195,-0.645953270361,0.929241202634,031-AIZ,0.141643966136,204,118,322
4196,-0.645953270361,0.929241202634,031-AJA,0.141643966136,200,126,326
4197,-0.645953270361,0.929241202634,031-AJB,0.141643966136,123,67,190
4198,-0.645953270361,0.929241202634,031-AJC,0.141643966136,205,85,290
4199,-0.645953270361,0.929241202634,031-AJD,0.141643966136,203,81,284
4200,-0.645953270361,0.929241202634,031-AJE,0.141643966136,258,51,309
4201,-0.645953270361,0.929241202634,031-AJF,0.141643966136,175,43,218
4202,-0.645953270361,0.929241202634,031-AJG,0.141643966136,198,106,304
4203,-0.645953270361,0.929241202634,031-AJH,0.141643966136,257,83,340
4204,-0.645953270361,0.929241202634,031-AJN,0.141643966136,339,93,432
4205,-0.645953270361,0.929241202634,031-AJO,0.141643966136,199,83,282
4206,-0.645953270361,0.929241202634,031-AJP,0.141643966136,352,11,363
4207,-0.645953270361,0.929241202634,031-AJQ,0.141643966136,387,26,413
4208,-0.645953270361,0.929241202634,031-AJR,0.141643966136,295,81,376
4209,-0.645953270361,0.929241202634,031-AJS,0.141643966136,214,127,341
4210,-0.645953270361,0.929241202634,031-AJT,0.141643966136,267,87,354
4211,-0.645953270361,0.929241202634,031-AJU,0.141643966136,165,41,206
4212,-0.645953270361,0.929241202634,031-AJV,0.141643966136,358,149,507
4213,-0.645953270361,0.929241202634,031-AJW,0.141643966136,218,79,297
4214,-0.645953270361,0.929241202634,031-AJX,0.141643966136,222,152,374
4215,-0.645953270361,0.929241202634,031-AJY,0.141643966136,322,12,334
4216,-0.645953270361,0.929241202634,031-AJZ,0.141643966136,197,69,266
4217,-0.645953270361,0.929241202634,031-AKA,0.141643966136,198,56,254
4218,-0.645953270361,0.929241202634,031-AKJ,0.141643966136,247,58,305
4219,-0.645953270361,0.929241202634,031-AKK,0.141643966136,333,13,346
4220,-0.645953270361,0.929241202634,031-AKL,0.141643966136,143,27,170
4221,-0.645953270361,0.929241202634,031-AKM,0.141643966136,273,9,282
4222,-0.645953270361,0.929241202634,031-AKN,0.141643966136,67,12,79
4223,-0.645953270361,0.929241202634,031-AKO,0.141643966136,258,47,305
4224,-0.645953270361,0.929241202634,031-AKS,0.141643966136,120,8,128
4225,-0.645953270361,0.929241202634,031-AKT,0.141643966136,156,6,162
4226,-0.645953270361,0.929241202634,031-AKU,0.141643966136,177,12,189
4227,-0.645953270361,0.929241202634,031-AKW,0.141643966136,101,303,404
4228,-0.645953270361,0.929241202634,031-AKX,0.141643966136,73,229,302
4229,-0.645953270361,0.929241202634,031-AKY,0.141643966136,63,196,259
4230,-0.645953270361,0.929241202634,031-AKZ,0.141643966136,63,229,292
4231,-0.645953270361,0.929241202634,031-ALA,0.141643966136,103,145,248
4232,-0.645953270361,0.929241202634,031-ALB,0.141643966136,40,26,66
4233,-0.645953270361,0.929241202634,031-ALE,0.141643966136,65,47,112
4234,-0.645953270361,0.929241202634,031-ALF,0.141643966136,88,77,165
4235,-0.645953270361,0.929241202634,031-ALG,0.141643966136,117,92,209
4236,-0.645953270361,0.929241202634,031-ALH,0.141643966136,74,60,134
4237,-0.645953270361,0.929241202634,031-ALI,0.141643966136,144,143,287
4238,-0.645953270361,0.929241202634,031-ALJ,0.141643966136,207,184,391
4239,-0.645953270361,0.929241202634,031-ALK,0.141643966136,75,48,123
4240,-0.645953270361,0.929241202634,031-ALL,0.141643966136,136,113,249
4241,-0.645953270361,0.929241202634,031-ALM,0.141643966136,80,66,146
4242,-0.645953270361,0.929241202634,031-ALR,0.141643966136,140,63,203
4243,-0.645953270361,0.929241202634,031-ALS,0.141643966136,81,28,109
4244,-0.645953270361,0.929241202634,031-ALT,0.141643966136,104,41,145
4245,-0.645953270361,0.929241202634,031-ALU,0.141643966136,70,24,94
4246,-0.645953270361,0.929241202634,031-ALV,0.141643966136,158,9,167
4247,-0.645953270361,0.929241202634,031-ALW,0.141643966136,84,77,161
4248,-0.645953270361,0.929241202634,031-ALX,0.141643966136,86,74,160
4249,-0.645953270361,0.929241202634,031-ALY,0.141643966136,54,30,84
4250,-0.645953270361,0.929241202634,031-ALZ,0.141643966136,99,6,105
4251,-0.645953270361,0.929241202634,031-AMB,0.141643966136,181,64,245
4252,-0.645953270361,0.929241202634,031-AMC,0.141643966136,134,43,177
4253,-0.645953270361,0.929241202634,031-AMD,0.141643966136,75,1,76
4254,-0.645953270361,0.929241202634,031-AME,0.141643966136,258,6,264
4255,-0.645953270361,0.929241202634,031-AMF,0.141643966136,197,36,233
4256,-0.645953270361,0.929241202634,031-AMG,0.141643966136,153,90,243
4257,-0.645953270361,0.929241202634,031-AMI,0.141643966136,283,59,342
4258,-0.645953270361,0.929241202634,031-AMK,0.141643966136,192,39,231
4259,-0.645953270361,0.929241202634,031-AMM,0.141643966136,484,129,613
4260,-0.645953270361,0.929241202634,031-AMO,0.141643966136,471,31,502
4261,-0.645953270361,0.929241202634,031-AMQ,0.141643966136,221,121,342
4262,-0.645953270361,0.929241202634,031-AMS,0.141643966136,216,53,269
4263,-0.645953270361,0.929241202634,031-AMU,0.141643966136,298,291,589
4264,-0.645953270361,0.929241202634,031-AMW,0.141643966136,256,202,458
4265,-0.645953270361,0.929241202634,031-AMY,0.141643966136,191,66,257
4266,-0.645953270361,0.929241202634,031-ANA,0.141643966136,432,156,588
4267,-0.645953270361,0.929241202634,031-ANB,0.141643966136,127,88,215
4268,-0.645953270361,0.929241202634,031-ANC,0.141643966136,323,131,454
4269,-0.645953270361,0.929241202634,031-AND,0.141643966136,350,230,580
4270,-0.645953270361,0.929241202634,031-ANE,0.141643966136,186,117,303
4271,-0.645953270361,0.929241202634,031-ANF,0.141643966136,295,179,474
4272,-0.645953270361,0.929241202634,031-ANG,0.141643966136,258,84,342
4273,-0.645953270361,0.929241202634,031-ANH,0.141643966136,187,77,264
4274,-0.645953270361,0.929241202634,031-ANI,0.141643966136,161,50,211
4275,-0.645953270361,0.929241202634,031-ANJ,0.141643966136,155,17,172
4276,-0.645953270361,0.929241202634,031-ANK,0.141643966136,111,176,287
4277,-0.645953270361,0.929241202634,031-ANL,0.141643966136,135,39,174
4278,-0.645953270361,0.929241202634,031-ANM,0.141643966136,236,41,277
4279,-0.645953270361,0.929241202634,031-ANN,0.141643966136,152,216,368
4280,-0.645953270361,0.929241202634,031-ANQ,0.141643966136,249,39,288
4281,-0.645953270361,0.929241202634,031-ANR,0.141643966136,200,76,276
4282,-0.645953270361,0.929241202634,031-ANS,0.141643966136,457,24,481
4283,-0.645953270361,0.929241202634,031-ANT,0.141643966136,114,179,293
4284,-0.645953270361,0.929241202634,031-ANU,0.141643966136,93,25,118
4285,-0.645953270361,0.929241202634,031-ANV,0.141643966136,199,61,260
4286,-0.645953270361,0.929241202634,031-ANW,0.141643966136,226,224,450
4287,-0.645953270361,0.929241202634,031-ANX,0.141643966136,172,118,290
4288,-0.645953270361,0.929241202634,031-ANY,0.141643966136,158,53,211
4289,-0.645953270361,0.929241202634,031-ANZ,0.141643966136,115,13,128
4290,-0.645953270361,0.929241202634,031-AOA,0.141643966136,200,138,338
4291,-0.645953270361,0.929241202634,031-AOB,0.141643966136,96,145,241
4292,-0.645953270361,0.929241202634,031-AOC,0.141643966136,197,82,279
4293,-0.645953270361,0.929241202634,031-AOD,0.141643966136,89,0,89
4294,-0.645953270361,0.929241202634,031-AOE,0.141643966136,105,1,106
4295,-0.645953270361,0.929241202634,031-AOI,0.141643966136,324,52,376
4296,-0.645953270361,0.929241202634,031-AOK,0.141643966136,156,110,266
4297,-0.645953270361,0.929241202634,031-AOM,0.141643966136,76,76,152
4298,-0.645953270361,0.929241202634,031-AON,0.141643966136,141,116,257
4299,-0.645953270361,0.929241202634,031-AOO,0.141643966136,181,417,598
4300,-0.645953270361,0.929241202634,031-AOP,0.141643966136,115,148,263
4301,-0.645953270361,0.929241202634,031-AOQ,0.141643966136,187,41,228
4302,-0.645953270361,0.929241202634,031-AOR,0.141643966136,153,234,387
4303,-0.645953270361,0.929241202634,031-AOS,0.141643966136,168,316,484
4304,-0.645953270361,0.929241202634,031-AOT,0.141643966136,231,185,416
4305,-0.645953270361,0.929241202634,031-AOU,0.141643966136,183,409,592
4306,-0.645953270361,0.929241202634,031-AOV,0.141643966136,176,154,330
4307,-0.645953270361,0.929241202634,031-AOW,0.141643966136,99,120,219
4308,-0.645953270361,0.929241202634,031-AOX,0.141643966136,161,215,376
4309,-0.645953270361,0.929241202634,031-AOY,0.141643966136,115,117,232
4310,-0.645953270361,0.929241202634,031-APK,0.141643966136,114,225,339
4311,-0.645953270361,0.929241202634,031-APM,0.141643966136,274,179,453
4312,-0.645953270361,0.929241202634,031-APO,0.141643966136,134,147,281
4313,-0.645953270361,0.929241202634,031-APQ,0.141643966136,330,66,396
4314,-0.645953270361,0.929241202634,031-APS,0.141643966136,267,39,306
4315,-0.645953270361,0.929241202634,031-APU,0.141643966136,161,181,342
4316,-0.645953270361,0.929241202634,031-APW,0.141643966136,130,25,155
4317,-0.645953270361,0.929241202634,031-APY,0.141643966136,157,9,166
4318,-0.645953270361,0.929241202634,031-AQA,0.141643966136,181,294,475
4319,-0.645953270361,0.929241202634,031-AQC,0.141643966136,230,62,292
4320,-0.645953270361,0.929241202634,031-AQE,0.141643966136,92,158,250
4321,-0.645953270361,0.929241202634,031-AQG,0.141643966136,120,204,324
4322,-0.645953270361,0.929241202634,031-AQI,0.141643966136,192,66,258
4323,-0.645953270361,0.929241202634,031-AQK,0.141643966136,285,130,415
4324,-0.645953270361,0.929241202634,031-AQM,0.141643966136,145,47,192
4325,-0.645953270361,0.929241202634,031-AQO,0.141643966136,203,125,328
4326,-0.645953270361,0.929241202634,031-AQP,0.141643966136,193,56,249
4327,-0.645953270361,0.929241202634,031-AQQ,0.141643966136,220,62,282
4328,-0.645953270361,0.929241202634,031-AQR,0.141643966136,130,282,412
4329,-0.645953270361,0.929241202634,031-AQS,0.141643966136,195,272,467
4330,-0.645953270361,0.929241202634,031-AQT,0.141643966136,155,9,164
4331,-0.645953270361,0.929241202634,031-AQU,0.141643966136,117,152,269
4332,-0.645953270361,0.929241202634,031-AQV,0.141643966136,262,319,581
4333,-0.645953270361,0.929241202634,031-AQW,0.141643966136,189,25,214
4334,-0.645953270361,0.929241202634,031-AQZ,0.141643966136,134,342,476
4335,-0.645953270361,0.929241202634,031-ARC,0.141643966136,119,361,480
4336,-0.645953270361,0.929241202634,031-ARE,0.141643966136,118,346,464
4337,-0.645953270361,0.929241202634,031-ARG,0.141643966136,172,416,588
4338,-0.645953270361,0.929241202634,031-ARI,0.141643966136,404,79,483
4339,-0.645953270361,0.929241202634,031-ARJ,0.141643966136,316,229,545
4340,-0.645953270361,0.929241202634,031-ARK,0.141643966136,357,55,412
4341,-0.645953270361,0.929241202634,031-ARL,0.141643966136,407,101,508
4342,-0.645953270361,0.929241202634,031-ARM,0.141643966136,362,149,511
4343,-0.645953270361,0.929241202634,031-ARN,0.141643966136,172,73,245
4344,-0.645953270361,0.929241202634,031-ARO,0.141643966136,441,51,492
4345,-0.645953270361,0.929241202634,031-ARP,0.141643966136,390,78,468
4346,-0.645953270361,0.929241202634,031-ARQ,0.141643966136,450,159,609
4347,-0.645953270361,0.929241202634,031-ARR,0.141643966136,431,91,522
4348,-0.645953270361,0.929241202634,031-ARS,0.141643966136,329,97,426
4349,-0.645953270361,0.929241202634,031-ART,0.141643966136,383,152,535
4350,-0.645953270361,0.929241202634,031-ARU,0.141643966136,438,82,520
4351,-0.645953270361,0.929241202634,031-ASG,0.141643966136,72,368,440
4352,-0.645953270361,0.929241202634,031-ASH,0.141643966136,97,671,768
4353,-0.645953270361,0.929241202634,031-ASI,0.141643966136,92,484,576
4354,-0.645953270361,0.929241202634,031-ASJ,0.141643966136,64,409,473
4355,-0.645953270361,0.929241202634,031-ASK,0.141643966136,80,451,531
4356,-0.645953270361,0.929241202634,031-ASL,0.141643966136,57,377,434
4357,-0.645953270361,0.929241202634,031-ASO,0.141643966136,112,368,480
4358,-0.645953270361,0.929241202634,031-ASP,0.141643966136,79,265,344
4359,-0.645953270361,0.929241202634,031-ASQ,0.141643966136,41,126,167
4360,-0.645953270361,0.929241202634,031-ASR,0.141643966136,117,268,385
4361,-0.645953270361,0.929241202634,031-ASS,0.141643966136,109,413,522
4362,-0.645953270361,0.929241202634,031-AST,0.141643966136,107,279,386
4363,-0.645953270361,0.929241202634,031-ASU,0.141643966136,94,306,400
4364,-0.645953270361,0.929241202634,031-ASV,0.141643966136,63,163,226
4365,-0.645953270361,0.929241202634,031-ASW,0.141643966136,101,283,384
4366,-0.645953270361,0.929241202634,031-ASZ,0.141643966136,161,453,614
4367,-0.645953270361,0.929241202634,031-ATA,0.141643966136,78,279,357
4368,-0.645953270361,0.929241202634,031-ATB,0.141643966136,129,365,494
4369,-0.645953270361,0.929241202634,031-ATC,0.141643966136,105,289,394
4370,-0.645953270361,0.929241202634,031-ATD,0.141643966136,89,225,314
4371,-0.645953270361,0.929241202634,031-ATE,0.141643966136,121,492,613
4372,-0.645953270361,0.929241202634,031-ATF,0.141643966136,64,274,338
4373,-0.645953270361,0.929241202634,031-ATG,0.141643966136,101,379,480
4374,-0.645953270361,0.929241202634,031-ATH,0.141643966136,94,293,387
4375,-0.645953270361,0.929241202634,031-ATN,0.141643966136,189,575,764
4376,-0.645953270361,0.929241202634,031-ATO,0.141643966136,169,648,817
4377,-0.645953270361,0.929241202634,031-ATP,0.141643966136,131,374,505
4378,-0.645953270361,0.929241202634,031-ATQ,0.141643966136,136,289,425
4379,-0.645953270361,0.929241202634,031-ATR,0.141643966136,124,259,383
4380,-0.645953270361,0.929241202634,031-ATS,0.141643966136,187,451,638
4381,-0.645953270361,0.929241202634,031-ATT,0.141643966136,100,324,424
4382,-0.645953270361,0.929241202634,031-ATU,0.141643966136,112,449,561
4383,-0.645953270361,0.929241202634,031-ATV,0.141643966136,80,250,330
4384,-0.645953270361,0.929241202634,031-ATW,0.141643966136,162,482,644
4385,-0.645953270361,0.929241202634,031-AUA,0.141643966136,219,134,353
4386,-0.645953270361,0.929241202634,031-AUB,0.141643966136,240,130,370
4387,-0.645953270361,0.929241202634,031-AUC,0.141643966136,180,268,448
4388,-0.645953270361,0.929241202634,031-AUE,0.141643966136,226,250,476
4389,-0.645953270361,0.929241202634,031-AUG,0.141643966136,192,245,437
4390,-0.645953270361,0.929241202634,031-AUI,0.141643966136,155,159,314
4391,-0.645953270361,0.929241202634,031-AUJ,0.141643966136,250,314,564
4392,-0.645953270361,0.929241202634,031-AUM,0.141643966136,218,147,365
4393,-0.645953270361,0.929241202634,031-AUO,0.141643966136,267,247,514
4394,-0.645953270361,0.929241202634,031-AUQ,0.141643966136,277,300,577
4395,-0.645953270361,0.929241202634,031-AUR,0.141643966136,123,143,266
4396,-0.645953270361,0.929241202634,031-AUS,0.141643966136,265,79,344
4397,-0.645953270361,0.929241202634,031-AUW,0.141643966136,90,161,251
4398,-0.645953270361,0.929241202634,031-AUX,0.141643966136,148,198,346
4399,-0.645953270361,0.929241202634,031-AUZ,0.141643966136,146,255,401
4400,-0.645953270361,0.929241202634,031-AVA,0.141643966136,148,279,427
4401,-0.645953270361,0.929241202634,031-AVB,0.141643966136,128,244,372
4402,-0.645953270361,0.929241202634,031-AVD,0.141643966136,106,200,306
4403,-0.645953270361,0.929241202634,031-AVE,0.141643966136,101,205,306
4404,-0.645953270361,0.929241202634,031-AVF,0.141643966136,74,121,195
4405,-0.645953270361,0.929241202634,031-AVG,0.141643966136,123,242,365
4406,-0.645953270361,0.929241202634,031-AVH,0.141643966136,120,202,322
4407,-0.645953270361,0.929241202634,031-AVI,0.141643966136,132,252,384
4408,-0.645953270361,0.929241202634,031-AVJ,0.141643966136,150,314,464
4409,-0.645953270361,0.929241202634,031-AVV,0.141643966136,112,202,314
4410,-0.645953270361,0.929241202634,031-AVW,0.141643966136,115,98,213
4411,-0.645953270361,0.929241202634,031-AVX,0.141643966136,84,191,275
4412,-0.645953270361,0.929241202634,031-AVZ,0.141643966136,122,250,372
4413,-0.645953270361,0.929241202634,031-AWA,0.141643966136,71,191,262
4414,-0.645953270361,0.929241202634,031-AWD,0.141643966136,132,377,509
4415,-0.645953270361,0.929241202634,031-AWE,0.141643966136,82,317,399
4416,-0.645953270361,0.929241202634,031-AWH,0.141643966136,89,358,447
4417,-0.645953270361,0.929241202634,031-AWI,0.141643966136,122,492,614
4418,-0.645953270361,0.929241202634,031-AWL,0.141643966136,104,265,369
4419,-0.645953270361,0.929241202634,031-AWN,0.141643966136,119,274,393
4420,-0.645953270361,0.929241202634,031-AWP,0.141643966136,161,227,388
4421,-0.645953270361,0.929241202634,031-AWR,0.141643966136,132,217,349
4422,-0.645953270361,0.929241202634,031-AWT,0.141643966136,159,257,416
4423,-0.645953270361,0.929241202634,031-AWU,0.141643966136,121,188,309
4424,-0.645953270361,0.929241202634,031-AWW,0.141643966136,194,457,651
4425,-0.645953270361,0.929241202634,031-AWZ,0.141643966136,55,233,288
4426,-0.645953270361,0.929241202634,031-AXA,0.141643966136,162,469,631
4427,-0.645953270361,0.929241202634,031-AXB,0.141643966136,161,343,504
4428,-0.645953270361,0.929241202634,031-AXD,0.141643966136,150,481,631
4429,-0.645953270361,0.929241202634,031-AXE,0.141643966136,135,458,593
4430,-0.645953270361,0.929241202634,031-AXI,0.141643966136,325,253,578
4431,-0.645953270361,0.929241202634,031-AXJ,0.141643966136,585,75,660
4432,-0.645953270361,0.929241202634,031-AXK,0.141643966136,377,165,542
4433,-0.645953270361,0.929241202634,031-AXQ,0.141643966136,362,258,620
4434,-0.645953270361,0.929241202634,031-AXR,0.141643966136,285,339,624
4435,-0.645953270361,0.929241202634,031-AXS,0.141643966136,131,213,344
4436,-0.645953270361,0.929241202634,031-AXT,0.141643966136,229,398,627
4437,-0.645953270361,0.929241202634,031-AXU,0.141643966136,178,264,442
4438,-0.645953270361,0.929241202634,031-AXV,0.141643966136,153,174,327
4439,-0.645953270361,0.929241202634,031-AXW,0.141643966136,56,32,88
4440,-0.645953270361,0.929241202634,031-AXX,0.141643966136,47,42,89
4441,-0.645953270361,0.929241202634,031-AXY,0.141643966136,286,196,482
4442,-0.645953270361,0.929241202634,031-AYD,0.141643966136,371,540,911
4443,-0.645953270361,0.929241202634,031-AYE,0.141643966136,303,536,839
4444,-0.645953270361,0.929241202634,031-AYF,0.141643966136,324,401,725
4445,-0.645953270361,0.929241202634,031-AYG,0.141643966136,417,334,751
4446,-0.645953270361,0.929241202634,031-AYH,0.141643966136,339,584,923
4447,-0.645953270361,0.929241202634,031-AYP,0.141643966136,227,272,499
4448,-0.645953270361,0.929241202634,031-AYQ,0.141643966136,195,331,526
4449,-0.645953270361,0.929241202634,031-AYR,0.141643966136,182,265,447
4450,-0.645953270361,0.929241202634,031-AYS,0.141643966136,198,344,542
4451,-0.645953270361,0.929241202634,031-AYU,0.141643966136,129,479,608
4452,-0.645953270361,0.929241202634,031-AYV,0.141643966136,169,552,721
4453,-0.645953270361,0.929241202634,031-AYW,0.141643966136,139,470,609
4454,-0.645953270361,0.929241202634,031-AYX,0.141643966136,111,401,512
4455,-0.645953270361,0.929241202634,031-AYY,0.141643966136,186,617,803
4456,-0.645953270361,0.929241202634,031-AYZ,0.141643966136,88,310,398
4457,-0.645953270361,0.929241202634,031-AZA,0.141643966136,151,663,814
4458,-0.645953270361,0.929241202634,031-AZB,0.141643966136,178,511,689
4459,-0.645953270361,0.929241202634,031-AZC,0.141643966136,129,587,716
4460,-0.645953270361,0.929241202634,031-AZD,0.141643966136,82,278,360
4461,-0.645953270361,0.929241202634,031-AZE,0.141643966136,142,652,794
4462,-0.645953270361,0.929241202634,031-AZF,0.141643966136,145,429,574
4463,-0.645953270361,0.929241202634,031-AZG,0.141643966136,165,555,720
4464,-0.645953270361,0.929241202634,031-AZH,0.141643966136,159,498,657
4465,-0.645953270361,0.929241202634,031-AZI,0.141643966136,158,553,711
4466,-0.645953270361,0.929241202634,031-AZK,0.141643966136,152,754,906
4467,-0.645953270361,0.929241202634,031-AZM,0.141643966136,153,717,870
4468,-0.645953270361,0.929241202634,031-AZO,0.141643966136,59,126,185
4469,-0.645953270361,0.929241202634,031-AZQ,0.141643966136,150,441,591
4470,-0.645953270361,0.929241202634,031-AZS,0.141643966136,91,333,424
4471,-0.645953270361,0.929241202634,031-AZU,0.141643966136,178,559,737
4472,-0.645953270361,0.929241202634,031-AZW,0.141643966136,162,516,678
4473,-0.645953270361,0.929241202634,031-AZY,0.141643966136,65,271,336
4474,-0.645953270361,0.929241202634,031-BAA,0.141643966136,152,543,695
4475,-0.645953270361,0.929241202634,031-BAC,0.141643966136,105,512,617
4476,-0.645953270361,0.929241202634,031-BAE,0.141643966136,100,328,428
4477,-0.645953270361,0.929241202634,031-BAG,0.141643966136,72,330,402
4478,-0.645953270361,0.929241202634,031-BAI,0.141643966136,127,378,505
4479,-0.645953270361,0.929241202634,031-BAK,0.141643966136,73,262,335
4480,-0.645953270361,0.929241202634,031-BAM,0.141643966136,104,362,466
4481,-0.645953270361,0.929241202634,031-BAO,0.141643966136,94,279,373
4482,-0.645953270361,0.929241202634,031-BAQ,0.141643966136,55,243,298
4483,-0.645953270361,0.929241202634,031-BAS,0.141643966136,125,497,622
4484,-0.645953270361,0.929241202634,031-BAT,0.141643966136,70,131,201
4485,-0.645953270361,0.929241202634,031-BAU,0.141643966136,114,627,741
4486,-0.645953270361,0.929241202634,031-BAV,0.141643966136,90,656,746
4487,-0.645953270361,0.929241202634,031-BAX,0.141643966136,194,316,510
4488,-0.645953270361,0.929241202634,031-BAY,0.141643966136,70,443,513
4489,-0.645953270361,0.929241202634,031-BBA,0.141643966136,243,354,597
4490,-0.645953270361,0.929241202634,031-BBB,0.141643966136,188,185,373
4491,-0.645953270361,0.929241202634,031-BBD,0.141643966136,174,237,411
4492,-0.645953270361,0.929241202634,031-BBE,0.141643966136,390,92,482
4493,-0.645953270361,0.929241202634,031-BBG,0.141643966136,102,647,749
4494,-0.645953270361,0.929241202634,031-BBH,0.141643966136,186,433,619
4495,-0.645953270361,0.929241202634,031-BBJ,0.141643966136,123,599,722
4496,-0.645953270361,0.929241202634,031-BBK,0.141643966136,41,198,239
4497,-0.645953270361,0.929241202634,031-BBM,0.141643966136,90,690,780
4498,-0.645953270361,0.929241202634,031-BBN,0.141643966136,247,350,597
4499,-0.645953270361,0.929241202634,031-BBP,0.141643966136,169,542,711
4500,-0.645953270361,0.929241202634,031-BBQ,0.141643966136,170,222,392
4501,-0.645953270361,0.929241202634,031-BBS,0.141643966136,79,488,567
4502,-0.645953270361,0.929241202634,031-BBT,0.141643966136,79,202,281
4503,-0.645953270361,0.929241202634,031-BBV,0.141643966136,163,467,630
4504,-0.645953270361,0.929241202634,031-BBW,0.141643966136,59,238,297
4505,-0.645953270361,0.929241202634,031-BBY,0.141643966136,123,331,454
4506,-0.645953270361,0.929241202634,031-BBZ,0.141643966136,272,317,589
4507,-0.645953270361,0.929241202634,031-BCB,0.141643966136,119,726,845
4508,-0.645953270361,0.929241202634,031-BCC,0.141643966136,142,229,371
4509,-0.645953270361,0.929241202634,031-BCE,0.141643966136,131,326,457
4510,-0.645953270361,0.929241202634,031-BCF,0.141643966136,176,398,574
4511,-0.645953270361,0.929241202634,031-BCG,0.141643966136,97,411,508
4512,-0.645953270361,0.929241202634,031-BCI,0.141643966136,55,253,308
4513,-0.645953270361,0.929241202634,031-BCK,0.141643966136,79,159,238
4514,-0.645953270361,0.929241202634,031-BCM,0.141643966136,89,729,818
4515,-0.645953270361,0.929241202634,031-BCO,0.141643966136,170,412,582
4516,-0.645953270361,0.929241202634,031-BCQ,0.141643966136,117,429,546
4517,-0.645953270361,0.929241202634,031-BCS,0.141643966136,295,312,607
4518,-0.645953270361,0.929241202634,031-BCU,0.141643966136,186,326,512
4519,-0.645953270361,0.929241202634,031-BCW,0.141643966136,170,350,520
4520,-0.645953270361,0.929241202634,031-BCY,0.141643966136,117,122,239
4521,-0.645953270361,0.929241202634,031-BDA,0.141643966136,148,348,496
4522,-0.645953270361,0.929241202634,031-BDC,0.141643966136,285,280,565
4523,-0.645953270361,0.929241202634,031-BDE,0.141643966136,222,304,526
4524,-0.645953270361,0.929241202634,031-BDG,0.141643966136,61,35,96
4525,-0.645953270361,0.929241202634,031-BDH,0.141643966136,88,81,169
4526,-0.645953270361,0.929241202634,031-BDI,0.141643966136,130,141,271
4527,-0.645953270361,0.929241202634,031-BDJ,0.141643966136,200,19,219
4528,-0.645953270361,0.929241202634,031-BDK,0.141643966136,112,84,196
4529,-0.645953270361,0.929241202634,031-BDL,0.141643966136,117,153,270
4530,-0.645953270361,0.929241202634,031-BDM,0.141643966136,107,258,365
4531,-0.645953270361,0.929241202634,031-BDN,0.141643966136,0,1,1
4532,-0.645953270361,0.929241202634,031-BDO,0.141643966136,0,2,2
4533,-0.645953270361,0.929241202634,031-BDP,0.141643966136,0,3,3
4534,-0.645953270361,0.929241202634,031-BDQ,0.141643966136,1,1,2
4535,-0.645953270361,0.929241202634,031-BDR,0.141643966136,12,18,30
4536,-0.645953270361,0.929241202634,031-BDT,0.141643966136,163,425,588
4537,-0.645953270361,0.929241202634,031-BDW,0.141643966136,54,270,324
4538,-0.645953270361,0.929241202634,031-BDX,0.141643966136,107,640,747
4539,-0.645953270361,0.929241202634,031-BDZ,0.141643966136,129,361,490
4540,-0.645953270361,0.929241202634,031-BEB,0.141643966136,124,354,478
4541,-0.645953270361,0.929241202634,031-BED,0.141643966136,126,604,730
4542,-0.645953270361,0.929241202634,031-BEF,0.141643966136,113,425,538
4543,-0.645953270361,0.929241202634,031-BEH,0.141643966136,63,569,632
4544,-0.645953270361,0.929241202634,031-BEJ,0.141643966136,148,600,748
4545,-0.645953270361,0.929241202634,031-BEL,0.141643966136,77,498,575
4546,-0.645953270361,0.929241202634,031-BEN,0.141643966136,114,640,754
4547,-0.645953270361,0.929241202634,031-BEP,0.141643966136,78,306,384
4548,-0.645953270361,0.929241202634,031-BER,0.141643966136,143,573,716
4549,-0.645953270361,0.929241202634,031-BET,0.141643966136,60,417,477
4550,-0.645953270361,0.929241202634,031-BEU,0.141643966136,77,431,508
4551,-0.645953270361,0.929241202634,031-BEV,0.141643966136,116,447,563
4552,-0.645953270361,0.929241202634,031-BEW,0.141643966136,61,214,275
4553,-0.645953270361,0.929241202634,031-BEX,0.141643966136,130,650,780
4554,-0.645953270361,0.929241202634,031-BEY,0.141643966136,103,529,632
4555,-0.645953270361,0.929241202634,031-BEZ,0.141643966136,106,822,928
4556,-0.645953270361,0.929241202634,031-BFA,0.141643966136,148,390,538
4557,-0.645953270361,0.929241202634,031-BFB,0.141643966136,90,544,634
4558,-0.645953270361,0.929241202634,031-BFJ,0.141643966136,59,158,217
4559,-0.645953270361,0.929241202634,031-BFK,0.141643966136,58,83,141
4560,-0.645953270361,0.929241202634,031-BFN,0.141643966136,236,570,806
4561,-0.645953270361,0.929241202634,031-BFO,0.141643966136,104,524,628
4562,-0.645953270361,0.929241202634,031-BFP,0.141643966136,53,112,165
4563,-0.645953270361,0.929241202634,031-BFR,0.141643966136,181,430,611
4564,-0.645953270361,0.929241202634,031-BFS,0.141643966136,229,417,646
4565,-0.645953270361,0.929241202634,031-BFW,0.141643966136,491,174,665
4566,-0.645953270361,0.929241202634,031-BFX,0.141643966136,492,81,573
4567,-0.645953270361,0.929241202634,031-BGC,0.141643966136,99,210,309
4568,-0.645953270361,0.929241202634,031-BGD,0.141643966136,135,535,670
4569,-0.645953270361,0.929241202634,031-BGE,0.141643966136,153,381,534
4570,-0.645953270361,0.929241202634,031-BGI,0.141643966136,118,533,651
4571,-0.645953270361,0.929241202634,031-BGJ,0.141643966136,83,586,669
4572,-0.645953270361,0.929241202634,031-BGL,0.141643966136,155,546,701
4573,-0.645953270361,0.929241202634,031-BGM,0.141643966136,100,494,594
4574,-0.645953270361,0.929241202634,031-BGO,0.141643966136,146,376,522
4575,-0.645953270361,0.929241202634,031-BGP,0.141643966136,120,485,605
4576,-0.645953270361,0.929241202634,031-BGR,0.141643966136,118,599,717
4577,-0.645953270361,0.929241202634,031-BGS,0.141643966136,86,462,548
4578,-0.645953270361,0.929241202634,031-BGU,0.141643966136,97,755,852
4579,-0.645953270361,0.929241202634,031-BGV,0.141643966136,97,460,557
4580,-0.645953270361,0.929241202634,031-BGX,0.141643966136,83,551,634
4581,-0.645953270361,0.929241202634,031-BGY,0.141643966136,114,436,550
4582,-0.645953270361,0.929241202634,031-BHA,0.141643966136,46,475,521
4583,-0.645953270361,0.929241202634,031-BHB,0.141643966136,99,694,793
4584,-0.645953270361,0.929241202634,031-BHD,0.141643966136,125,305,430
4585,-0.645953270361,0.929241202634,031-BHE,0.141643966136,129,549,678
4586,-0.645953270361,0.929241202634,031-BHG,0.141643966136,100,460,560
4587,-0.645953270361,0.929241202634,031-BHH,0.141643966136,128,178,306
4588,-0.645953270361,0.929241202634,031-BHJ,0.141643966136,74,469,543
4589,-0.645953270361,0.929241202634,031-BHK,0.141643966136,120,562,682
4590,-0.645953270361,0.929241202634,031-BHM,0.141643966136,109,712,821
4591,-0.645953270361,0.929241202634,031-BHN,0.141643966136,86,545,631
4592,-0.645953270361,0.929241202634,031-BHP,0.141643966136,136,502,638
4593,-0.645953270361,0.929241202634,031-BHQ,0.141643966136,72,484,556
4594,-0.645953270361,0.929241202634,031-BHS,0.141643966136,52,455,507
4595,-0.645953270361,0.929241202634,031-BHT,0.141643966136,44,436,480
4596,-0.645953270361,0.929241202634,031-BHV,0.141643966136,108,539,647
4597,-0.645953270361,0.929241202634,031-BHW,0.141643966136,51,373,424
4598,-0.645953270361,0.929241202634,031-BHY,0.141643966136,170,499,669
4599,-0.645953270361,0.929241202634,031-BHZ,0.141643966136,59,349,408
4600,-0.645953270361,0.929241202634,031-BIB,0.141643966136,97,561,658
4601,-0.645953270361,0.929241202634,031-BIC,0.141643966136,73,343,416
4602,-0.645953270361,0.929241202634,031-BIE,0.141643966136,90,704,794
4603,-0.645953270361,0.929241202634,031-BIF,0.141643966136,105,710,815
4604,-0.645953270361,0.929241202634,031-BIH,0.141643966136,74,388,462
4605,-0.645953270361,0.929241202634,031-BIJ,0.141643966136,124,526,650
4606,-0.645953270361,0.929241202634,031-BIL,0.141643966136,68,225,293
4607,-0.645953270361,0.929241202634,031-BIN,0.141643966136,38,365,403
4608,-0.645953270361,0.929241202634,031-BIP,0.141643966136,107,505,612
4609,-0.645953270361,0.929241202634,031-BIR,0.141643966136,92,771,863
4610,-0.645953270361,0.929241202634,031-BIT,0.141643966136,151,670,821
4611,-0.645953270361,0.929241202634,031-BIV,0.141643966136,78,498,576
4612,-0.645953270361,0.929241202634,031-BIX,0.141643966136,94,467,561
4613,-0.645953270361,0.929241202634,031-BIZ,0.141643966136,62,392,454
4614,-0.645953270361,0.929241202634,031-BJA,0.141643966136,88,610,698
4615,-0.645953270361,0.929241202634,031-BJB,0.141643966136,75,337,412
4616,-0.645953270361,0.929241202634,031-BJE,0.141643966136,90,324,414
4617,-0.645953270361,0.929241202634,031-BJF,0.141643966136,104,448,552
4618,-0.645953270361,0.929241202634,031-BJG,0.141643966136,103,546,649
4619,-0.645953270361,0.929241202634,031-BJH,0.141643966136,112,450,562
4620,-0.645953270361,0.929241202634,031-BJI,0.141643966136,110,738,848
4621,-0.645953270361,0.929241202634,031-BJL,0.141643966136,110,250,360
4622,-0.645953270361,0.929241202634,031-BJM,0.141643966136,89,126,215
4623,-0.645953270361,0.929241202634,031-BJN,0.141643966136,152,122,274
4624,-0.645953270361,0.929241202634,031-BJS,0.141643966136,191,395,586
4625,-0.645953270361,0.929241202634,031-BJT,0.141643966136,214,645,859
4626,-0.645953270361,0.929241202634,031-BJX,0.141643966136,48,197,245
4627,-0.645953270361,0.929241202634,031-BJZ,0.141643966136,61,426,487
4628,-0.645953270361,0.929241202634,031-BKA,0.141643966136,72,148,220
4629,-0.645953270361,0.929241202634,031-BKB,0.141643966136,71,189,260
4630,-0.645953270361,0.929241202634,031-BKC,0.141643966136,99,541,640
4631,-0.645953270361,0.929241202634,031-BKD,0.141643966136,113,700,813
4632,-0.645953270361,0.929241202634,031-BKE,0.141643966136,60,792,852
4633,-0.645953270361,0.929241202634,031-BKF,0.141643966136,86,519,605
4634,-0.645953270361,0.929241202634,031-BKG,0.141643966136,121,721,842
4635,-0.645953270361,0.929241202634,031-BKH,0.141643966136,66,490,556
4636,-0.645953270361,0.929241202634,031-BKI,0.141643966136,62,247,309
4637,-0.645953270361,0.929241202634,031-BKJ,0.141643966136,71,420,491
4638,-0.645953270361,0.929241202634,031-BKK,0.141643966136,78,309,387
4639,-0.645953270361,0.929241202634,031-BKL,0.141643966136,87,449,536
4640,-0.645953270361,0.929241202634,031-BKM,0.141643966136,333,47,380
4641,-0.645953270361,0.929241202634,031-BKN,0.141643966136,274,293,567
4642,-0.645953270361,0.929241202634,031-BKO,0.141643966136,186,209,395
4643,-0.645953270361,0.929241202634,031-BKP,0.141643966136,115,336,451
4644,-0.645953270361,0.929241202634,031-BKQ,0.141643966136,302,333,635
4645,-0.645953270361,0.929241202634,031-BKS,0.141643966136,227,227,454
4646,-0.645953270361,0.929241202634,031-BKU,0.141643966136,148,148,296
4647,-0.645953270361,0.929241202634,031-BKW,0.141643966136,139,296,435
4648,-0.645953270361,0.929241202634,031-BKY,0.141643966136,339,394,733
4649,-0.645953270361,0.929241202634,031-BLA,0.141643966136,191,519,710
4650,-0.645953270361,0.929241202634,031-BLC,0.141643966136,82,126,208
4651,-0.645953270361,0.929241202634,031-BLE,0.141643966136,322,222,544
4652,-0.645953270361,0.929241202634,031-BLG,0.141643966136,248,126,374
4653,-0.645953270361,0.929241202634,031-BLI,0.141643966136,95,49,144
4654,-0.645953270361,0.929241202634,031-BLK,0.141643966136,317,331,648
4655,-0.645953270361,0.929241202634,031-BLM,0.141643966136,226,405,631
4656,-0.645953270361,0.929241202634,031-BLO,0.141643966136,293,66,359
4657,-0.645953270361,0.929241202634,031-BLQ,0.141643966136,323,163,486
4658,-0.645953270361,0.929241202634,031-BLS,0.141643966136,360,290,650
4659,-0.645953270361,0.929241202634,031-BLU,0.141643966136,335,324,659
4660,-0.645953270361,0.929241202634,031-BLW,0.141643966136,311,466,777
4661,-0.645953270361,0.929241202634,031-BLY,0.141643966136,376,340,716
4662,-0.645953270361,0.929241202634,031-BMA,0.141643966136,318,509,827
4663,-0.645953270361,0.929241202634,031-BMC,0.141643966136,190,545,735
4664,-0.645953270361,0.929241202634,031-BME,0.141643966136,283,436,719
4665,-0.645953270361,0.929241202634,031-BMG,0.141643966136,259,141,400
4666,-0.645953270361,0.929241202634,031-BMI,0.141643966136,334,202,536
4667,-0.645953270361,0.929241202634,031-BMJ,0.141643966136,195,193,388
4668,-0.645953270361,0.929241202634,031-BMK,0.141643966136,58,13,71
4669,-0.645953270361,0.929241202634,031-BMM,0.141643966136,176,461,637
4670,-0.645953270361,0.929241202634,031-BMO,0.141643966136,79,235,314
4671,-0.645953270361,0.929241202634,031-BMP,0.141643966136,102,402,504
4672,-0.645953270361,0.929241202634,031-BMQ,0.141643966136,87,296,383
4673,-0.645953270361,0.929241202634,031-BMR,0.141643966136,126,402,528
4674,-0.645953270361,0.929241202634,031-BMS,0.141643966136,169,503,672
4675,-0.645953270361,0.929241202634,031-BMT,0.141643966136,181,307,488
4676,-0.645953270361,0.929241202634,031-BMU,0.141643966136,152,582,734
4677,-0.645953270361,0.929241202634,031-BMV,0.141643966136,132,302,434
4678,-0.645953270361,0.929241202634,031-BMW,0.141643966136,74,281,355
4679,-0.645953270361,0.929241202634,031-BMX,0.141643966136,126,490,616
4680,-0.645953270361,0.929241202634,031-BMY,0.141643966136,66,335,401
4681,-0.645953270361,0.929241202634,031-BMZ,0.141643966136,209,567,776
4682,-0.645953270361,0.929241202634,031-BNA,0.141643966136,156,204,360
4683,-0.645953270361,0.929241202634,031-BNB,0.141643966136,207,408,615
4684,-0.645953270361,0.929241202634,031-BNM,0.141643966136,60,86,146
4685,-0.645953270361,0.929241202634,031-BNN,0.141643966136,160,446,606
4686,-0.645953270361,0.929241202634,031-BNO,0.141643966136,122,537,659
4687,-0.645953270361,0.929241202634,031-BNP,0.141643966136,178,417,595
4688,-0.645953270361,0.929241202634,031-BNQ,0.141643966136,142,522,664
4689,-0.645953270361,0.929241202634,031-BNR,0.141643966136,98,212,310
4690,-0.645953270361,0.929241202634,031-BNS,0.141643966136,88,316,404
4691,-0.645953270361,0.929241202634,031-BNT,0.141643966136,101,253,354
4692,-0.645953270361,0.929241202634,031-BNU,0.141643966136,121,254,375
4693,-0.645953270361,0.929241202634,031-BNV,0.141643966136,155,475,630
4694,-0.645953270361,0.929241202634,031-BNW,0.141643966136,28,184,212
4695,-0.645953270361,0.929241202634,031-BNX,0.141643966136,151,501,652
4696,-0.645953270361,0.929241202634,031-BNY,0.141643966136,49,223,272
4697,-0.645953270361,0.929241202634,031-BOE,0.141643966136,101,606,707
4698,-0.645953270361,0.929241202634,031-BOF,0.141643966136,62,373,435
4699,-0.645953270361,0.929241202634,031-BOH,0.141643966136,49,194,243
4700,-0.645953270361,0.929241202634,031-BOI,0.141643966136,88,372,460
4701,-0.645953270361,0.929241202634,031-BOJ,0.141643966136,30,169,199
4702,-0.645953270361,0.929241202634,031-BOK,0.141643966136,90,403,493
4703,-0.645953270361,0.929241202634,031-BOL,0.141643966136,476,62,538
4704,-0.645953270361,0.929241202634,031-BOM,0.141643966136,226,86,312
4705,-0.645953270361,0.929241202634,031-BON,0.141643966136,303,22,325
4706,-0.645953270361,0.929241202634,031-BOP,0.141643966136,288,9,297
4707,-0.645953270361,0.929241202634,031-BOQ,0.141643966136,366,12,378
4708,-0.645953270361,0.929241202634,031-BOR,0.141643966136,404,11,415
4709,-0.645953270361,0.929241202634,031-BPV,0.141643966136,207,69,276
4710,-0.645953270361,0.929241202634,031-BPY,0.141643966136,146,8,154
4711,-0.645953270361,0.929241202634,031-ZZZ,0.141643966136,112938,166087,279025
4712,-0.645953270361,0.929241202634,032-AAA,0.141643966136,98,140,238
4713,-0.645953270361,0.929241202634,032-AAB,0.141643966136,102,218,320
4714,-0.645953270361,0.929241202634,032-AAC,0.141643966136,66,91,157
4715,-0.645953270361,0.929241202634,032-AAE,0.141643966136,63,100,163
4716,-0.645953270361,0.929241202634,032-AAG,0.141643966136,86,150,236
4717,-0.645953270361,0.929241202634,032-AAH,0.141643966136,117,372,489
4718,-0.645953270361,0.929241202634,032-AAI,0.141643966136,82,200,282
4719,-0.645953270361,0.929241202634,032-AAJ,0.141643966136,88,301,389
4720,-0.645953270361,0.929241202634,032-AAK,0.141643966136,176,537,713
4721,-0.645953270361,0.929241202634,032-AAL,0.141643966136,87,391,478
4722,-0.645953270361,0.929241202634,032-AAM,0.141643966136,72,322,394
4723,-0.645953270361,0.929241202634,032-AAO,0.141643966136,53,85,138
4724,-0.645953270361,0.929241202634,032-AAP,0.141643966136,71,206,277
4725,-0.645953270361,0.929241202634,032-AAQ,0.141643966136,73,150,223
4726,-0.645953270361,0.929241202634,032-AAR,0.141643966136,92,205,297
4727,-0.645953270361,0.929241202634,032-AAS,0.141643966136,86,171,257
4728,-0.645953270361,0.929241202634,032-AAU,0.141643966136,53,86,139
4729,-0.645953270361,0.929241202634,032-AAV,0.141643966136,110,303,413
4730,-0.645953270361,0.929241202634,032-AAW,0.141643966136,96,283,379
4731,-0.645953270361,0.929241202634,032-AAX,0.141643966136,136,338,474
4732,-0.645953270361,0.929241202634,032-AAZ,0.141643966136,63,132,195
4733,-0.645953270361,0.929241202634,032-ABA,0.141643966136,57,128,185
4734,-0.645953270361,0.929241202634,032-ABB,0.141643966136,109,261,370
4735,-0.645953270361,0.929241202634,032-ABC,0.141643966136,89,138,227
4736,-0.645953270361,0.929241202634,032-ABD,0.141643966136,87,215,302
4737,-0.645953270361,0.929241202634,032-ABE,0.141643966136,58,193,251
4738,-0.645953270361,0.929241202634,032-ABF,0.141643966136,90,223,313
4739,-0.645953270361,0.929241202634,032-ABG,0.141643966136,88,175,263
4740,-0.645953270361,0.929241202634,032-ABH,0.141643966136,69,231,300
4741,-0.645953270361,0.929241202634,032-ABI,0.141643966136,69,214,283
4742,-0.645953270361,0.929241202634,032-ABJ,0.141643966136,77,274,351
4743,-0.645953270361,0.929241202634,032-ABK,0.141643966136,68,325,393
4744,-0.645953270361,0.929241202634,032-ABL,0.141643966136,60,188,248
4745,-0.645953270361,0.929241202634,032-ABM,0.141643966136,120,256,376
4746,-0.645953270361,0.929241202634,032-ABN,0.141643966136,205,323,528
4747,-0.645953270361,0.929241202634,032-ABO,0.141643966136,192,247,439
4748,-0.645953270361,0.929241202634,032-ABP,0.141643966136,70,342,412
4749,-0.645953270361,0.929241202634,032-ABQ,0.141643966136,79,367,446
4750,-0.645953270361,0.929241202634,032-ABR,0.141643966136,85,357,442
4751,-0.645953270361,0.929241202634,032-ABS,0.141643966136,108,384,492
4752,-0.645953270361,0.929241202634,032-ABT,0.141643966136,60,361,421
4753,-0.645953270361,0.929241202634,032-ABU,0.141643966136,68,308,376
4754,-0.645953270361,0.929241202634,032-ABV,0.141643966136,106,355,461
4755,-0.645953270361,0.929241202634,032-ABW,0.141643966136,63,442,505
4756,-0.645953270361,0.929241202634,032-ABX,0.141643966136,77,377,454
4757,-0.645953270361,0.929241202634,032-ABY,0.141643966136,88,300,388
4758,-0.645953270361,0.929241202634,032-ABZ,0.141643966136,103,279,382
4759,-0.645953270361,0.929241202634,032-ACA,0.141643966136,83,497,580
4760,-0.645953270361,0.929241202634,032-ACB,0.141643966136,105,286,391
4761,-0.645953270361,0.929241202634,032-ACC,0.141643966136,74,386,460
4762,-0.645953270361,0.929241202634,032-ACD,0.141643966136,117,311,428
4763,-0.645953270361,0.929241202634,032-ACE,0.141643966136,90,471,561
4764,-0.645953270361,0.929241202634,032-ACH,0.141643966136,116,496,612
4765,-0.645953270361,0.929241202634,032-ACI,0.141643966136,82,417,499
4766,-0.645953270361,0.929241202634,032-ACJ,0.141643966136,39,234,273
4767,-0.645953270361,0.929241202634,032-ACK,0.141643966136,99,304,403
4768,-0.645953270361,0.929241202634,032-ACL,0.141643966136,37,217,254
4769,-0.645953270361,0.929241202634,032-ACM,0.141643966136,46,225,271
4770,-0.645953270361,0.929241202634,032-ACN,0.141643966136,51,277,328
4771,-0.645953270361,0.929241202634,032-ACO,0.141643966136,62,326,388
4772,-0.645953270361,0.929241202634,032-ACR,0.141643966136,154,476,630
4773,-0.645953270361,0.929241202634,032-ACS,0.141643966136,115,480,595
4774,-0.645953270361,0.929241202634,032-ACT,0.141643966136,60,386,446
4775,-0.645953270361,0.929241202634,033-AAA,0.141643966136,34,50,84
4776,-0.645953270361,0.929241202634,033-AAB,0.141643966136,58,112,170
4777,-0.645953270361,0.929241202634,033-AAC,0.141643966136,50,87,137
4778,-0.645953270361,0.929241202634,033-AAD,0.141643966136,49,127,176
4779,-0.645953270361,0.929241202634,033-AAE,0.141643966136,75,208,283
4780,-0.645953270361,0.929241202634,033-AAF,0.141643966136,71,115,186
4781,-0.645953270361,0.929241202634,033-AAG,0.141643966136,37,60,97
4782,-0.645953270361,0.929241202634,033-AAH,0.141643966136,62,89,151
4783,-0.645953270361,0.929241202634,033-AAI,0.141643966136,55,118,173
4784,-0.645953270361,0.929241202634,033-AAJ,0.141643966136,41,69,110
4785,-0.645953270361,0.929241202634,033-AAK,0.141643966136,72,81,153
4786,-0.645953270361,0.929241202634,033-AAM,0.141643966136,132,320,452
4787,-0.645953270361,0.929241202634,033-AAN,0.141643966136,78,240,318
4788,-0.645953270361,0.929241202634,033-AAO,0.141643966136,73,130,203
4789,-0.645953270361,0.929241202634,033-AAP,0.141643966136,98,212,310
4790,-0.645953270361,0.929241202634,033-AAQ,0.141643966136,39,188,227
4791,-0.645953270361,0.929241202634,033-AAS,0.141643966136,101,213,314
4792,-0.645953270361,0.929241202634,033-AAT,0.141643966136,41,147,188
4793,-0.645953270361,0.929241202634,033-AAU,0.141643966136,54,162,216
4794,-0.645953270361,0.929241202634,033-AAV,0.141643966136,120,235,355
4795,-0.645953270361,0.929241202634,033-AAX,0.141643966136,144,490,634
4796,-0.645953270361,0.929241202634,033-AAZ,0.141643966136,139,268,407
4797,-0.645953270361,0.929241202634,033-ABB,0.141643966136,171,282,453
4798,-0.645953270361,0.929241202634,033-ABD,0.141643966136,58,155,213
4799,-0.645953270361,0.929241202634,033-ABE,0.141643966136,87,120,207
4800,-0.645953270361,0.929241202634,033-ABF,0.141643966136,103,245,348
4801,-0.645953270361,0.929241202634,033-ABG,0.141643966136,60,45,105
4802,-0.645953270361,0.929241202634,033-ABH,0.141643966136,65,221,286
4803,-0.645953270361,0.929241202634,033-ABI,0.141643966136,137,502,639
4804,-0.645953270361,0.929241202634,033-ABK,0.141643966136,57,199,256
4805,-0.645953270361,0.929241202634,033-ABL,0.141643966136,49,159,208
4806,-0.645953270361,0.929241202634,033-ABM,0.141643966136,57,217,274
4807,-0.645953270361,0.929241202634,034-AAA,0.141643966136,35,74,109
4808,-0.645953270361,0.929241202634,034-AAB,0.141643966136,123,75,198
4809,-0.645953270361,0.929241202634,034-AAE,0.141643966136,251,304,555
4810,-0.645953270361,0.929241202634,034-AAG,0.141643966136,306,332,638
4811,-0.645953270361,0.929241202634,034-AAL,0.141643966136,98,156,254
4812,-0.645953270361,0.929241202634,034-AAM,0.141643966136,112,151,263
4813,-0.645953270361,0.929241202634,034-AAO,0.141643966136,125,145,270
4814,-0.645953270361,0.929241202634,034-AAS,0.141643966136,327,334,661
4815,-0.645953270361,0.929241202634,034-AAU,0.141643966136,146,232,378
4816,-0.645953270361,0.929241202634,034-AAV,0.141643966136,69,85,154
4817,-0.645953270361,0.929241202634,034-AAX,0.141643966136,186,275,461
4818,-0.645953270361,0.929241202634,034-ABA,0.141643966136,51,82,133
4819,-0.645953270361,0.929241202634,034-ABB,0.141643966136,194,226,420
4820,-0.645953270361,0.929241202634,034-ABF,0.141643966136,211,194,405
4821,-0.645953270361,0.929241202634,034-ABH,0.141643966136,93,104,197
4822,-0.645953270361,0.929241202634,034-ABI,0.141643966136,99,111,210
4823,-0.645953270361,0.929241202634,035-AAA,0.141643966136,90,164,254
4824,-0.645953270361,0.929241202634,035-AAB,0.141643966136,89,157,246
4825,-0.645953270361,0.929241202634,035-AAC,0.141643966136,97,198,295
4826,-0.645953270361,0.929241202634,035-AAD,0.141643966136,88,142,230
4827,-0.645953270361,0.929241202634,035-AAE,0.141643966136,89,172,261
4828,-0.645953270361,0.929241202634,035-AAF,0.141643966136,75,202,277
4829,-0.645953270361,0.929241202634,035-AAG,0.141643966136,87,130,217
4830,-0.645953270361,0.929241202634,035-AAH,0.141643966136,81,148,229
4831,-0.645953270361,0.929241202634,035-AAI,0.141643966136,121,333,454
4832,-0.645953270361,0.929241202634,035-AAJ,0.141643966136,39,214,253
4833,-0.645953270361,0.929241202634,035-AAK,0.141643966136,83,289,372
4834,-0.645953270361,0.929241202634,035-AAL,0.141643966136,67,192,259
4835,-0.645953270361,0.929241202634,035-AAM,0.141643966136,107,174,281
4836,-0.645953270361,0.929241202634,035-AAN,0.141643966136,47,70,117
4837,-0.645953270361,0.929241202634,035-AAO,0.141643966136,87,207,294
4838,-0.645953270361,0.929241202634,035-AAP,0.141643966136,65,299,364
4839,-0.645953270361,0.929241202634,035-AAQ,0.141643966136,99,330,429
4840,-0.645953270361,0.929241202634,035-AAR,0.141643966136,62,131,193
4841,-0.645953270361,0.929241202634,035-AAS,0.141643966136,106,168,274
4842,-0.645953270361,0.929241202634,035-AAT,0.141643966136,40,176,216
4843,-0.645953270361,0.929241202634,035-AAU,0.141643966136,109,210,319
4844,-0.645953270361,0.929241202634,035-AAV,0.141643966136,89,222,311
4845,-0.645953270361,0.929241202634,035-AAW,0.141643966136,71,261,332
4846,-0.645953270361,0.929241202634,035-AAX,0.141643966136,68,103,171
4847,-0.645953270361,0.929241202634,035-AAY,0.141643966136,56,157,213
4848,-0.645953270361,0.929241202634,035-AAZ,0.141643966136,60,193,253
4849,-0.645953270361,0.929241202634,035-ABA,0.141643966136,64,161,225
4850,-0.645953270361,0.929241202634,035-ABB,0.141643966136,69,290,359
4851,-0.645953270361,0.929241202634,035-ABC,0.141643966136,92,277,369
4852,-0.645953270361,0.929241202634,035-ABD,0.141643966136,54,232,286
4853,-0.645953270361,0.929241202634,035-ABE,0.141643966136,64,383,447
4854,-0.645953270361,0.929241202634,035-ABF,0.141643966136,102,181,283
4855,-0.645953270361,0.929241202634,035-ABG,0.141643966136,106,221,327
4856,-0.645953270361,0.929241202634,036-AAB,0.141643966136,155,322,477
4857,-0.645953270361,0.929241202634,036-AAF,0.141643966136,152,239,391
4858,-0.645953270361,0.929241202634,036-AAI,0.141643966136,109,290,399
4859,-0.645953270361,0.929241202634,036-AAJ,0.141643966136,136,291,427
4860,-0.645953270361,0.929241202634,036-AAL,0.141643966136,98,210,308
4861,-0.645953270361,0.929241202634,036-AAN,0.141643966136,78,188,266
4862,-0.645953270361,0.929241202634,036-AAO,0.141643966136,65,208,273
4863,-0.645953270361,0.929241202634,036-AAQ,0.141643966136,85,282,367
4864,-0.645953270361,0.929241202634,036-AAS,0.141643966136,85,368,453
4865,-0.645953270361,0.929241202634,036-AAT,0.141643966136,75,350,425
4866,-0.645953270361,0.929241202634,036-AAU,0.141643966136,62,276,338
4867,-0.645953270361,0.929241202634,036-AAV,0.141643966136,81,299,380
4868,-0.645953270361,0.929241202634,036-AAX,0.141643966136,69,358,427
4869,-0.645953270361,0.929241202634,036-AAY,0.141643966136,36,167,203
4870,-0.645953270361,0.929241202634,036-AAZ,0.141643966136,61,186,247
4871,-0.645953270361,0.929241202634,036-ABB,0.141643966136,53,189,242
4872,-0.645953270361,0.929241202634,036-ABC,0.141643966136,103,236,339
4873,-0.645953270361,0.929241202634,036-ABD,0.141643966136,57,279,336
4874,-0.645953270361,0.929241202634,036-ABE,0.141643966136,71,258,329
4875,-0.645953270361,0.929241202634,036-ABF,0.141643966136,104,487,591
4876,-0.645953270361,0.929241202634,036-ABG,0.141643966136,157,446,603
4877,-0.645953270361,0.929241202634,036-ABI,0.141643966136,94,244,338
4878,-0.645953270361,0.929241202634,036-ABJ,0.141643966136,116,498,614
4879,-0.645953270361,0.929241202634,036-ABL,0.141643966136,64,205,269
4880,-0.645953270361,0.929241202634,036-ABM,0.141643966136,127,188,315
4881,-0.645953270361,0.929241202634,036-ABN,0.141643966136,137,244,381
4882,-0.645953270361,0.929241202634,036-ABO,0.141643966136,95,357,452
4883,-0.645953270361,0.929241202634,036-ABP,0.141643966136,55,206,261
4884,-0.645953270361,0.929241202634,036-ABQ,0.141643966136,122,371,493
4885,-0.645953270361,0.929241202634,036-ABR,0.141643966136,71,291,362
4886,-0.645953270361,0.929241202634,036-ABT,0.141643966136,107,307,414
4887,-0.645953270361,0.929241202634,037-AAB,0.141643966136,227,319,546
4888,-0.645953270361,0.929241202634,037-AAE,0.141643966136,183,243,426
4889,-0.645953270361,0.929241202634,037-AAG,0.141643966136,211,342,553
4890,-0.645953270361,0.929241202634,037-AAJ,0.141643966136,133,211,344
4891,-0.645953270361,0.929241202634,037-AAL,0.141643966136,128,136,264
4892,-0.645953270361,0.929241202634,037-AAM,0.141643966136,89,150,239
4893,-0.645953270361,0.929241202634,037-AAN,0.141643966136,113,211,324
4894,-0.645953270361,0.929241202634,037-AAO,0.141643966136,69,133,202
4895,-0.645953270361,0.929241202634,037-AAP,0.141643966136,121,227,348
4896,-0.645953270361,0.929241202634,037-AAQ,0.141643966136,79,112,191
4897,-0.645953270361,0.929241202634,037-AAR,0.141643966136,128,354,482
4898,-0.645953270361,0.929241202634,037-AAT,0.141643966136,126,267,393
4899,-0.645953270361,0.929241202634,037-AAU,0.141643966136,118,165,283
4900,-0.645953270361,0.929241202634,037-AAV,0.141643966136,183,290,473
4901,-0.645953270361,0.929241202634,037-AAW,0.141643966136,103,237,340
4902,-0.645953270361,0.929241202634,037-AAX,0.141643966136,98,164,262
4903,-0.645953270361,0.929241202634,037-AAY,0.141643966136,53,78,131
4904,-0.645953270361,0.929241202634,037-AAZ,0.141643966136,115,201,316
4905,-0.645953270361,0.929241202634,037-ABA,0.141643966136,144,168,312
4906,-0.645953270361,0.929241202634,037-ABB,0.141643966136,173,244,417
4907,-0.645953270361,0.929241202634,037-ABD,0.141643966136,142,72,214
4908,-0.645953270361,0.929241202634,037-ABE,0.141643966136,102,36,138
4909,-0.645953270361,0.929241202634,037-ABF,0.141643966136,138,234,372
4910,-0.645953270361,0.929241202634,037-ABG,0.141643966136,82,173,255
4911,-0.645953270361,0.929241202634,037-ABH,0.141643966136,106,168,274
4912,-0.645953270361,0.929241202634,037-ABJ,0.141643966136,60,114,174
4913,-0.645953270361,0.929241202634,038-AAA,0.141643966136,32,366,398
4914,-0.645953270361,0.929241202634,038-AAB,0.141643966136,34,307,341
4915,-0.645953270361,0.929241202634,038-AAC,0.141643966136,17,238,255
4916,-0.645953270361,0.929241202634,038-AAD,0.141643966136,120,614,734
4917,-0.645953270361,0.929241202634,038-AAF,0.141643966136,163,409,572
4918,-0.645953270361,0.929241202634,038-AAH,0.141643966136,67,189,256
4919,-0.645953270361,0.929241202634,038-AAJ,0.141643966136,155,404,559
4920,-0.645953270361,0.929241202634,038-AAL,0.141643966136,100,309,409
4921,-0.645953270361,0.929241202634,038-AAM,0.141643966136,13,90,103
4922,-0.645953270361,0.929241202634,038-AAN,0.141643966136,111,379,490
4923,-0.645953270361,0.929241202634,038-AAO,0.141643966136,112,445,557
4924,-0.645953270361,0.929241202634,038-AAP,0.141643966136,32,405,437
4925,-0.645953270361,0.929241202634,038-AAR,0.141643966136,124,496,620
4926,-0.645953270361,0.929241202634,038-AAT,0.141643966136,77,204,281
4927,-0.645953270361,0.929241202634,038-AAU,0.141643966136,141,435,576
4928,-0.645953270361,0.929241202634,038-AAW,0.141643966136,33,328,361
4929,-0.645953270361,0.929241202634,038-AAX,0.141643966136,55,506,561
4930,-0.645953270361,0.929241202634,038-AAY,0.141643966136,70,199,269
4931,-0.645953270361,0.929241202634,038-ABA,0.141643966136,79,170,249
4932,-0.645953270361,0.929241202634,039-AAA,0.141643966136,166,173,339
4933,-0.645953270361,0.929241202634,039-AAD,0.141643966136,170,227,397
4934,-0.645953270361,0.929241202634,039-AAG,0.141643966136,178,298,476
4935,-0.645953270361,0.929241202634,039-AAH,0.141643966136,223,324,547
4936,-0.645953270361,0.929241202634,039-AAI,0.141643966136,119,165,284
4937,-0.645953270361,0.929241202634,039-AAL,0.141643966136,122,335,457
4938,-0.645953270361,0.929241202634,039-AAM,0.141643966136,137,225,362
4939,-0.645953270361,0.929241202634,039-AAN,0.141643966136,135,268,403
4940,-0.645953270361,0.929241202634,039-AAQ,0.141643966136,90,114,204
4941,-0.645953270361,0.929241202634,039-AAR,0.141643966136,103,201,304
4942,-0.645953270361,0.929241202634,039-AAS,0.141643966136,105,219,324
4943,-0.645953270361,0.929241202634,039-AAV,0.141643966136,105,127,232
4944,-0.645953270361,0.929241202634,039-AAW,0.141643966136,109,178,287
4945,-0.645953270361,0.929241202634,039-AAX,0.141643966136,113,244,357
4946,-0.645953270361,0.929241202634,039-ABA,0.141643966136,73,99,172
4947,-0.645953270361,0.929241202634,039-ABC,0.141643966136,64,90,154
4948,-0.645953270361,0.929241202634,039-ABE,0.141643966136,42,94,136
4949,-0.645953270361,0.929241202634,039-ABF,0.141643966136,98,214,312
4950,-0.645953270361,0.929241202634,039-ABG,0.141643966136,55,79,134
4951,-0.645953270361,0.929241202634,039-ABH,0.141643966136,101,218,319
4952,-0.645953270361,0.929241202634,039-ABI,0.141643966136,66,153,219
4953,-0.645953270361,0.929241202634,039-ABJ,0.141643966136,100,412,512
4954,-0.645953270361,0.929241202634,039-ABK,0.141643966136,148,350,498
4955,-0.645953270361,0.929241202634,039-ABL,0.141643966136,37,173,210
4956,-0.645953270361,0.929241202634,039-ABM,0.141643966136,40,60,100
4957,-0.645953270361,0.929241202634,039-ABN,0.141643966136,69,212,281
4958,-0.645953270361,0.929241202634,039-ABO,0.141643966136,149,394,543
4959,-0.645953270361,0.929241202634,039-ABP,0.141643966136,51,163,214
4960,-0.645953270361,0.929241202634,039-ABQ,0.141643966136,74,251,325
4961,-0.645953270361,0.929241202634,039-ABS,0.141643966136,69,219,288
4962,-0.645953270361,0.929241202634,039-ABT,0.141643966136,110,269,379
4963,-0.645953270361,0.929241202634,039-ABU,0.141643966136,93,179,272
4964,-0.645953270361,0.929241202634,039-ABV,0.141643966136,52,166,218
4965,-0.645953270361,0.929241202634,039-ABW,0.141643966136,55,108,163
4966,-0.645953270361,0.929241202634,039-ABX,0.141643966136,88,221,309
4967,-0.645953270361,0.929241202634,039-ABY,0.141643966136,104,155,259
4968,-0.645953270361,0.929241202634,039-ABZ,0.141643966136,104,210,314
4969,-0.645953270361,0.929241202634,039-ACB,0.141643966136,158,270,428
4970,-0.645953270361,0.929241202634,039-ACC,0.141643966136,122,226,348
4971,-0.645953270361,0.929241202634,039-ACD,0.141643966136,66,187,253
4972,-0.645953270361,0.929241202634,039-ACE,0.141643966136,82,230,312
4973,-0.645953270361,0.929241202634,039-ACF,0.141643966136,131,229,360
4974,-0.645953270361,0.929241202634,039-ACG,0.141643966136,74,234,308
4975,-0.645953270361,0.929241202634,039-ACH,0.141643966136,107,214,321
4976,-0.645953270361,0.929241202634,039-ACI,0.141643966136,134,186,320
4977,-0.645953270361,0.929241202634,039-ACK,0.141643966136,56,184,240
4978,-0.645953270361,0.929241202634,039-ACL,0.141643966136,55,126,181
4979,-0.645953270361,0.929241202634,039-ACM,0.141643966136,88,190,278
4980,-0.645953270361,0.929241202634,039-ACN,0.141643966136,78,136,214
4981,-0.645953270361,0.929241202634,039-ACO,0.141643966136,72,137,209
4982,-0.645953270361,0.929241202634,039-ACP,0.141643966136,94,154,248
4983,-0.645953270361,0.929241202634,039-ACQ,0.141643966136,110,196,306
4984,-0.645953270361,0.929241202634,040-AAA,0.141643966136,141,426,567
4985,-0.645953270361,0.929241202634,040-AAC,0.141643966136,171,186,357
4986,-0.645953270361,0.929241202634,040-AAE,0.141643966136,112,233,345
4987,-0.645953270361,0.929241202634,040-AAG,0.141643966136,144,388,532
4988,-0.645953270361,0.929241202634,040-AAJ,0.141643966136,121,223,344
4989,-0.645953270361,0.929241202634,040-AAL,0.141643966136,85,132,217
4990,-0.645953270361,0.929241202634,040-AAM,0.141643966136,134,189,323
4991,-0.645953270361,0.929241202634,040-AAO,0.141643966136,79,123,202
4992,-0.645953270361,0.929241202634,040-AAQ,0.141643966136,147,214,361
4993,-0.645953270361,0.929241202634,040-AAS,0.141643966136,98,204,302
4994,-0.645953270361,0.929241202634,040-AAT,0.141643966136,130,244,374
4995,-0.645953270361,0.929241202634,040-AAV,0.141643966136,48,68,116
4996,-0.645953270361,0.929241202634,040-AAW,0.141643966136,80,210,290
4997,-0.645953270361,0.929241202634,040-AAX,0.141643966136,70,107,177
4998,-0.645953270361,0.929241202634,040-AAY,0.141643966136,150,224,374
4999,-0.645953270361,0.929241202634,040-AAZ,0.141643966136,104,176,280
5000,-0.645953270361,0.929241202634,040-ABA,0.141643966136,158,151,309
5001,-0.645953270361,0.929241202634,040-ABB,0.141643966136,79,158,237
5002,-0.645953270361,0.929241202634,040-ABC,0.141643966136,168,211,379
5003,-0.645953270361,0.929241202634,040-ABD,0.141643966136,177,291,468
5004,-0.645953270361,0.929241202634,040-ABE,0.141643966136,127,239,366
5005,-0.645953270361,0.929241202634,040-ABG,0.141643966136,59,147,206
5006,-0.645953270361,0.929241202634,040-ABH,0.141643966136,87,165,252
5007,-0.645953270361,0.929241202634,040-ABI,0.141643966136,55,95,150
5008,-0.645953270361,0.929241202634,040-ABJ,0.141643966136,137,189,326
5009,-0.645953270361,0.929241202634,040-ABM,0.141643966136,89,143,232
5010,-0.645953270361,0.929241202634,040-ABN,0.141643966136,85,162,247
5011,-0.645953270361,0.929241202634,040-ABO,0.141643966136,114,319,433
5012,-0.645953270361,0.929241202634,040-ABP,0.141643966136,71,147,218
5013,-0.645953270361,0.929241202634,040-ABQ,0.141643966136,87,198,285
5014,-0.645953270361,0.929241202634,041-AAA,0.141643966136,81,14,95
5015,-0.645953270361,0.929241202634,041-AAB,0.141643966136,137,53,190
5016,-0.645953270361,0.929241202634,041-AAC,0.141643966136,149,83,232
5017,-0.645953270361,0.929241202634,041-AAE,0.141643966136,125,152,277
5018,-0.645953270361,0.929241202634,041-AAF,0.141643966136,199,160,359
5019,-0.645953270361,0.929241202634,041-AAG,0.141643966136,113,109,222
5020,-0.645953270361,0.929241202634,041-AAI,0.141643966136,92,122,214
5021,-0.645953270361,0.929241202634,041-AAJ,0.141643966136,133,176,309
5022,-0.645953270361,0.929241202634,041-AAK,0.141643966136,174,240,414
5023,-0.645953270361,0.929241202634,041-AAM,0.141643966136,120,34,154
5024,-0.645953270361,0.929241202634,041-AAN,0.141643966136,120,44,164
5025,-0.645953270361,0.929241202634,041-AAO,0.141643966136,43,53,96
5026,-0.645953270361,0.929241202634,041-AAQ,0.141643966136,177,142,319
5027,-0.645953270361,0.929241202634,041-AAR,0.141643966136,156,194,350
5028,-0.645953270361,0.929241202634,041-AAS,0.141643966136,120,144,264
5029,-0.645953270361,0.929241202634,041-AAT,0.141643966136,183,177,360
5030,-0.645953270361,0.929241202634,041-AAU,0.141643966136,59,81,140
5031,-0.645953270361,0.929241202634,041-AAV,0.141643966136,142,193,335
5032,-0.645953270361,0.929241202634,041-AAW,0.141643966136,141,292,433
5033,-0.645953270361,0.929241202634,041-AAX,0.141643966136,182,282,464
5034,-0.645953270361,0.929241202634,041-ABA,0.141643966136,242,218,460
5035,-0.645953270361,0.929241202634,041-ABC,0.141643966136,273,228,501
5036,-0.645953270361,0.929241202634,041-ABE,0.141643966136,223,244,467
5037,-0.645953270361,0.929241202634,041-ABG,0.141643966136,231,227,458
5038,-0.645953270361,0.929241202634,041-ABI,0.141643966136,69,84,153
5039,-0.645953270361,0.929241202634,041-ABJ,0.141643966136,217,389,606
5040,-0.645953270361,0.929241202634,041-ABL,0.141643966136,207,246,453
5041,-0.645953270361,0.929241202634,041-ABM,0.141643966136,61,64,125
5042,-0.645953270361,0.929241202634,041-ABN,0.141643966136,111,170,281
5043,-0.645953270361,0.929241202634,041-ABO,0.141643966136,32,46,78
5044,-0.645953270361,0.929241202634,041-ABR,0.141643966136,62,87,149
5045,-0.645953270361,0.929241202634,041-ABS,0.141643966136,177,231,408
5046,-0.645953270361,0.929241202634,041-ABT,0.141643966136,230,234,464
5047,-0.645953270361,0.929241202634,041-ABU,0.141643966136,169,216,385
5048,-0.645953270361,0.929241202634,041-ABV,0.141643966136,153,123,276
5049,-0.645953270361,0.929241202634,041-ABY,0.141643966136,134,204,338
5050,-0.645953270361,0.929241202634,041-ABZ,0.141643966136,90,230,320
5051,-0.645953270361,0.929241202634,041-ACA,0.141643966136,172,229,401
5052,-0.645953270361,0.929241202634,041-ACB,0.141643966136,184,309,493
5053,-0.645953270361,0.929241202634,041-ACE,0.141643966136,119,161,280
5054,-0.645953270361,0.929241202634,041-ACF,0.141643966136,90,161,251
5055,-0.645953270361,0.929241202634,041-ACH,0.141643966136,82,101,183
5056,-0.645953270361,0.929241202634,041-ACI,0.141643966136,190,243,433
5057,-0.645953270361,0.929241202634,041-ACK,0.141643966136,44,37,81
5058,-0.645953270361,0.929241202634,041-ACL,0.141643966136,119,140,259
5059,-0.645953270361,0.929241202634,041-ACN,0.141643966136,153,272,425
5060,-0.645953270361,0.929241202634,041-ACO,0.141643966136,79,47,126
5061,-0.645953270361,0.929241202634,041-ACP,0.141643966136,183,170,353
5062,-0.645953270361,0.929241202634,041-ACR,0.141643966136,91,43,134
5063,-0.645953270361,0.929241202634,041-ACS,0.141643966136,103,70,173
5064,-0.645953270361,0.929241202634,041-ACT,0.141643966136,129,51,180
5065,-0.645953270361,0.929241202634,041-ACU,0.141643966136,64,149,213
5066,-0.645953270361,0.929241202634,041-ACV,0.141643966136,74,123,197
5067,-0.645953270361,0.929241202634,041-ACW,0.141643966136,99,212,311
5068,-0.645953270361,0.929241202634,041-ACX,0.141643966136,226,430,656
5069,-0.645953270361,0.929241202634,041-ACZ,0.141643966136,64,32,96
5070,-0.645953270361,0.929241202634,041-ADA,0.141643966136,148,142,290
5071,-0.645953270361,0.929241202634,041-ADB,0.141643966136,122,91,213
5072,-0.645953270361,0.929241202634,041-ADC,0.141643966136,114,72,186
5073,-0.645953270361,0.929241202634,041-ADD,0.141643966136,134,56,190
5074,-0.645953270361,0.929241202634,041-ADE,0.141643966136,122,99,221
5075,-0.645953270361,0.929241202634,041-ADF,0.141643966136,144,72,216
5076,-0.645953270361,0.929241202634,041-ADG,0.141643966136,77,43,120
5077,-0.645953270361,0.929241202634,041-ADH,0.141643966136,86,111,197
5078,-0.645953270361,0.929241202634,041-ADI,0.141643966136,171,205,376
5079,-0.645953270361,0.929241202634,041-ADK,0.141643966136,63,64,127
5080,-0.645953270361,0.929241202634,041-ADL,0.141643966136,34,42,76
5081,-0.645953270361,0.929241202634,041-ADM,0.141643966136,180,130,310
5082,-0.645953270361,0.929241202634,041-ADN,0.141643966136,151,78,229
5083,-0.645953270361,0.929241202634,041-ADO,0.141643966136,186,159,345
5084,-0.645953270361,0.929241202634,041-ADP,0.141643966136,177,120,297
5085,-0.645953270361,0.929241202634,041-ADS,0.141643966136,256,148,404
5086,-0.645953270361,0.929241202634,041-ADT,0.141643966136,148,58,206
5087,-0.645953270361,0.929241202634,041-ADU,0.141643966136,87,61,148
5088,-0.645953270361,0.929241202634,041-ADW,0.141643966136,287,186,473
5089,-0.645953270361,0.929241202634,041-AEA,0.141643966136,150,58,208
5090,-0.645953270361,0.929241202634,041-AEB,0.141643966136,138,242,380
5091,-0.645953270361,0.929241202634,041-AEC,0.141643966136,27,33,60
5092,-0.645953270361,0.929241202634,041-AEE,0.141643966136,165,275,440
5093,-0.645953270361,0.929241202634,041-AEF,0.141643966136,90,83,173
5094,-0.645953270361,0.929241202634,041-AEG,0.141643966136,181,139,320
5095,-0.645953270361,0.929241202634,041-AEH,0.141643966136,204,220,424
5096,-0.645953270361,0.929241202634,042-AAA,0.141643966136,151,274,425
5097,-0.645953270361,0.929241202634,042-AAB,0.141643966136,32,65,97
5098,-0.645953270361,0.929241202634,042-AAC,0.141643966136,97,272,369
5099,-0.645953270361,0.929241202634,042-AAD,0.141643966136,89,196,285
5100,-0.645953270361,0.929241202634,042-AAE,0.141643966136,84,136,220
5101,-0.645953270361,0.929241202634,042-AAF,0.141643966136,35,112,147
5102,-0.645953270361,0.929241202634,042-AAG,0.141643966136,119,246,365
5103,-0.645953270361,0.929241202634,042-AAH,0.141643966136,87,127,214
5104,-0.645953270361,0.929241202634,042-AAI,0.141643966136,150,306,456
5105,-0.645953270361,0.929241202634,042-AAJ,0.141643966136,115,255,370
5106,-0.645953270361,0.929241202634,042-AAK,0.141643966136,105,167,272
5107,-0.645953270361,0.929241202634,042-AAL,0.141643966136,88,127,215
5108,-0.645953270361,0.929241202634,042-AAM,0.141643966136,81,211,292
5109,-0.645953270361,0.929241202634,042-AAN,0.141643966136,97,169,266
5110,-0.645953270361,0.929241202634,042-AAO,0.141643966136,73,296,369
5111,-0.645953270361,0.929241202634,042-AAP,0.141643966136,77,230,307
5112,-0.645953270361,0.929241202634,042-AAQ,0.141643966136,132,353,485
5113,-0.645953270361,0.929241202634,042-AAR,0.141643966136,52,186,238
5114,-0.645953270361,0.929241202634,042-AAS,0.141643966136,103,325,428
5115,-0.645953270361,0.929241202634,042-AAT,0.141643966136,80,221,301
5116,-0.645953270361,0.929241202634,042-AAU,0.141643966136,92,217,309
5117,-0.645953270361,0.929241202634,042-AAV,0.141643966136,105,279,384
5118,-0.645953270361,0.929241202634,042-AAW,0.141643966136,69,92,161
5119,-0.645953270361,0.929241202634,042-AAX,0.141643966136,256,62,318
5120,-0.645953270361,0.929241202634,042-AAY,0.141643966136,81,242,323
5121,-0.645953270361,0.929241202634,042-AAZ,0.141643966136,91,336,427
5122,-0.645953270361,0.929241202634,042-ABA,0.141643966136,64,268,332
5123,-0.645953270361,0.929241202634,042-ABB,0.141643966136,90,201,291
5124,-0.645953270361,0.929241202634,042-ABC,0.141643966136,85,236,321
5125,-0.645953270361,0.929241202634,042-ABD,0.141643966136,60,235,295
5126,-0.645953270361,0.929241202634,042-ABE,0.141643966136,95,250,345
5127,-0.645953270361,0.929241202634,042-ABF,0.141643966136,62,243,305
5128,-0.645953270361,0.929241202634,042-ABG,0.141643966136,54,135,189
5129,-0.645953270361,0.929241202634,042-ABH,0.141643966136,81,288,369
5130,-0.645953270361,0.929241202634,042-ABI,0.141643966136,71,290,361
5131,-0.645953270361,0.929241202634,042-ABJ,0.141643966136,64,238,302
5132,-0.645953270361,0.929241202634,042-ABK,0.141643966136,67,323,390
5133,-0.645953270361,0.929241202634,042-ABL,0.141643966136,130,249,379
5134,-0.645953270361,0.929241202634,042-ABM,0.141643966136,123,276,399
5135,-0.645953270361,0.929241202634,042-ABN,0.141643966136,88,316,404
5136,-0.645953270361,0.929241202634,042-ABO,0.141643966136,59,249,308
5137,-0.645953270361,0.929241202634,042-ABP,0.141643966136,113,340,453
5138,-0.645953270361,0.929241202634,042-ABQ,0.141643966136,97,362,459
5139,-0.645953270361,0.929241202634,042-ABR,0.141643966136,109,263,372
5140,-0.645953270361,0.929241202634,042-ABS,0.141643966136,93,277,370
5141,-0.645953270361,0.929241202634,042-ABT,0.141643966136,68,158,226
5142,-0.645953270361,0.929241202634,042-ABU,0.141643966136,75,298,373
5143,-0.645953270361,0.929241202634,042-ABV,0.141643966136,45,98,143
5144,-0.645953270361,0.929241202634,042-ABW,0.141643966136,91,277,368
5145,-0.645953270361,0.929241202634,042-ABX,0.141643966136,72,303,375
5146,-0.645953270361,0.929241202634,042-ABY,0.141643966136,143,344,487
5147,-0.645953270361,0.929241202634,042-ABZ,0.141643966136,63,202,265
5148,-0.645953270361,0.929241202634,042-ACA,0.141643966136,89,262,351
5149,-0.645953270361,0.929241202634,042-ACB,0.141643966136,76,266,342
5150,-0.645953270361,0.929241202634,042-ACC,0.141643966136,87,211,298
5151,-0.645953270361,0.929241202634,042-ACD,0.141643966136,76,265,341
5152,-0.645953270361,0.929241202634,042-ACE,0.141643966136,87,273,360
5153,-0.645953270361,0.929241202634,042-ACF,0.141643966136,89,270,359
5154,-0.645953270361,0.929241202634,042-ACG,0.141643966136,98,22,120
5155,-0.645953270361,0.929241202634,043-AAA,0.141643966136,188,184,372
5156,-0.645953270361,0.929241202634,043-AAB,0.141643966136,160,186,346
5157,-0.645953270361,0.929241202634,043-AAC,0.141643966136,264,380,644
5158,-0.645953270361,0.929241202634,043-AAE,0.141643966136,214,246,460
5159,-0.645953270361,0.929241202634,043-AAF,0.141643966136,124,179,303
5160,-0.645953270361,0.929241202634,043-AAG,0.141643966136,204,226,430
5161,-0.645953270361,0.929241202634,043-AAI,0.141643966136,203,228,431
5162,-0.645953270361,0.929241202634,043-AAJ,0.141643966136,192,264,456
5163,-0.645953270361,0.929241202634,043-AAK,0.141643966136,193,265,458
5164,-0.645953270361,0.929241202634,043-AAN,0.141643966136,197,301,498
5165,-0.645953270361,0.929241202634,043-AAO,0.141643966136,247,355,602
5166,-0.645953270361,0.929241202634,043-AAP,0.141643966136,140,202,342
5167,-0.645953270361,0.929241202634,043-AAS,0.141643966136,202,345,547
5168,-0.645953270361,0.929241202634,043-AAT,0.141643966136,202,565,767
5169,-0.645953270361,0.929241202634,043-AAU,0.141643966136,264,520,784
5170,-0.645953270361,0.929241202634,043-AAV,0.141643966136,196,547,743
5171,-0.645953270361,0.929241202634,043-AAW,0.141643966136,174,277,451
5172,-0.645953270361,0.929241202634,043-AAX,0.141643966136,130,209,339
5173,-0.645953270361,0.929241202634,043-AAY,0.141643966136,179,329,508
5174,-0.645953270361,0.929241202634,043-AAZ,0.141643966136,185,371,556
5175,-0.645953270361,0.929241202634,043-ABA,0.141643966136,166,231,397
5176,-0.645953270361,0.929241202634,043-ABB,0.141643966136,170,398,568
5177,-0.645953270361,0.929241202634,043-ABC,0.141643966136,182,449,631
5178,-0.645953270361,0.929241202634,043-ABD,0.141643966136,164,330,494
5179,-0.645953270361,0.929241202634,043-ABF,0.141643966136,187,348,535
5180,-0.645953270361,0.929241202634,043-ABG,0.141643966136,202,359,561
5181,-0.645953270361,0.929241202634,043-ABH,0.141643966136,195,393,588
5182,-0.645953270361,0.929241202634,043-ABI,0.141643966136,162,276,438
5183,-0.645953270361,0.929241202634,043-ABJ,0.141643966136,136,204,340
5184,-0.645953270361,0.929241202634,043-ABK,0.141643966136,115,256,371
5185,-0.645953270361,0.929241202634,043-ABL,0.141643966136,236,427,663
5186,-0.645953270361,0.929241202634,043-ABM,0.141643966136,148,266,414
5187,-0.645953270361,0.929241202634,043-ABQ,0.141643966136,204,262,466
5188,-0.645953270361,0.929241202634,043-ABR,0.141643966136,196,308,504
5189,-0.645953270361,0.929241202634,043-ABS,0.141643966136,192,397,589
5190,-0.645953270361,0.929241202634,043-ABT,0.141643966136,250,348,598
5191,-0.645953270361,0.929241202634,043-ABU,0.141643966136,156,256,412
5192,-0.645953270361,0.929241202634,043-ABV,0.141643966136,244,374,618
5193,-0.645953270361,0.929241202634,043-ABW,0.141643966136,146,255,401
5194,-0.645953270361,0.929241202634,043-ABX,0.141643966136,173,358,531
5195,-0.645953270361,0.929241202634,043-ABY,0.141643966136,165,349,514
5196,-0.645953270361,0.929241202634,043-ABZ,0.141643966136,126,359,485
5197,-0.645953270361,0.929241202634,043-ACA,0.141643966136,147,183,330
5198,-0.645953270361,0.929241202634,043-ACB,0.141643966136,146,150,296
5199,-0.645953270361,0.929241202634,043-ACC,0.141643966136,184,323,507
5200,-0.645953270361,0.929241202634,043-ACD,0.141643966136,148,325,473
5201,-0.645953270361,0.929241202634,043-ACE,0.141643966136,228,409,637
5202,-0.645953270361,0.929241202634,043-ACF,0.141643966136,163,308,471
5203,-0.645953270361,0.929241202634,043-ACG,0.141643966136,239,302,541
5204,-0.645953270361,0.929241202634,043-ACH,0.141643966136,118,192,310
5205,-0.645953270361,0.929241202634,043-ACI,0.141643966136,133,225,358
5206,-0.645953270361,0.929241202634,043-ACJ,0.141643966136,177,263,440
5207,-0.645953270361,0.929241202634,043-ACK,0.141643966136,141,174,315
5208,-0.645953270361,0.929241202634,043-ACL,0.141643966136,272,206,478
5209,-0.645953270361,0.929241202634,043-ACM,0.141643966136,147,71,218
5210,-0.645953270361,0.929241202634,043-ACP,0.141643966136,196,210,406
5211,-0.645953270361,0.929241202634,043-ACQ,0.141643966136,196,212,408
5212,-0.645953270361,0.929241202634,043-ACT,0.141643966136,154,181,335
5213,-0.645953270361,0.929241202634,043-ACU,0.141643966136,186,215,401
5214,-0.645953270361,0.929241202634,043-ACV,0.141643966136,187,172,359
5215,-0.645953270361,0.929241202634,043-ACX,0.141643966136,151,214,365
5216,-0.645953270361,0.929241202634,043-ACY,0.141643966136,275,145,420
5217,-0.645953270361,0.929241202634,043-ACZ,0.141643966136,193,113,306
5218,-0.645953270361,0.929241202634,043-ADB,0.141643966136,246,340,586
5219,-0.645953270361,0.929241202634,043-ADC,0.141643966136,252,331,583
5220,-0.645953270361,0.929241202634,043-ADF,0.141643966136,193,250,443
5221,-0.645953270361,0.929241202634,043-ADG,0.141643966136,86,219,305
5222,-0.645953270361,0.929241202634,043-ADH,0.141643966136,133,169,302
5223,-0.645953270361,0.929241202634,043-ADJ,0.141643966136,224,288,512
5224,-0.645953270361,0.929241202634,043-ADK,0.141643966136,264,229,493
5225,-0.645953270361,0.929241202634,043-ADN,0.141643966136,198,364,562
5226,-0.645953270361,0.929241202634,043-ADO,0.141643966136,202,242,444
5227,-0.645953270361,0.929241202634,043-ADR,0.141643966136,143,204,347
5228,-0.645953270361,0.929241202634,043-ADS,0.141643966136,204,318,522
5229,-0.645953270361,0.929241202634,043-ADT,0.141643966136,157,154,311
5230,-0.645953270361,0.929241202634,043-ADV,0.141643966136,189,270,459
5231,-0.645953270361,0.929241202634,043-ADW,0.141643966136,193,413,606
5232,-0.645953270361,0.929241202634,043-ADX,0.141643966136,180,242,422
5233,-0.645953270361,0.929241202634,043-ADY,0.141643966136,225,264,489
5234,-0.645953270361,0.929241202634,043-AEB,0.141643966136,184,299,483
5235,-0.645953270361,0.929241202634,043-AEC,0.141643966136,147,186,333
5236,-0.645953270361,0.929241202634,043-AED,0.141643966136,150,221,371
5237,-0.645953270361,0.929241202634,043-AEE,0.141643966136,233,344,577
5238,-0.645953270361,0.929241202634,043-AEF,0.141643966136,237,447,684
5239,-0.645953270361,0.929241202634,043-AEI,0.141643966136,162,258,420
5240,-0.645953270361,0.929241202634,043-AEJ,0.141643966136,156,328,484
5241,-0.645953270361,0.929241202634,043-AEL,0.141643966136,205,466,671
5242,-0.645953270361,0.929241202634,043-AEM,0.141643966136,165,332,497
5243,-0.645953270361,0.929241202634,043-AEN,0.141643966136,261,367,628
5244,-0.645953270361,0.929241202634,043-AEO,0.141643966136,258,102,360
5245,-0.645953270361,0.929241202634,043-AEP,0.141643966136,136,264,400
5246,-0.645953270361,0.929241202634,043-AEQ,0.141643966136,138,328,466
5247,-0.645953270361,0.929241202634,043-AER,0.141643966136,206,97,303
5248,-0.645953270361,0.929241202634,043-AET,0.141643966136,234,261,495
5249,-0.645953270361,0.929241202634,043-AEU,0.141643966136,158,178,336
5250,-0.645953270361,0.929241202634,043-AEV,0.141643966136,221,253,474
5251,-0.645953270361,0.929241202634,043-AEY,0.141643966136,196,279,475
5252,-0.645953270361,0.929241202634,043-AEZ,0.141643966136,181,231,412
5253,-0.645953270361,0.929241202634,043-AFA,0.141643966136,260,273,533
5254,-0.645953270361,0.929241202634,043-AFD,0.141643966136,246,351,597
5255,-0.645953270361,0.929241202634,043-AFE,0.141643966136,198,230,428
5256,-0.645953270361,0.929241202634,043-AFF,0.141643966136,212,297,509
5257,-0.645953270361,0.929241202634,043-AFJ,0.141643966136,177,419,596
5258,-0.645953270361,0.929241202634,043-AFK,0.141643966136,142,614,756
5259,-0.645953270361,0.929241202634,043-AFL,0.141643966136,211,509,720
5260,-0.645953270361,0.929241202634,043-AFM,0.141643966136,145,327,472
5261,-0.645953270361,0.929241202634,043-AFN,0.141643966136,186,273,459
5262,-0.645953270361,0.929241202634,043-AFO,0.141643966136,150,440,590
5263,-0.645953270361,0.929241202634,043-AFP,0.141643966136,157,482,639
5264,-0.645953270361,0.929241202634,043-AFQ,0.141643966136,126,279,405
5265,-0.645953270361,0.929241202634,043-AFR,0.141643966136,188,660,848
5266,-0.645953270361,0.929241202634,043-AFS,0.141643966136,133,427,560
5267,-0.645953270361,0.929241202634,043-AFT,0.141643966136,53,267,320
5268,-0.645953270361,0.929241202634,043-AFU,0.141643966136,45,39,84
5269,-0.645953270361,0.929241202634,043-AFV,0.141643966136,209,482,691
5270,-0.645953270361,0.929241202634,043-AFW,0.141643966136,204,495,699
5271,-0.645953270361,0.929241202634,043-AFX,0.141643966136,184,231,415
5272,-0.645953270361,0.929241202634,043-AFY,0.141643966136,202,279,481
5273,-0.645953270361,0.929241202634,043-AFZ,0.141643966136,172,242,414
5274,-0.645953270361,0.929241202634,043-AGA,0.141643966136,173,315,488
5275,-0.645953270361,0.929241202634,043-AGB,0.141643966136,127,207,334
5276,-0.645953270361,0.929241202634,043-AGC,0.141643966136,196,362,558
5277,-0.645953270361,0.929241202634,043-AGD,0.141643966136,172,246,418
5278,-0.645953270361,0.929241202634,043-AGE,0.141643966136,176,311,487
5279,-0.645953270361,0.929241202634,043-AGF,0.141643966136,139,330,469
5280,-0.645953270361,0.929241202634,043-AGG,0.141643966136,132,141,273
5281,-0.645953270361,0.929241202634,043-AGH,0.141643966136,197,354,551
5282,-0.645953270361,0.929241202634,043-AGI,0.141643966136,197,364,561
5283,-0.645953270361,0.929241202634,043-AGJ,0.141643966136,223,432,655
5284,-0.645953270361,0.929241202634,043-AGK,0.141643966136,230,345,575
5285,-0.645953270361,0.929241202634,043-AGL,0.141643966136,289,424,713
5286,-0.645953270361,0.929241202634,043-AGM,0.141643966136,157,330,487
5287,-0.645953270361,0.929241202634,043-AGN,0.141643966136,151,293,444
5288,-0.645953270361,0.929241202634,043-AGO,0.141643966136,189,380,569
5289,-0.645953270361,0.929241202634,043-AGP,0.141643966136,211,302,513
5290,-0.645953270361,0.929241202634,043-AGQ,0.141643966136,215,328,543
5291,-0.645953270361,0.929241202634,043-AGR,0.141643966136,140,260,400
5292,-0.645953270361,0.929241202634,043-AGS,0.141643966136,118,211,329
5293,-0.645953270361,0.929241202634,043-AGT,0.141643966136,244,312,556
5294,-0.645953270361,0.929241202634,043-AGU,0.141643966136,174,213,387
5295,-0.645953270361,0.929241202634,043-AGY,0.141643966136,51,96,147
5296,-0.645953270361,0.929241202634,043-AGZ,0.141643966136,219,415,634
5297,-0.645953270361,0.929241202634,043-AHA,0.141643966136,168,349,517
5298,-0.645953270361,0.929241202634,043-AHB,0.141643966136,164,340,504
5299,-0.645953270361,0.929241202634,043-AHC,0.141643966136,87,255,342
5300,-0.645953270361,0.929241202634,043-AHD,0.141643966136,169,363,532
5301,-0.645953270361,0.929241202634,043-AHE,0.141643966136,126,187,313
5302,-0.645953270361,0.929241202634,043-AHF,0.141643966136,54,221,275
5303,-0.645953270361,0.929241202634,043-AHK,0.141643966136,181,462,643
5304,-0.645953270361,0.929241202634,043-AHR,0.141643966136,169,349,518
5305,-0.645953270361,0.929241202634,043-AHX,0.141643966136,115,279,394
5306,-0.645953270361,0.929241202634,043-AHY,0.141643966136,99,344,443
5307,-0.645953270361,0.929241202634,043-AHZ,0.141643966136,194,325,519
5308,-0.645953270361,0.929241202634,043-AIA,0.141643966136,108,286,394
5309,-0.645953270361,0.929241202634,043-AIG,0.141643966136,182,348,530
5310,-0.645953270361,0.929241202634,043-AIL,0.141643966136,168,329,497
5311,-0.645953270361,0.929241202634,044-AAA,0.141643966136,87,97,184
5312,-0.645953270361,0.929241202634,044-AAB,0.141643966136,63,41,104
5313,-0.645953270361,0.929241202634,044-AAC,0.141643966136,33,27,60
5314,-0.645953270361,0.929241202634,044-AAD,0.141643966136,34,24,58
5315,-0.645953270361,0.929241202634,044-AAE,0.141643966136,94,136,230
5316,-0.645953270361,0.929241202634,044-AAF,0.141643966136,128,141,269
5317,-0.645953270361,0.929241202634,044-AAG,0.141643966136,53,41,94
5318,-0.645953270361,0.929241202634,044-AAH,0.141643966136,17,36,53
5319,-0.645953270361,0.929241202634,044-AAI,0.141643966136,35,59,94
5320,-0.645953270361,0.929241202634,044-AAJ,0.141643966136,99,50,149
5321,-0.645953270361,0.929241202634,044-AAK,0.141643966136,28,36,64
5322,-0.645953270361,0.929241202634,044-AAL,0.141643966136,72,36,108
5323,-0.645953270361,0.929241202634,044-AAM,0.141643966136,20,9,29
5324,-0.645953270361,0.929241202634,044-AAN,0.141643966136,42,42,84
5325,-0.645953270361,0.929241202634,044-AAO,0.141643966136,68,66,134
5326,-0.645953270361,0.929241202634,044-AAP,0.141643966136,29,56,85
5327,-0.645953270361,0.929241202634,044-AAQ,0.141643966136,37,66,103
5328,-0.645953270361,0.929241202634,044-AAR,0.141643966136,42,84,126
5329,-0.645953270361,0.929241202634,044-AAS,0.141643966136,52,70,122
5330,-0.645953270361,0.929241202634,044-AAT,0.141643966136,71,78,149
5331,-0.645953270361,0.929241202634,044-AAU,0.141643966136,73,148,221
5332,-0.645953270361,0.929241202634,044-AAV,0.141643966136,71,62,133
5333,-0.645953270361,0.929241202634,044-AAW,0.141643966136,49,55,104
5334,-0.645953270361,0.929241202634,044-AAX,0.141643966136,77,72,149
5335,-0.645953270361,0.929241202634,044-AAY,0.141643966136,73,138,211
5336,-0.645953270361,0.929241202634,044-AAZ,0.141643966136,82,131,213
5337,-0.645953270361,0.929241202634,044-ABA,0.141643966136,26,47,73
5338,-0.645953270361,0.929241202634,044-ABC,0.141643966136,145,117,262
5339,-0.645953270361,0.929241202634,044-ABD,0.141643966136,183,217,400
5340,-0.645953270361,0.929241202634,044-ABE,0.141643966136,95,100,195
5341,-0.645953270361,0.929241202634,044-ABF,0.141643966136,93,216,309
5342,-0.645953270361,0.929241202634,044-ABG,0.141643966136,55,104,159
5343,-0.645953270361,0.929241202634,044-ABH,0.141643966136,79,172,251
5344,-0.645953270361,0.929241202634,044-ABI,0.141643966136,66,110,176
5345,-0.645953270361,0.929241202634,044-ABJ,0.141643966136,107,235,342
5346,-0.645953270361,0.929241202634,044-ABK,0.141643966136,73,152,225
5347,-0.645953270361,0.929241202634,044-ABL,0.141643966136,128,117,245
5348,-0.645953270361,0.929241202634,044-ABM,0.141643966136,134,211,345
5349,-0.645953270361,0.929241202634,044-ABN,0.141643966136,142,136,278
5350,-0.645953270361,0.929241202634,044-ABO,0.141643966136,102,56,158
5351,-0.645953270361,0.929241202634,044-ABP,0.141643966136,43,52,95
5352,-0.645953270361,0.929241202634,044-ABQ,0.141643966136,96,161,257
5353,-0.645953270361,0.929241202634,044-ABR,0.141643966136,95,138,233
5354,-0.645953270361,0.929241202634,044-ABS,0.141643966136,102,206,308
5355,-0.645953270361,0.929241202634,044-ABT,0.141643966136,95,86,181
5356,-0.645953270361,0.929241202634,044-ABU,0.141643966136,35,76,111
5357,-0.645953270361,0.929241202634,044-ABV,0.141643966136,154,147,301
5358,-0.645953270361,0.929241202634,044-ABW,0.141643966136,120,201,321
5359,-0.645953270361,0.929241202634,044-ABX,0.141643966136,47,101,148
5360,-0.645953270361,0.929241202634,044-ABY,0.141643966136,104,187,291
5361,-0.645953270361,0.929241202634,044-ABZ,0.141643966136,142,153,295
5362,-0.645953270361,0.929241202634,044-ACA,0.141643966136,42,80,122
5363,-0.645953270361,0.929241202634,044-ACB,0.141643966136,110,166,276
5364,-0.645953270361,0.929241202634,044-ACC,0.141643966136,42,50,92
5365,-0.645953270361,0.929241202634,044-ACD,0.141643966136,89,152,241
5366,-0.645953270361,0.929241202634,044-ACE,0.141643966136,183,396,579
5367,-0.645953270361,0.929241202634,044-ACF,0.141643966136,85,139,224
5368,-0.645953270361,0.929241202634,044-ACG,0.141643966136,132,244,376
5369,-0.645953270361,0.929241202634,044-ACH,0.141643966136,60,139,199
5370,-0.645953270361,0.929241202634,044-ACI,0.141643966136,127,307,434
5371,-0.645953270361,0.929241202634,044-ACJ,0.141643966136,76,117,193
5372,-0.645953270361,0.929241202634,044-ACK,0.141643966136,141,231,372
5373,-0.645953270361,0.929241202634,044-ACL,0.141643966136,72,50,122
5374,-0.645953270361,0.929241202634,044-ACM,0.141643966136,61,126,187
5375,-0.645953270361,0.929241202634,044-ACN,0.141643966136,60,101,161
5376,-0.645953270361,0.929241202634,044-ACO,0.141643966136,107,233,340
5377,-0.645953270361,0.929241202634,044-ACP,0.141643966136,84,180,264
5378,-0.645953270361,0.929241202634,044-ACQ,0.141643966136,102,203,305
5379,-0.645953270361,0.929241202634,044-ACR,0.141643966136,108,227,335
5380,-0.645953270361,0.929241202634,044-ACS,0.141643966136,90,204,294
5381,-0.645953270361,0.929241202634,044-ACT,0.141643966136,68,71,139
5382,-0.645953270361,0.929241202634,044-ACU,0.141643966136,41,51,92
5383,-0.645953270361,0.929241202634,044-ACV,0.141643966136,49,84,133
5384,-0.645953270361,0.929241202634,044-ACW,0.141643966136,49,65,114
5385,-0.645953270361,0.929241202634,044-ACX,0.141643966136,103,131,234
5386,-0.645953270361,0.929241202634,044-ACY,0.141643966136,101,145,246
5387,-0.645953270361,0.929241202634,044-ACZ,0.141643966136,87,88,175
5388,-0.645953270361,0.929241202634,044-ADA,0.141643966136,49,73,122
5389,-0.645953270361,0.929241202634,044-ADB,0.141643966136,103,156,259
5390,-0.645953270361,0.929241202634,044-ADC,0.141643966136,82,128,210
5391,-0.645953270361,0.929241202634,044-ADE,0.141643966136,76,155,231
5392,-0.645953270361,0.929241202634,044-ADF,0.141643966136,124,242,366
5393,-0.645953270361,0.929241202634,045-AAA,0.141643966136,203,437,640
5394,-0.645953270361,0.929241202634,045-AAB,0.141643966136,148,213,361
5395,-0.645953270361,0.929241202634,045-AAD,0.141643966136,145,348,493
5396,-0.645953270361,0.929241202634,045-AAE,0.141643966136,206,368,574
5397,-0.645953270361,0.929241202634,045-AAG,0.141643966136,134,406,540
5398,-0.645953270361,0.929241202634,045-AAH,0.141643966136,184,411,595
5399,-0.645953270361,0.929241202634,045-AAJ,0.141643966136,146,181,327
5400,-0.645953270361,0.929241202634,045-AAK,0.141643966136,127,183,310
5401,-0.645953270361,0.929241202634,045-AAL,0.141643966136,105,115,220
5402,-0.645953270361,0.929241202634,045-AAM,0.141643966136,92,102,194
5403,-0.645953270361,0.929241202634,045-AAP,0.141643966136,101,153,254
5404,-0.645953270361,0.929241202634,045-AAQ,0.141643966136,128,106,234
5405,-0.645953270361,0.929241202634,045-AAR,0.141643966136,107,114,221
5406,-0.645953270361,0.929241202634,045-AAS,0.141643966136,109,123,232
5407,-0.645953270361,0.929241202634,045-AAV,0.141643966136,103,163,266
5408,-0.645953270361,0.929241202634,045-AAW,0.141643966136,121,156,277
5409,-0.645953270361,0.929241202634,045-AAX,0.141643966136,169,537,706
5410,-0.645953270361,0.929241202634,045-AAY,0.141643966136,129,231,360
5411,-0.645953270361,0.929241202634,045-AAZ,0.141643966136,125,296,421
5412,-0.645953270361,0.929241202634,045-ABB,0.141643966136,134,260,394
5413,-0.645953270361,0.929241202634,045-ABC,0.141643966136,98,193,291
5414,-0.645953270361,0.929241202634,045-ABD,0.141643966136,144,253,397
5415,-0.645953270361,0.929241202634,045-ABE,0.141643966136,159,337,496
5416,-0.645953270361,0.929241202634,045-ABF,0.141643966136,142,267,409
5417,-0.645953270361,0.929241202634,045-ABJ,0.141643966136,129,508,637
5418,-0.645953270361,0.929241202634,045-ABK,0.141643966136,102,262,364
5419,-0.645953270361,0.929241202634,045-ABL,0.141643966136,93,274,367
5420,-0.645953270361,0.929241202634,045-ABM,0.141643966136,171,330,501
5421,-0.645953270361,0.929241202634,045-ABN,0.141643966136,107,227,334
5422,-0.645953270361,0.929241202634,045-ABO,0.141643966136,150,240,390
5423,-0.645953270361,0.929241202634,045-ABR,0.141643966136,190,394,584
5424,-0.645953270361,0.929241202634,045-ABS,0.141643966136,163,305,468
5425,-0.645953270361,0.929241202634,045-ABT,0.141643966136,135,295,430
5426,-0.645953270361,0.929241202634,045-ABU,0.141643966136,94,207,301
5427,-0.645953270361,0.929241202634,045-ABV,0.141643966136,136,418,554
5428,-0.645953270361,0.929241202634,045-ABZ,0.141643966136,156,157,313
5429,-0.645953270361,0.929241202634,045-ACA,0.141643966136,92,153,245
5430,-0.645953270361,0.929241202634,045-ACB,0.141643966136,120,187,307
5431,-0.645953270361,0.929241202634,045-ACC,0.141643966136,169,181,350
5432,-0.645953270361,0.929241202634,045-ACJ,0.141643966136,129,551,680
5433,-0.645953270361,0.929241202634,045-ACK,0.141643966136,167,485,652
5434,-0.645953270361,0.929241202634,045-ACL,0.141643966136,149,379,528
5435,-0.645953270361,0.929241202634,045-ACM,0.141643966136,122,257,379
5436,-0.645953270361,0.929241202634,045-ACN,0.141643966136,115,352,467
5437,-0.645953270361,0.929241202634,045-ACO,0.141643966136,92,247,339
5438,-0.645953270361,0.929241202634,045-ACP,0.141643966136,149,450,599
5439,-0.645953270361,0.929241202634,045-ACQ,0.141643966136,94,303,397
5440,-0.645953270361,0.929241202634,045-ACR,0.141643966136,231,540,771
5441,-0.645953270361,0.929241202634,045-ACS,0.141643966136,90,213,303
5442,-0.645953270361,0.929241202634,045-ACT,0.141643966136,111,310,421
5443,-0.645953270361,0.929241202634,045-ACU,0.141643966136,140,374,514
5444,-0.645953270361,0.929241202634,045-ACV,0.141643966136,193,404,597
5445,-0.645953270361,0.929241202634,045-ACW,0.141643966136,220,395,615
5446,-0.645953270361,0.929241202634,045-ACX,0.141643966136,173,412,585
5447,-0.645953270361,0.929241202634,045-ACY,0.141643966136,108,209,317
5448,-0.645953270361,0.929241202634,045-ACZ,0.141643966136,159,134,293
5449,-0.645953270361,0.929241202634,045-ADA,0.141643966136,211,295,506
5450,-0.645953270361,0.929241202634,045-ADB,0.141643966136,168,582,750
5451,-0.645953270361,0.929241202634,045-ADC,0.141643966136,207,139,346
5452,-0.645953270361,0.929241202634,045-ADD,0.141643966136,89,219,308
5453,-0.645953270361,0.929241202634,045-ADE,0.141643966136,81,154,235
5454,-0.645953270361,0.929241202634,045-ADF,0.141643966136,103,217,320
5455,-0.645953270361,0.929241202634,045-ADG,0.141643966136,41,124,165
5456,-0.645953270361,0.929241202634,045-ADH,0.141643966136,152,450,602
5457,-0.645953270361,0.929241202634,045-ADI,0.141643966136,170,422,592
5458,-0.645953270361,0.929241202634,045-ADJ,0.141643966136,160,401,561
5459,-0.645953270361,0.929241202634,045-ADK,0.141643966136,195,549,744
5460,-0.645953270361,0.929241202634,045-ADL,0.141643966136,175,498,673
5461,-0.645953270361,0.929241202634,045-ADM,0.141643966136,68,298,366
5462,-0.645953270361,0.929241202634,045-ADN,0.141643966136,28,102,130
5463,-0.645953270361,0.929241202634,045-ADO,0.141643966136,147,318,465
5464,-0.645953270361,0.929241202634,045-ADP,0.141643966136,54,307,361
5465,-0.645953270361,0.929241202634,045-ADQ,0.141643966136,120,377,497
5466,-0.645953270361,0.929241202634,045-ADR,0.141643966136,93,380,473
5467,-0.645953270361,0.929241202634,045-ADS,0.141643966136,101,439,540
5468,-0.645953270361,0.929241202634,045-ADT,0.141643966136,133,354,487
5469,-0.645953270361,0.929241202634,045-ADU,0.141643966136,87,231,318
5470,-0.645953270361,0.929241202634,045-ADV,0.141643966136,128,373,501
5471,-0.645953270361,0.929241202634,045-ADW,0.141643966136,173,408,581
5472,-0.645953270361,0.929241202634,045-ADX,0.141643966136,102,270,372
5473,-0.645953270361,0.929241202634,045-ADY,0.141643966136,81,229,310
5474,-0.645953270361,0.929241202634,045-ADZ,0.141643966136,129,296,425
5475,-0.645953270361,0.929241202634,045-AEA,0.141643966136,83,214,297
5476,-0.645953270361,0.929241202634,045-AEB,0.141643966136,106,231,337
5477,-0.645953270361,0.929241202634,045-AEC,0.141643966136,182,446,628
5478,-0.645953270361,0.929241202634,045-AEE,0.141643966136,93,350,443
5479,-0.645953270361,0.929241202634,045-AEF,0.141643966136,92,438,530
5480,-0.645953270361,0.929241202634,045-AEG,0.141643966136,180,564,744
5481,-0.645953270361,0.929241202634,045-AEI,0.141643966136,148,427,575
5482,-0.645953270361,0.929241202634,045-AEK,0.141643966136,141,384,525
5483,-0.645953270361,0.929241202634,045-AEL,0.141643966136,114,247,361
5484,-0.645953270361,0.929241202634,045-AEO,0.141643966136,106,195,301
5485,-0.645953270361,0.929241202634,045-AEP,0.141643966136,160,231,391
5486,-0.645953270361,0.929241202634,045-AEQ,0.141643966136,97,272,369
5487,-0.645953270361,0.929241202634,045-AER,0.141643966136,50,65,115
5488,-0.645953270361,0.929241202634,045-AES,0.141643966136,124,245,369
5489,-0.645953270361,0.929241202634,045-AET,0.141643966136,197,432,629
5490,-0.645953270361,0.929241202634,045-AEU,0.141643966136,117,292,409
5491,-0.645953270361,0.929241202634,045-AEV,0.141643966136,217,365,582
5492,-0.645953270361,0.929241202634,045-AEW,0.141643966136,123,348,471
5493,-0.645953270361,0.929241202634,045-AEX,0.141643966136,128,269,397
5494,-0.645953270361,0.929241202634,045-AEY,0.141643966136,131,330,461
5495,-0.645953270361,0.929241202634,045-AEZ,0.141643966136,129,381,510
5496,-0.645953270361,0.929241202634,045-AFA,0.141643966136,117,350,467
5497,-0.645953270361,0.929241202634,045-AFB,0.141643966136,58,128,186
5498,-0.645953270361,0.929241202634,045-AFC,0.141643966136,124,381,505
5499,-0.645953270361,0.929241202634,045-AFD,0.141643966136,87,331,418
5500,-0.645953270361,0.929241202634,045-AFE,0.141643966136,210,575,785
5501,-0.645953270361,0.929241202634,045-AFF,0.141643966136,120,261,381
5502,-0.645953270361,0.929241202634,045-AFG,0.141643966136,97,340,437
5503,-0.645953270361,0.929241202634,045-AFH,0.141643966136,151,259,410
5504,-0.645953270361,0.929241202634,045-AFI,0.141643966136,127,192,319
5505,-0.645953270361,0.929241202634,045-AFJ,0.141643966136,105,199,304
5506,-0.645953270361,0.929241202634,045-AFK,0.141643966136,139,209,348
5507,-0.645953270361,0.929241202634,045-AFL,0.141643966136,89,303,392
5508,-0.645953270361,0.929241202634,045-AFM,0.141643966136,213,360,573
5509,-0.645953270361,0.929241202634,045-AFQ,0.141643966136,86,266,352
5510,-0.645953270361,0.929241202634,045-AFR,0.141643966136,219,288,507
5511,-0.645953270361,0.929241202634,045-AFS,0.141643966136,283,445,728
5512,-0.645953270361,0.929241202634,045-AFT,0.141643966136,172,229,401
5513,-0.645953270361,0.929241202634,045-AFU,0.141643966136,336,325,661
5514,-0.645953270361,0.929241202634,045-AFV,0.141643966136,370,327,697
5515,-0.645953270361,0.929241202634,045-AFW,0.141643966136,148,291,439
5516,-0.645953270361,0.929241202634,045-AFX,0.141643966136,127,262,389
5517,-0.645953270361,0.929241202634,045-AFY,0.141643966136,156,412,568
5518,-0.645953270361,0.929241202634,046-AAA,0.141643966136,101,220,321
5519,-0.645953270361,0.929241202634,046-AAB,0.141643966136,133,328,461
5520,-0.645953270361,0.929241202634,046-AAE,0.141643966136,72,230,302
5521,-0.645953270361,0.929241202634,046-AAG,0.141643966136,106,296,402
5522,-0.645953270361,0.929241202634,046-AAH,0.141643966136,56,272,328
5523,-0.645953270361,0.929241202634,046-AAI,0.141643966136,54,181,235
5524,-0.645953270361,0.929241202634,046-AAJ,0.141643966136,58,161,219
5525,-0.645953270361,0.929241202634,046-AAL,0.141643966136,62,75,137
5526,-0.645953270361,0.929241202634,046-AAM,0.141643966136,88,205,293
5527,-0.645953270361,0.929241202634,046-AAN,0.141643966136,108,247,355
5528,-0.645953270361,0.929241202634,046-AAO,0.141643966136,53,69,122
5529,-0.645953270361,0.929241202634,046-AAQ,0.141643966136,28,133,161
5530,-0.645953270361,0.929241202634,046-AAR,0.141643966136,42,180,222
5531,-0.645953270361,0.929241202634,046-AAS,0.141643966136,42,193,235
5532,-0.645953270361,0.929241202634,046-AAT,0.141643966136,106,452,558
5533,-0.645953270361,0.929241202634,046-AAV,0.141643966136,92,341,433
5534,-0.645953270361,0.929241202634,046-AAW,0.141643966136,73,320,393
5535,-0.645953270361,0.929241202634,046-AAX,0.141643966136,33,83,116
5536,-0.645953270361,0.929241202634,046-AAY,0.141643966136,57,192,249
5537,-0.645953270361,0.929241202634,046-AAZ,0.141643966136,91,448,539
5538,-0.645953270361,0.929241202634,046-ABA,0.141643966136,57,257,314
5539,-0.645953270361,0.929241202634,046-ABB,0.141643966136,62,206,268
5540,-0.645953270361,0.929241202634,046-ABC,0.141643966136,21,86,107
5541,-0.645953270361,0.929241202634,046-ABD,0.141643966136,98,437,535
5542,-0.645953270361,0.929241202634,046-ABE,0.141643966136,17,208,225
5543,-0.645953270361,0.929241202634,046-ABF,0.141643966136,40,124,164
5544,-0.645953270361,0.929241202634,046-ABG,0.141643966136,74,295,369
5545,-0.645953270361,0.929241202634,046-ABH,0.141643966136,105,495,600
5546,-0.645953270361,0.929241202634,046-ABI,0.141643966136,73,254,327
5547,-0.645953270361,0.929241202634,046-ABJ,0.141643966136,56,217,273
5548,-0.645953270361,0.929241202634,046-ABK,0.141643966136,54,186,240
5549,-0.645953270361,0.929241202634,046-ABL,0.141643966136,136,394,530
5550,-0.645953270361,0.929241202634,046-ABM,0.141643966136,92,462,554
5551,-0.645953270361,0.929241202634,046-ABN,0.141643966136,43,126,169
5552,-0.645953270361,0.929241202634,046-ABP,0.141643966136,71,134,205
5553,-0.645953270361,0.929241202634,046-ABQ,0.141643966136,69,230,299
5554,-0.645953270361,0.929241202634,046-ABR,0.141643966136,84,249,333
5555,-0.645953270361,0.929241202634,046-ABS,0.141643966136,64,253,317
5556,-0.645953270361,0.929241202634,046-ABT,0.141643966136,62,255,317
5557,-0.645953270361,0.929241202634,046-ABU,0.141643966136,48,293,341
5558,-0.645953270361,0.929241202634,046-ABV,0.141643966136,90,264,354
5559,-0.645953270361,0.929241202634,046-ABW,0.141643966136,57,221,278
5560,-0.645953270361,0.929241202634,046-ABX,0.141643966136,69,196,265
5561,-0.645953270361,0.929241202634,046-ABZ,0.141643966136,99,315,414
5562,-0.645953270361,0.929241202634,047-AAA,0.141643966136,153,224,377
5563,-0.645953270361,0.929241202634,047-AAB,0.141643966136,193,282,475
5564,-0.645953270361,0.929241202634,047-AAC,0.141643966136,166,266,432
5565,-0.645953270361,0.929241202634,047-AAE,0.141643966136,232,249,481
5566,-0.645953270361,0.929241202634,047-AAF,0.141643966136,156,239,395
5567,-0.645953270361,0.929241202634,047-AAG,0.141643966136,135,256,391
5568,-0.645953270361,0.929241202634,047-AAH,0.141643966136,166,145,311
5569,-0.645953270361,0.929241202634,047-AAI,0.141643966136,144,205,349
5570,-0.645953270361,0.929241202634,047-AAJ,0.141643966136,150,151,301
5571,-0.645953270361,0.929241202634,047-AAK,0.141643966136,172,255,427
5572,-0.645953270361,0.929241202634,047-AAL,0.141643966136,162,221,383
5573,-0.645953270361,0.929241202634,047-AAM,0.141643966136,167,165,332
5574,-0.645953270361,0.929241202634,047-AAO,0.141643966136,269,513,782
5575,-0.645953270361,0.929241202634,047-AAP,0.141643966136,134,309,443
5576,-0.645953270361,0.929241202634,047-AAQ,0.141643966136,257,461,718
5577,-0.645953270361,0.929241202634,047-AAR,0.141643966136,252,312,564
5578,-0.645953270361,0.929241202634,047-AAS,0.141643966136,162,375,537
5579,-0.645953270361,0.929241202634,047-AAT,0.141643966136,151,271,422
5580,-0.645953270361,0.929241202634,047-AAU,0.141643966136,243,456,699
5581,-0.645953270361,0.929241202634,047-AAV,0.141643966136,182,535,717
5582,-0.645953270361,0.929241202634,047-AAW,0.141643966136,122,370,492
5583,-0.645953270361,0.929241202634,047-AAX,0.141643966136,165,428,593
5584,-0.645953270361,0.929241202634,047-AAY,0.141643966136,222,628,850
5585,-0.645953270361,0.929241202634,047-AAZ,0.141643966136,171,297,468
5586,-0.645953270361,0.929241202634,047-ABA,0.141643966136,123,330,453
5587,-0.645953270361,0.929241202634,047-ABB,0.141643966136,103,291,394
5588,-0.645953270361,0.929241202634,047-ABC,0.141643966136,102,224,326
5589,-0.645953270361,0.929241202634,047-ABD,0.141643966136,154,572,726
5590,-0.645953270361,0.929241202634,047-ABE,0.141643966136,149,413,562
5591,-0.645953270361,0.929241202634,047-ABF,0.141643966136,121,219,340
5592,-0.645953270361,0.929241202634,047-ABG,0.141643966136,130,203,333
5593,-0.645953270361,0.929241202634,047-ABH,0.141643966136,113,216,329
5594,-0.645953270361,0.929241202634,047-ABI,0.141643966136,147,320,467
5595,-0.645953270361,0.929241202634,047-ABJ,0.141643966136,104,241,345
5596,-0.645953270361,0.929241202634,047-ABK,0.141643966136,133,196,329
5597,-0.645953270361,0.929241202634,047-ABL,0.141643966136,142,198,340
5598,-0.645953270361,0.929241202634,047-ABM,0.141643966136,200,246,446
5599,-0.645953270361,0.929241202634,047-ABN,0.141643966136,140,348,488
5600,-0.645953270361,0.929241202634,047-ABO,0.141643966136,179,386,565
5601,-0.645953270361,0.929241202634,047-ABP,0.141643966136,132,153,285
5602,-0.645953270361,0.929241202634,047-ABQ,0.141643966136,196,181,377
5603,-0.645953270361,0.929241202634,047-ABR,0.141643966136,255,225,480
5604,-0.645953270361,0.929241202634,047-ABS,0.141643966136,150,89,239
5605,-0.645953270361,0.929241202634,047-ABT,0.141643966136,160,165,325
5606,-0.645953270361,0.929241202634,047-ABW,0.141643966136,144,78,222
5607,-0.645953270361,0.929241202634,047-ABX,0.141643966136,201,120,321
5608,-0.645953270361,0.929241202634,047-ABY,0.141643966136,172,75,247
5609,-0.645953270361,0.929241202634,047-ABZ,0.141643966136,273,46,319
5610,-0.645953270361,0.929241202634,047-ACA,0.141643966136,176,103,279
5611,-0.645953270361,0.929241202634,047-ACD,0.141643966136,205,217,422
5612,-0.645953270361,0.929241202634,047-ACE,0.141643966136,263,250,513
5613,-0.645953270361,0.929241202634,047-ACF,0.141643966136,196,230,426
5614,-0.645953270361,0.929241202634,047-ACG,0.141643966136,220,248,468
5615,-0.645953270361,0.929241202634,047-ACH,0.141643966136,132,153,285
5616,-0.645953270361,0.929241202634,047-ACI,0.141643966136,336,430,766
5617,-0.645953270361,0.929241202634,047-ACJ,0.141643966136,212,238,450
5618,-0.645953270361,0.929241202634,047-ACM,0.141643966136,168,251,419
5619,-0.645953270361,0.929241202634,047-ACN,0.141643966136,210,226,436
5620,-0.645953270361,0.929241202634,047-ACO,0.141643966136,197,261,458
5621,-0.645953270361,0.929241202634,047-ACP,0.141643966136,203,259,462
5622,-0.645953270361,0.929241202634,047-ACQ,0.141643966136,202,260,462
5623,-0.645953270361,0.929241202634,047-ACR,0.141643966136,152,149,301
5624,-0.645953270361,0.929241202634,047-ACS,0.141643966136,177,135,312
5625,-0.645953270361,0.929241202634,047-ACW,0.141643966136,111,58,169
5626,-0.645953270361,0.929241202634,047-ACX,0.141643966136,170,106,276
5627,-0.645953270361,0.929241202634,047-ACZ,0.141643966136,212,27,239
5628,-0.645953270361,0.929241202634,047-ADA,0.141643966136,195,101,296
5629,-0.645953270361,0.929241202634,047-ADC,0.141643966136,223,132,355
5630,-0.645953270361,0.929241202634,047-ADD,0.141643966136,142,102,244
5631,-0.645953270361,0.929241202634,047-ADE,0.141643966136,167,40,207
5632,-0.645953270361,0.929241202634,047-ADF,0.141643966136,216,147,363
5633,-0.645953270361,0.929241202634,047-ADG,0.141643966136,187,223,410
5634,-0.645953270361,0.929241202634,047-ADI,0.141643966136,208,157,365
5635,-0.645953270361,0.929241202634,047-ADJ,0.141643966136,219,189,408
5636,-0.645953270361,0.929241202634,047-ADK,0.141643966136,151,196,347
5637,-0.645953270361,0.929241202634,047-ADL,0.141643966136,224,177,401
5638,-0.645953270361,0.929241202634,047-ADM,0.141643966136,163,142,305
5639,-0.645953270361,0.929241202634,047-ADQ,0.141643966136,148,82,230
5640,-0.645953270361,0.929241202634,047-ADR,0.141643966136,180,85,265
5641,-0.645953270361,0.929241202634,047-ADS,0.141643966136,163,110,273
5642,-0.645953270361,0.929241202634,047-ADT,0.141643966136,206,67,273
5643,-0.645953270361,0.929241202634,047-ADU,0.141643966136,153,60,213
5644,-0.645953270361,0.929241202634,047-ADV,0.141643966136,199,138,337
5645,-0.645953270361,0.929241202634,047-ADW,0.141643966136,195,208,403
5646,-0.645953270361,0.929241202634,047-ADX,0.141643966136,144,80,224
5647,-0.645953270361,0.929241202634,047-ADY,0.141643966136,166,96,262
5648,-0.645953270361,0.929241202634,047-ADZ,0.141643966136,195,24,219
5649,-0.645953270361,0.929241202634,047-AEA,0.141643966136,165,38,203
5650,-0.645953270361,0.929241202634,047-AEB,0.141643966136,106,114,220
5651,-0.645953270361,0.929241202634,047-AEC,0.141643966136,169,128,297
5652,-0.645953270361,0.929241202634,047-AEF,0.141643966136,261,97,358
5653,-0.645953270361,0.929241202634,047-AEG,0.141643966136,218,35,253
5654,-0.645953270361,0.929241202634,047-AEH,0.141643966136,210,49,259
5655,-0.645953270361,0.929241202634,047-AEI,0.141643966136,247,152,399
5656,-0.645953270361,0.929241202634,047-AEJ,0.141643966136,241,27,268
5657,-0.645953270361,0.929241202634,047-AEM,0.141643966136,318,204,522
5658,-0.645953270361,0.929241202634,047-AEN,0.141643966136,318,171,489
5659,-0.645953270361,0.929241202634,047-AEO,0.141643966136,163,104,267
5660,-0.645953270361,0.929241202634,047-AEP,0.141643966136,267,170,437
5661,-0.645953270361,0.929241202634,047-AEQ,0.141643966136,214,158,372
5662,-0.645953270361,0.929241202634,047-AER,0.141643966136,120,124,244
5663,-0.645953270361,0.929241202634,047-AEW,0.141643966136,191,32,223
5664,-0.645953270361,0.929241202634,047-AEX,0.141643966136,180,30,210
5665,-0.645953270361,0.929241202634,047-AEY,0.141643966136,126,15,141
5666,-0.645953270361,0.929241202634,047-AEZ,0.141643966136,332,86,418
5667,-0.645953270361,0.929241202634,047-AFA,0.141643966136,281,103,384
5668,-0.645953270361,0.929241202634,047-AFD,0.141643966136,221,83,304
5669,-0.645953270361,0.929241202634,047-AFE,0.141643966136,213,67,280
5670,-0.645953270361,0.929241202634,047-AFF,0.141643966136,186,90,276
5671,-0.645953270361,0.929241202634,047-AFG,0.141643966136,210,61,271
5672,-0.645953270361,0.929241202634,047-AFH,0.141643966136,198,104,302
5673,-0.645953270361,0.929241202634,047-AFI,0.141643966136,193,106,299
5674,-0.645953270361,0.929241202634,047-AFL,0.141643966136,134,85,219
5675,-0.645953270361,0.929241202634,047-AFM,0.141643966136,159,120,279
5676,-0.645953270361,0.929241202634,047-AFN,0.141643966136,147,63,210
5677,-0.645953270361,0.929241202634,047-AFO,0.141643966136,246,145,391
5678,-0.645953270361,0.929241202634,047-AFP,0.141643966136,253,64,317
5679,-0.645953270361,0.929241202634,047-AFQ,0.141643966136,236,147,383
5680,-0.645953270361,0.929241202634,047-AFR,0.141643966136,144,114,258
5681,-0.645953270361,0.929241202634,047-AFU,0.141643966136,300,306,606
5682,-0.645953270361,0.929241202634,047-AFV,0.141643966136,249,123,372
5683,-0.645953270361,0.929241202634,047-AFW,0.141643966136,192,107,299
5684,-0.645953270361,0.929241202634,047-AFX,0.141643966136,317,185,502
5685,-0.645953270361,0.929241202634,047-AFY,0.141643966136,158,135,293
5686,-0.645953270361,0.929241202634,047-AFZ,0.141643966136,321,302,623
5687,-0.645953270361,0.929241202634,047-AGA,0.141643966136,220,155,375
5688,-0.645953270361,0.929241202634,047-AGB,0.141643966136,287,233,520
5689,-0.645953270361,0.929241202634,047-AGC,0.141643966136,190,266,456
5690,-0.645953270361,0.929241202634,047-AGN,0.141643966136,210,271,481
5691,-0.645953270361,0.929241202634,047-AGO,0.141643966136,140,316,456
5692,-0.645953270361,0.929241202634,047-AGP,0.141643966136,211,351,562
5693,-0.645953270361,0.929241202634,047-AGQ,0.141643966136,151,231,382
5694,-0.645953270361,0.929241202634,047-AGS,0.141643966136,174,181,355
5695,-0.645953270361,0.929241202634,047-AGT,0.141643966136,100,143,243
5696,-0.645953270361,0.929241202634,047-AGU,0.141643966136,141,170,311
5697,-0.645953270361,0.929241202634,047-AGV,0.141643966136,141,239,380
5698,-0.645953270361,0.929241202634,047-AGY,0.141643966136,171,269,440
5699,-0.645953270361,0.929241202634,047-AGZ,0.141643966136,169,204,373
5700,-0.645953270361,0.929241202634,047-AHA,0.141643966136,258,585,843
5701,-0.645953270361,0.929241202634,047-AHB,0.141643966136,207,316,523
5702,-0.645953270361,0.929241202634,047-AHC,0.141643966136,139,194,333
5703,-0.645953270361,0.929241202634,047-AHD,0.141643966136,125,223,348
5704,-0.645953270361,0.929241202634,047-AHE,0.141643966136,169,279,448
5705,-0.645953270361,0.929241202634,047-AHF,0.141643966136,159,308,467
5706,-0.645953270361,0.929241202634,047-AHG,0.141643966136,137,173,310
5707,-0.645953270361,0.929241202634,047-AHI,0.141643966136,358,68,426
5708,-0.645953270361,0.929241202634,047-AHJ,0.141643966136,310,52,362
5709,-0.645953270361,0.929241202634,047-AHK,0.141643966136,473,96,569
5710,-0.645953270361,0.929241202634,047-AHL,0.141643966136,305,80,385
5711,-0.645953270361,0.929241202634,047-AHM,0.141643966136,185,27,212
5712,-0.645953270361,0.929241202634,047-AHO,0.141643966136,231,10,241
5713,-0.645953270361,0.929241202634,047-AHP,0.141643966136,176,179,355
5714,-0.645953270361,0.929241202634,047-AHQ,0.141643966136,132,141,273
5715,-0.645953270361,0.929241202634,047-AHR,0.141643966136,167,145,312
5716,-0.645953270361,0.929241202634,047-AHS,0.141643966136,160,144,304
5717,-0.645953270361,0.929241202634,047-AHT,0.141643966136,152,148,300
5718,-0.645953270361,0.929241202634,047-AHU,0.141643966136,108,139,247
5719,-0.645953270361,0.929241202634,047-AHV,0.141643966136,173,211,384
5720,-0.645953270361,0.929241202634,047-AHW,0.141643966136,137,172,309
5721,-0.645953270361,0.929241202634,047-AHX,0.141643966136,140,238,378
5722,-0.645953270361,0.929241202634,047-AHY,0.141643966136,37,95,132
5723,-0.645953270361,0.929241202634,047-AHZ,0.141643966136,136,136,272
5724,-0.645953270361,0.929241202634,047-AIA,0.141643966136,159,196,355
5725,-0.645953270361,0.929241202634,047-AIB,0.141643966136,192,290,482
5726,-0.645953270361,0.929241202634,047-AIC,0.141643966136,148,209,357
5727,-0.645953270361,0.929241202634,047-AIE,0.141643966136,187,297,484
5728,-0.645953270361,0.929241202634,047-AIF,0.141643966136,226,311,537
5729,-0.645953270361,0.929241202634,047-AIG,0.141643966136,161,246,407
5730,-0.645953270361,0.929241202634,047-AIH,0.141643966136,179,239,418
5731,-0.645953270361,0.929241202634,047-AIK,0.141643966136,132,181,313
5732,-0.645953270361,0.929241202634,047-AIL,0.141643966136,122,163,285
5733,-0.645953270361,0.929241202634,047-AIM,0.141643966136,118,261,379
5734,-0.645953270361,0.929241202634,047-AIN,0.141643966136,248,422,670
5735,-0.645953270361,0.929241202634,047-AIO,0.141643966136,224,382,606
5736,-0.645953270361,0.929241202634,047-AIQ,0.141643966136,158,226,384
5737,-0.645953270361,0.929241202634,047-AIR,0.141643966136,144,171,315
5738,-0.645953270361,0.929241202634,047-AIS,0.141643966136,155,228,383
5739,-0.645953270361,0.929241202634,047-AIT,0.141643966136,184,353,537
5740,-0.645953270361,0.929241202634,047-AIU,0.141643966136,134,199,333
5741,-0.645953270361,0.929241202634,047-AIV,0.141643966136,107,303,410
5742,-0.645953270361,0.929241202634,047-AIW,0.141643966136,133,246,379
5743,-0.645953270361,0.929241202634,047-AIZ,0.141643966136,134,179,313
5744,-0.645953270361,0.929241202634,047-AJA,0.141643966136,165,301,466
5745,-0.645953270361,0.929241202634,047-AJB,0.141643966136,187,293,480
5746,-0.645953270361,0.929241202634,047-AJC,0.141643966136,159,284,443
5747,-0.645953270361,0.929241202634,047-AJD,0.141643966136,180,367,547
5748,-0.645953270361,0.929241202634,047-AJE,0.141643966136,154,289,443
5749,-0.645953270361,0.929241202634,047-AJF,0.141643966136,143,265,408
5750,-0.645953270361,0.929241202634,047-AJG,0.141643966136,164,209,373
5751,-0.645953270361,0.929241202634,047-AJH,0.141643966136,162,271,433
5752,-0.645953270361,0.929241202634,047-AJI,0.141643966136,138,296,434
5753,-0.645953270361,0.929241202634,047-AJJ,0.141643966136,148,131,279
5754,-0.645953270361,0.929241202634,047-AJL,0.141643966136,174,172,346
5755,-0.645953270361,0.929241202634,047-AJM,0.141643966136,192,201,393
5756,-0.645953270361,0.929241202634,047-AJN,0.141643966136,177,192,369
5757,-0.645953270361,0.929241202634,047-AJP,0.141643966136,191,387,578
5758,-0.645953270361,0.929241202634,047-AJQ,0.141643966136,159,346,505
5759,-0.645953270361,0.929241202634,047-AJR,0.141643966136,128,210,338
5760,-0.645953270361,0.929241202634,047-AJT,0.141643966136,192,298,490
5761,-0.645953270361,0.929241202634,047-AJV,0.141643966136,130,241,371
5762,-0.645953270361,0.929241202634,047-AJW,0.141643966136,124,212,336
5763,-0.645953270361,0.929241202634,047-AJX,0.141643966136,164,314,478
5764,-0.645953270361,0.929241202634,047-AJY,0.141643966136,166,226,392
5765,-0.645953270361,0.929241202634,047-AJZ,0.141643966136,149,302,451
5766,-0.645953270361,0.929241202634,047-AKA,0.141643966136,153,336,489
5767,-0.645953270361,0.929241202634,047-AKB,0.141643966136,210,409,619
5768,-0.645953270361,0.929241202634,047-AKC,0.141643966136,277,406,683
5769,-0.645953270361,0.929241202634,047-AKD,0.141643966136,240,413,653
5770,-0.645953270361,0.929241202634,047-AKE,0.141643966136,100,182,282
5771,-0.645953270361,0.929241202634,047-AKF,0.141643966136,185,166,351
5772,-0.645953270361,0.929241202634,047-AKG,0.141643966136,162,195,357
5773,-0.645953270361,0.929241202634,047-AKH,0.141643966136,164,114,278
5774,-0.645953270361,0.929241202634,047-AKI,0.141643966136,196,119,315
5775,-0.645953270361,0.929241202634,047-AKK,0.141643966136,166,108,274
5776,-0.645953270361,0.929241202634,047-AKL,0.141643966136,194,261,455
5777,-0.645953270361,0.929241202634,047-AKM,0.141643966136,235,298,533
5778,-0.645953270361,0.929241202634,047-AKN,0.141643966136,182,380,562
5779,-0.645953270361,0.929241202634,047-AKO,0.141643966136,194,285,479
5780,-0.645953270361,0.929241202634,047-AKP,0.141643966136,169,265,434
5781,-0.645953270361,0.929241202634,047-AKQ,0.141643966136,185,280,465
5782,-0.645953270361,0.929241202634,047-AKS,0.141643966136,248,51,299
5783,-0.645953270361,0.929241202634,047-AKT,0.141643966136,172,282,454
5784,-0.645953270361,0.929241202634,047-AKU,0.141643966136,258,474,732
5785,-0.645953270361,0.929241202634,047-AKV,0.141643966136,130,548,678
5786,-0.645953270361,0.929241202634,047-AKY,0.141643966136,206,437,643
5787,-0.645953270361,0.929241202634,047-AKZ,0.141643966136,239,559,798
5788,-0.645953270361,0.929241202634,047-ALA,0.141643966136,142,165,307
5789,-0.645953270361,0.929241202634,047-ALC,0.141643966136,201,302,503
5790,-0.645953270361,0.929241202634,047-ALD,0.141643966136,131,249,380
5791,-0.645953270361,0.929241202634,047-ALE,0.141643966136,200,297,497
5792,-0.645953270361,0.929241202634,047-ALF,0.141643966136,315,24,339
5793,-0.645953270361,0.929241202634,047-ALG,0.141643966136,194,405,599
5794,-0.645953270361,0.929241202634,047-AND,0.141643966136,192,166,358
5795,-0.645953270361,0.929241202634,048-AAA,0.141643966136,169,213,382
5796,-0.645953270361,0.929241202634,048-AAB,0.141643966136,213,307,520
5797,-0.645953270361,0.929241202634,048-AAC,0.141643966136,228,235,463
5798,-0.645953270361,0.929241202634,048-AAD,0.141643966136,236,237,473
5799,-0.645953270361,0.929241202634,048-AAL,0.141643966136,183,182,365
5800,-0.645953270361,0.929241202634,048-AAO,0.141643966136,260,333,593
5801,-0.645953270361,0.929241202634,048-AAP,0.141643966136,136,207,343
5802,-0.645953270361,0.929241202634,048-AAQ,0.141643966136,217,271,488
5803,-0.645953270361,0.929241202634,048-AAR,0.141643966136,171,148,319
5804,-0.645953270361,0.929241202634,048-AAS,0.141643966136,219,289,508
5805,-0.645953270361,0.929241202634,048-AAT,0.141643966136,206,231,437
5806,-0.645953270361,0.929241202634,048-AAU,0.141643966136,229,283,512
5807,-0.645953270361,0.929241202634,048-AAV,0.141643966136,185,211,396
5808,-0.645953270361,0.929241202634,048-AAW,0.141643966136,196,139,335
5809,-0.645953270361,0.929241202634,048-AAX,0.141643966136,201,181,382
5810,-0.645953270361,0.929241202634,048-AAY,0.141643966136,210,160,370
5811,-0.645953270361,0.929241202634,048-AAZ,0.141643966136,259,203,462
5812,-0.645953270361,0.929241202634,048-ABA,0.141643966136,222,241,463
5813,-0.645953270361,0.929241202634,048-ABB,0.141643966136,280,266,546
5814,-0.645953270361,0.929241202634,048-ABC,0.141643966136,264,276,540
5815,-0.645953270361,0.929241202634,048-ABD,0.141643966136,197,146,343
5816,-0.645953270361,0.929241202634,048-ABG,0.141643966136,230,199,429
5817,-0.645953270361,0.929241202634,048-ABK,0.141643966136,217,184,401
5818,-0.645953270361,0.929241202634,048-ABL,0.141643966136,252,198,450
5819,-0.645953270361,0.929241202634,048-ABM,0.141643966136,263,358,621
5820,-0.645953270361,0.929241202634,048-ABN,0.141643966136,279,183,462
5821,-0.645953270361,0.929241202634,048-ABO,0.141643966136,323,277,600
5822,-0.645953270361,0.929241202634,048-ABP,0.141643966136,203,188,391
5823,-0.645953270361,0.929241202634,048-ABQ,0.141643966136,255,191,446
5824,-0.645953270361,0.929241202634,048-ABR,0.141643966136,222,455,677
5825,-0.645953270361,0.929241202634,048-ABS,0.141643966136,133,335,468
5826,-0.645953270361,0.929241202634,048-ABT,0.141643966136,164,360,524
5827,-0.645953270361,0.929241202634,048-ABU,0.141643966136,223,257,480
5828,-0.645953270361,0.929241202634,048-ABV,0.141643966136,205,405,610
5829,-0.645953270361,0.929241202634,048-ABW,0.141643966136,158,190,348
5830,-0.645953270361,0.929241202634,048-ABX,0.141643966136,137,168,305
5831,-0.645953270361,0.929241202634,048-ABY,0.141643966136,171,179,350
5832,-0.645953270361,0.929241202634,048-ACC,0.141643966136,244,340,584
5833,-0.645953270361,0.929241202634,048-ACI,0.141643966136,213,312,525
5834,-0.645953270361,0.929241202634,048-ACJ,0.141643966136,216,315,531
5835,-0.645953270361,0.929241202634,048-ACK,0.141643966136,117,352,469
5836,-0.645953270361,0.929241202634,048-ACL,0.141643966136,183,194,377
5837,-0.645953270361,0.929241202634,048-ACM,0.141643966136,163,224,387
5838,-0.645953270361,0.929241202634,048-ACO,0.141643966136,194,274,468
5839,-0.645953270361,0.929241202634,048-ACP,0.141643966136,262,233,495
5840,-0.645953270361,0.929241202634,048-ACR,0.141643966136,207,191,398
5841,-0.645953270361,0.929241202634,048-ACS,0.141643966136,236,161,397
5842,-0.645953270361,0.929241202634,048-ACT,0.141643966136,162,48,210
5843,-0.645953270361,0.929241202634,048-ACU,0.141643966136,253,217,470
5844,-0.645953270361,0.929241202634,048-ACV,0.141643966136,261,198,459
5845,-0.645953270361,0.929241202634,048-ACW,0.141643966136,215,182,397
5846,-0.645953270361,0.929241202634,048-ACX,0.141643966136,243,180,423
5847,-0.645953270361,0.929241202634,048-ACY,0.141643966136,233,180,413
5848,-0.645953270361,0.929241202634,048-ADA,0.141643966136,163,95,258
5849,-0.645953270361,0.929241202634,048-ADD,0.141643966136,136,146,282
5850,-0.645953270361,0.929241202634,048-ADG,0.141643966136,99,37,136
5851,-0.645953270361,0.929241202634,048-ADH,0.141643966136,150,31,181
5852,-0.645953270361,0.929241202634,048-ADI,0.141643966136,80,45,125
5853,-0.645953270361,0.929241202634,048-ADK,0.141643966136,149,74,223
5854,-0.645953270361,0.929241202634,048-ADM,0.141643966136,127,26,153
5855,-0.645953270361,0.929241202634,048-ADO,0.141643966136,75,9,84
5856,-0.645953270361,0.929241202634,048-ADP,0.141643966136,121,22,143
5857,-0.645953270361,0.929241202634,048-ADQ,0.141643966136,143,30,173
5858,-0.645953270361,0.929241202634,048-ADR,0.141643966136,94,18,112
5859,-0.645953270361,0.929241202634,048-ADT,0.141643966136,123,84,207
5860,-0.645953270361,0.929241202634,048-ADU,0.141643966136,205,130,335
5861,-0.645953270361,0.929241202634,048-ADV,0.141643966136,134,41,175
5862,-0.645953270361,0.929241202634,048-ADW,0.141643966136,141,139,280
5863,-0.645953270361,0.929241202634,048-ADX,0.141643966136,221,192,413
5864,-0.645953270361,0.929241202634,048-ADY,0.141643966136,139,104,243
5865,-0.645953270361,0.929241202634,048-ADZ,0.141643966136,179,175,354
5866,-0.645953270361,0.929241202634,048-AEA,0.141643966136,136,104,240
5867,-0.645953270361,0.929241202634,048-AEC,0.141643966136,104,53,157
5868,-0.645953270361,0.929241202634,048-AED,0.141643966136,175,158,333
5869,-0.645953270361,0.929241202634,048-AEE,0.141643966136,197,116,313
5870,-0.645953270361,0.929241202634,048-AEF,0.141643966136,222,175,397
5871,-0.645953270361,0.929241202634,048-AEG,0.141643966136,137,114,251
5872,-0.645953270361,0.929241202634,048-AEH,0.141643966136,160,140,300
5873,-0.645953270361,0.929241202634,048-AEM,0.141643966136,127,119,246
5874,-0.645953270361,0.929241202634,048-AEO,0.141643966136,225,29,254
5875,-0.645953270361,0.929241202634,048-AEP,0.141643966136,242,56,298
5876,-0.645953270361,0.929241202634,048-AER,0.141643966136,179,34,213
5877,-0.645953270361,0.929241202634,048-AES,0.141643966136,318,50,368
5878,-0.645953270361,0.929241202634,048-AET,0.141643966136,208,42,250
5879,-0.645953270361,0.929241202634,048-AEU,0.141643966136,218,15,233
5880,-0.645953270361,0.929241202634,048-AEV,0.141643966136,274,31,305
5881,-0.645953270361,0.929241202634,048-AEW,0.141643966136,215,18,233
5882,-0.645953270361,0.929241202634,048-AEX,0.141643966136,214,44,258
5883,-0.645953270361,0.929241202634,048-AEY,0.141643966136,213,15,228
5884,-0.645953270361,0.929241202634,048-AFF,0.141643966136,259,134,393
5885,-0.645953270361,0.929241202634,048-AFG,0.141643966136,313,220,533
5886,-0.645953270361,0.929241202634,048-AFH,0.141643966136,217,171,388
5887,-0.645953270361,0.929241202634,048-AFI,0.141643966136,307,167,474
5888,-0.645953270361,0.929241202634,048-AFJ,0.141643966136,219,131,350
5889,-0.645953270361,0.929241202634,048-AFK,0.141643966136,174,132,306
5890,-0.645953270361,0.929241202634,048-AFL,0.141643966136,250,157,407
5891,-0.645953270361,0.929241202634,048-AFM,0.141643966136,245,104,349
5892,-0.645953270361,0.929241202634,048-AFN,0.141643966136,214,189,403
5893,-0.645953270361,0.929241202634,048-AFO,0.141643966136,258,106,364
5894,-0.645953270361,0.929241202634,048-AFP,0.141643966136,264,207,471
5895,-0.645953270361,0.929241202634,048-AFV,0.141643966136,483,67,550
5896,-0.645953270361,0.929241202634,048-AFW,0.141643966136,372,70,442
5897,-0.645953270361,0.929241202634,048-AFX,0.141643966136,415,65,480
5898,-0.645953270361,0.929241202634,048-AFY,0.141643966136,141,46,187
5899,-0.645953270361,0.929241202634,048-AFZ,0.141643966136,219,118,337
5900,-0.645953270361,0.929241202634,048-AGA,0.141643966136,231,15,246
5901,-0.645953270361,0.929241202634,048-AGB,0.141643966136,363,48,411
5902,-0.645953270361,0.929241202634,048-AGC,0.141643966136,383,38,421
5903,-0.645953270361,0.929241202634,048-AGD,0.141643966136,420,23,443
5904,-0.645953270361,0.929241202634,048-AGE,0.141643966136,337,46,383
5905,-0.645953270361,0.929241202634,048-AGF,0.141643966136,190,25,215
5906,-0.645953270361,0.929241202634,048-AGL,0.141643966136,168,183,351
5907,-0.645953270361,0.929241202634,048-AGM,0.141643966136,163,23,186
5908,-0.645953270361,0.929241202634,048-AGN,0.141643966136,258,328,586
5909,-0.645953270361,0.929241202634,048-AGO,0.141643966136,285,364,649
5910,-0.645953270361,0.929241202634,048-AGP,0.141643966136,175,145,320
5911,-0.645953270361,0.929241202634,048-AGR,0.141643966136,256,320,576
5912,-0.645953270361,0.929241202634,048-AGT,0.141643966136,194,178,372
5913,-0.645953270361,0.929241202634,048-AGZ,0.141643966136,266,272,538
5914,-0.645953270361,0.929241202634,048-AHA,0.141643966136,173,172,345
5915,-0.645953270361,0.929241202634,048-AHB,0.141643966136,188,41,229
5916,-0.645953270361,0.929241202634,048-AHC,0.141643966136,321,8,329
5917,-0.645953270361,0.929241202634,048-AHD,0.141643966136,317,9,326
5918,-0.645953270361,0.929241202634,048-AHE,0.141643966136,339,12,351
5919,-0.645953270361,0.929241202634,048-AHG,0.141643966136,306,10,316
5920,-0.645953270361,0.929241202634,048-AHH,0.141643966136,213,53,266
5921,-0.645953270361,0.929241202634,048-AHI,0.141643966136,268,10,278
5922,-0.645953270361,0.929241202634,048-AHJ,0.141643966136,156,37,193
5923,-0.645953270361,0.929241202634,048-AHR,0.141643966136,248,131,379
5924,-0.645953270361,0.929241202634,048-AHT,0.141643966136,253,139,392
5925,-0.645953270361,0.929241202634,048-AHU,0.141643966136,260,114,374
5926,-0.645953270361,0.929241202634,048-AHV,0.141643966136,161,101,262
5927,-0.645953270361,0.929241202634,048-AHW,0.141643966136,91,66,157
5928,-0.645953270361,0.929241202634,048-AHX,0.141643966136,265,175,440
5929,-0.645953270361,0.929241202634,048-AHY,0.141643966136,165,119,284
5930,-0.645953270361,0.929241202634,048-AHZ,0.141643966136,186,79,265
5931,-0.645953270361,0.929241202634,048-AIA,0.141643966136,248,197,445
5932,-0.645953270361,0.929241202634,048-AIJ,0.141643966136,267,31,298
5933,-0.645953270361,0.929241202634,048-AIL,0.141643966136,257,31,288
5934,-0.645953270361,0.929241202634,048-AIM,0.141643966136,219,10,229
5935,-0.645953270361,0.929241202634,048-AIN,0.141643966136,296,16,312
5936,-0.645953270361,0.929241202634,048-AIO,0.141643966136,186,12,198
5937,-0.645953270361,0.929241202634,048-AIP,0.141643966136,314,77,391
5938,-0.645953270361,0.929241202634,048-AIR,0.141643966136,332,50,382
5939,-0.645953270361,0.929241202634,048-AIS,0.141643966136,312,25,337
5940,-0.645953270361,0.929241202634,048-AIW,0.141643966136,313,69,382
5941,-0.645953270361,0.929241202634,048-AIY,0.141643966136,192,131,323
5942,-0.645953270361,0.929241202634,048-AIZ,0.141643966136,141,99,240
5943,-0.645953270361,0.929241202634,048-AJA,0.141643966136,250,178,428
5944,-0.645953270361,0.929241202634,048-AJB,0.141643966136,183,135,318
5945,-0.645953270361,0.929241202634,048-AJD,0.141643966136,186,168,354
5946,-0.645953270361,0.929241202634,048-AJE,0.141643966136,205,156,361
5947,-0.645953270361,0.929241202634,048-AJF,0.141643966136,139,123,262
5948,-0.645953270361,0.929241202634,048-AJP,0.141643966136,226,129,355
5949,-0.645953270361,0.929241202634,048-AJQ,0.141643966136,317,238,555
5950,-0.645953270361,0.929241202634,048-AJR,0.141643966136,323,127,450
5951,-0.645953270361,0.929241202634,048-AJS,0.141643966136,237,179,416
5952,-0.645953270361,0.929241202634,048-AJV,0.141643966136,168,115,283
5953,-0.645953270361,0.929241202634,048-AJW,0.141643966136,206,130,336
5954,-0.645953270361,0.929241202634,048-AJX,0.141643966136,350,307,657
5955,-0.645953270361,0.929241202634,048-AJY,0.141643966136,160,77,237
5956,-0.645953270361,0.929241202634,048-AJZ,0.141643966136,227,157,384
5957,-0.645953270361,0.929241202634,048-AKD,0.141643966136,62,40,102
5958,-0.645953270361,0.929241202634,048-AKE,0.141643966136,287,159,446
5959,-0.645953270361,0.929241202634,048-AKJ,0.141643966136,244,9,253
5960,-0.645953270361,0.929241202634,048-AKK,0.141643966136,443,47,490
5961,-0.645953270361,0.929241202634,048-AKL,0.141643966136,262,6,268
5962,-0.645953270361,0.929241202634,048-AKM,0.141643966136,275,21,296
5963,-0.645953270361,0.929241202634,048-AKN,0.141643966136,201,9,210
5964,-0.645953270361,0.929241202634,048-AKP,0.141643966136,347,29,376
5965,-0.645953270361,0.929241202634,048-AKQ,0.141643966136,320,6,326
5966,-0.645953270361,0.929241202634,048-AKW,0.141643966136,251,56,307
5967,-0.645953270361,0.929241202634,048-ALA,0.141643966136,324,12,336
5968,-0.645953270361,0.929241202634,048-ALB,0.141643966136,306,7,313
5969,-0.645953270361,0.929241202634,048-ALC,0.141643966136,335,12,347
5970,-0.645953270361,0.929241202634,048-ALD,0.141643966136,396,33,429
5971,-0.645953270361,0.929241202634,048-ALF,0.141643966136,283,5,288
5972,-0.645953270361,0.929241202634,048-ALG,0.141643966136,249,4,253
5973,-0.645953270361,0.929241202634,048-ALM,0.141643966136,291,15,306
5974,-0.645953270361,0.929241202634,048-ALQ,0.141643966136,209,105,314
5975,-0.645953270361,0.929241202634,048-ALR,0.141643966136,269,262,531
5976,-0.645953270361,0.929241202634,048-ALS,0.141643966136,243,157,400
5977,-0.645953270361,0.929241202634,048-ALT,0.141643966136,270,142,412
5978,-0.645953270361,0.929241202634,048-ALU,0.141643966136,227,234,461
5979,-0.645953270361,0.929241202634,048-ALV,0.141643966136,261,172,433
5980,-0.645953270361,0.929241202634,048-ALW,0.141643966136,175,86,261
5981,-0.645953270361,0.929241202634,048-ALX,0.141643966136,109,66,175
5982,-0.645953270361,0.929241202634,048-ALY,0.141643966136,180,86,266
5983,-0.645953270361,0.929241202634,048-AMF,0.141643966136,74,11,85
5984,-0.645953270361,0.929241202634,048-AMG,0.141643966136,240,279,519
5985,-0.645953270361,0.929241202634,048-AMH,0.141643966136,242,183,425
5986,-0.645953270361,0.929241202634,048-AMI,0.141643966136,133,172,305
5987,-0.645953270361,0.929241202634,048-AMJ,0.141643966136,253,243,496
5988,-0.645953270361,0.929241202634,048-AMK,0.141643966136,230,167,397
5989,-0.645953270361,0.929241202634,048-AMN,0.141643966136,256,369,625
5990,-0.645953270361,0.929241202634,048-AMO,0.141643966136,192,101,293
5991,-0.645953270361,0.929241202634,048-AMP,0.141643966136,299,307,606
5992,-0.645953270361,0.929241202634,048-AMX,0.141643966136,148,115,263
5993,-0.645953270361,0.929241202634,048-AMZ,0.141643966136,182,83,265
5994,-0.645953270361,0.929241202634,048-ANA,0.141643966136,147,42,189
5995,-0.645953270361,0.929241202634,048-ANB,0.141643966136,149,55,204
5996,-0.645953270361,0.929241202634,048-AND,0.141643966136,122,64,186
5997,-0.645953270361,0.929241202634,048-ANE,0.141643966136,159,50,209
5998,-0.645953270361,0.929241202634,048-ANF,0.141643966136,123,62,185
5999,-0.645953270361,0.929241202634,048-ANG,0.141643966136,93,27,120
6000,-0.645953270361,0.929241202634,048-ANJ,0.141643966136,92,34,126
6001,-0.645953270361,0.929241202634,048-ANO,0.141643966136,146,73,219
6002,-0.645953270361,0.929241202634,048-ANP,0.141643966136,166,86,252
6003,-0.645953270361,0.929241202634,048-ANQ,0.141643966136,85,14,99
6004,-0.645953270361,0.929241202634,048-ANR,0.141643966136,192,86,278
6005,-0.645953270361,0.929241202634,048-ANS,0.141643966136,216,136,352
6006,-0.645953270361,0.929241202634,048-ANT,0.141643966136,191,80,271
6007,-0.645953270361,0.929241202634,048-ANY,0.141643966136,123,41,164
6008,-0.645953270361,0.929241202634,048-ANZ,0.141643966136,144,71,215
6009,-0.645953270361,0.929241202634,048-AOB,0.141643966136,144,96,240
6010,-0.645953270361,0.929241202634,048-AOC,0.141643966136,149,57,206
6011,-0.645953270361,0.929241202634,048-AOD,0.141643966136,122,74,196
6012,-0.645953270361,0.929241202634,048-AOG,0.141643966136,132,90,222
6013,-0.645953270361,0.929241202634,048-AOJ,0.141643966136,152,67,219
6014,-0.645953270361,0.929241202634,048-AOL,0.141643966136,141,33,174
6015,-0.645953270361,0.929241202634,048-AOM,0.141643966136,243,126,369
6016,-0.645953270361,0.929241202634,048-AON,0.141643966136,178,76,254
6017,-0.645953270361,0.929241202634,048-AOO,0.141643966136,188,105,293
6018,-0.645953270361,0.929241202634,048-AOP,0.141643966136,119,48,167
6019,-0.645953270361,0.929241202634,048-AOS,0.141643966136,222,71,293
6020,-0.645953270361,0.929241202634,048-AOU,0.141643966136,234,202,436
6021,-0.645953270361,0.929241202634,048-AOV,0.141643966136,206,201,407
6022,-0.645953270361,0.929241202634,048-AOW,0.141643966136,204,226,430
6023,-0.645953270361,0.929241202634,048-AOX,0.141643966136,235,265,500
6024,-0.645953270361,0.929241202634,048-AOY,0.141643966136,184,191,375
6025,-0.645953270361,0.929241202634,048-AOZ,0.141643966136,155,143,298
6026,-0.645953270361,0.929241202634,048-APA,0.141643966136,262,262,524
6027,-0.645953270361,0.929241202634,048-APB,0.141643966136,234,235,469
6028,-0.645953270361,0.929241202634,048-APK,0.141643966136,215,209,424
6029,-0.645953270361,0.929241202634,048-APL,0.141643966136,211,246,457
6030,-0.645953270361,0.929241202634,048-APP,0.141643966136,260,242,502
6031,-0.645953270361,0.929241202634,048-APQ,0.141643966136,194,179,373
6032,-0.645953270361,0.929241202634,048-APR,0.141643966136,270,282,552
6033,-0.645953270361,0.929241202634,048-APS,0.141643966136,210,238,448
6034,-0.645953270361,0.929241202634,048-APT,0.141643966136,195,226,421
6035,-0.645953270361,0.929241202634,048-APU,0.141643966136,161,207,368
6036,-0.645953270361,0.929241202634,048-APV,0.141643966136,227,267,494
6037,-0.645953270361,0.929241202634,048-APW,0.141643966136,217,252,469
6038,-0.645953270361,0.929241202634,048-APX,0.141643966136,176,118,294
6039,-0.645953270361,0.929241202634,048-AQG,0.141643966136,256,182,438
6040,-0.645953270361,0.929241202634,048-AQH,0.141643966136,268,277,545
6041,-0.645953270361,0.929241202634,048-AQI,0.141643966136,247,198,445
6042,-0.645953270361,0.929241202634,048-AQJ,0.141643966136,225,142,367
6043,-0.645953270361,0.929241202634,048-AQK,0.141643966136,236,301,537
6044,-0.645953270361,0.929241202634,048-AQL,0.141643966136,123,95,218
6045,-0.645953270361,0.929241202634,048-AQM,0.141643966136,204,210,414
6046,-0.645953270361,0.929241202634,048-AQN,0.141643966136,228,234,462
6047,-0.645953270361,0.929241202634,048-AQO,0.141643966136,215,141,356
6048,-0.645953270361,0.929241202634,048-AQP,0.141643966136,255,262,517
6049,-0.645953270361,0.929241202634,048-AQQ,0.141643966136,175,267,442
6050,-0.645953270361,0.929241202634,048-AQR,0.141643966136,176,187,363
6051,-0.645953270361,0.929241202634,048-AQZ,0.141643966136,118,111,229
6052,-0.645953270361,0.929241202634,048-ARA,0.141643966136,103,69,172
6053,-0.645953270361,0.929241202634,048-ARB,0.141643966136,225,208,433
6054,-0.645953270361,0.929241202634,048-ARD,0.141643966136,263,204,467
6055,-0.645953270361,0.929241202634,048-ARE,0.141643966136,271,105,376
6056,-0.645953270361,0.929241202634,048-ARF,0.141643966136,260,306,566
6057,-0.645953270361,0.929241202634,048-ARG,0.141643966136,164,146,310
6058,-0.645953270361,0.929241202634,048-ARH,0.141643966136,254,104,358
6059,-0.645953270361,0.929241202634,048-ARI,0.141643966136,239,249,488
6060,-0.645953270361,0.929241202634,048-ARJ,0.141643966136,255,141,396
6061,-0.645953270361,0.929241202634,048-ARK,0.141643966136,164,201,365
6062,-0.645953270361,0.929241202634,048-ARO,0.141643966136,174,78,252
6063,-0.645953270361,0.929241202634,048-ARQ,0.141643966136,113,196,309
6064,-0.645953270361,0.929241202634,048-ARR,0.141643966136,209,242,451
6065,-0.645953270361,0.929241202634,048-ARS,0.141643966136,246,202,448
6066,-0.645953270361,0.929241202634,048-ART,0.141643966136,171,120,291
6067,-0.645953270361,0.929241202634,048-ARV,0.141643966136,162,424,586
6068,-0.645953270361,0.929241202634,048-ARW,0.141643966136,341,656,997
6069,-0.645953270361,0.929241202634,048-ARX,0.141643966136,159,419,578
6070,-0.645953270361,0.929241202634,048-ARY,0.141643966136,102,208,310
6071,-0.645953270361,0.929241202634,048-ARZ,0.141643966136,133,297,430
6072,-0.645953270361,0.929241202634,048-ASA,0.141643966136,267,379,646
6073,-0.645953270361,0.929241202634,048-ASB,0.141643966136,109,282,391
6074,-0.645953270361,0.929241202634,048-ASC,0.141643966136,214,422,636
6075,-0.645953270361,0.929241202634,048-ASD,0.141643966136,298,329,627
6076,-0.645953270361,0.929241202634,048-ASH,0.141643966136,159,239,398
6077,-0.645953270361,0.929241202634,048-ASI,0.141643966136,162,311,473
6078,-0.645953270361,0.929241202634,048-ASJ,0.141643966136,111,266,377
6079,-0.645953270361,0.929241202634,048-ASK,0.141643966136,273,435,708
6080,-0.645953270361,0.929241202634,048-ASM,0.141643966136,164,138,302
6081,-0.645953270361,0.929241202634,048-ASN,0.141643966136,178,73,251
6082,-0.645953270361,0.929241202634,048-ASO,0.141643966136,336,325,661
6083,-0.645953270361,0.929241202634,048-ASP,0.141643966136,144,112,256
6084,-0.645953270361,0.929241202634,048-ASQ,0.141643966136,195,253,448
6085,-0.645953270361,0.929241202634,048-ASR,0.141643966136,180,345,525
6086,-0.645953270361,0.929241202634,048-ASS,0.141643966136,145,203,348
6087,-0.645953270361,0.929241202634,048-AST,0.141643966136,98,230,328
6088,-0.645953270361,0.929241202634,048-ASU,0.141643966136,247,303,550
6089,-0.645953270361,0.929241202634,048-ASV,0.141643966136,258,247,505
6090,-0.645953270361,0.929241202634,048-ASW,0.141643966136,216,603,819
6091,-0.645953270361,0.929241202634,048-ASX,0.141643966136,107,222,329
6092,-0.645953270361,0.929241202634,048-ASY,0.141643966136,300,483,783
6093,-0.645953270361,0.929241202634,048-ASZ,0.141643966136,319,328,647
6094,-0.645953270361,0.929241202634,048-ATC,0.141643966136,243,217,460
6095,-0.645953270361,0.929241202634,048-ATD,0.141643966136,180,181,361
6096,-0.645953270361,0.929241202634,048-ATE,0.141643966136,244,205,449
6097,-0.645953270361,0.929241202634,048-ATF,0.141643966136,152,184,336
6098,-0.645953270361,0.929241202634,048-ATG,0.141643966136,138,234,372
6099,-0.645953270361,0.929241202634,048-ATH,0.141643966136,168,262,430
6100,-0.645953270361,0.929241202634,048-ATI,0.141643966136,182,327,509
6101,-0.645953270361,0.929241202634,048-ATJ,0.141643966136,147,146,293
6102,-0.645953270361,0.929241202634,048-ATK,0.141643966136,205,278,483
6103,-0.645953270361,0.929241202634,048-ATL,0.141643966136,113,110,223
6104,-0.645953270361,0.929241202634,048-ATM,0.141643966136,198,181,379
6105,-0.645953270361,0.929241202634,048-ATO,0.141643966136,223,321,544
6106,-0.645953270361,0.929241202634,048-ATP,0.141643966136,224,353,577
6107,-0.645953270361,0.929241202634,048-ATQ,0.141643966136,162,412,574
6108,-0.645953270361,0.929241202634,048-ATR,0.141643966136,219,453,672
6109,-0.645953270361,0.929241202634,048-ATS,0.141643966136,199,326,525
6110,-0.645953270361,0.929241202634,048-ATT,0.141643966136,151,285,436
6111,-0.645953270361,0.929241202634,048-ATU,0.141643966136,217,377,594
6112,-0.645953270361,0.929241202634,048-ATV,0.141643966136,227,297,524
6113,-0.645953270361,0.929241202634,048-ATY,0.141643966136,253,362,615
6114,-0.645953270361,0.929241202634,048-ATZ,0.141643966136,200,229,429
6115,-0.645953270361,0.929241202634,048-AUA,0.141643966136,161,256,417
6116,-0.645953270361,0.929241202634,048-AUB,0.141643966136,213,283,496
6117,-0.645953270361,0.929241202634,048-AUD,0.141643966136,213,439,652
6118,-0.645953270361,0.929241202634,048-AUE,0.141643966136,177,265,442
6119,-0.645953270361,0.929241202634,048-AUF,0.141643966136,120,242,362
6120,-0.645953270361,0.929241202634,048-AUG,0.141643966136,225,371,596
6121,-0.645953270361,0.929241202634,048-AUH,0.141643966136,195,207,402
6122,-0.645953270361,0.929241202634,048-AUI,0.141643966136,177,296,473
6123,-0.645953270361,0.929241202634,048-AUJ,0.141643966136,112,140,252
6124,-0.645953270361,0.929241202634,048-AUK,0.141643966136,222,382,604
6125,-0.645953270361,0.929241202634,048-AUN,0.141643966136,242,232,474
6126,-0.645953270361,0.929241202634,048-AUO,0.141643966136,225,181,406
6127,-0.645953270361,0.929241202634,048-AUP,0.141643966136,91,45,136
6128,-0.645953270361,0.929241202634,048-AUR,0.141643966136,201,310,511
6129,-0.645953270361,0.929241202634,048-AUT,0.141643966136,204,401,605
6130,-0.645953270361,0.929241202634,048-AUU,0.141643966136,222,334,556
6131,-0.645953270361,0.929241202634,048-AUV,0.141643966136,213,422,635
6132,-0.645953270361,0.929241202634,048-AUW,0.141643966136,186,315,501
6133,-0.645953270361,0.929241202634,048-AUX,0.141643966136,156,376,532
6134,-0.645953270361,0.929241202634,048-AUY,0.141643966136,139,224,363
6135,-0.645953270361,0.929241202634,048-AUZ,0.141643966136,113,259,372
6136,-0.645953270361,0.929241202634,048-AVA,0.141643966136,151,304,455
6137,-0.645953270361,0.929241202634,048-AVD,0.141643966136,171,348,519
6138,-0.645953270361,0.929241202634,048-AVE,0.141643966136,257,436,693
6139,-0.645953270361,0.929241202634,048-AVJ,0.141643966136,116,368,484
6140,-0.645953270361,0.929241202634,048-AVK,0.141643966136,148,411,559
6141,-0.645953270361,0.929241202634,048-AVL,0.141643966136,211,348,559
6142,-0.645953270361,0.929241202634,048-AVT,0.141643966136,169,220,389
6143,-0.645953270361,0.929241202634,048-AVU,0.141643966136,181,456,637
6144,-0.645953270361,0.929241202634,048-AVV,0.141643966136,174,304,478
6145,-0.645953270361,0.929241202634,048-AVZ,0.141643966136,191,90,281
6146,-0.645953270361,0.929241202634,048-CAN,0.141643966136,198,311,509
6147,-0.645953270361,0.929241202634,048-XXX,0.141643966136,11,2,13
6148,-0.645953270361,0.929241202634,049-AAA,0.141643966136,32,55,87
6149,-0.645953270361,0.929241202634,049-AAB,0.141643966136,44,79,123
6150,-0.645953270361,0.929241202634,049-AAC,0.141643966136,109,218,327
6151,-0.645953270361,0.929241202634,049-AAD,0.141643966136,40,94,134
6152,-0.645953270361,0.929241202634,049-AAE,0.141643966136,64,125,189
6153,-0.645953270361,0.929241202634,049-AAG,0.141643966136,143,323,466
6154,-0.645953270361,0.929241202634,049-AAH,0.141643966136,148,170,318
6155,-0.645953270361,0.929241202634,049-AAJ,0.141643966136,26,43,69
6156,-0.645953270361,0.929241202634,049-AAK,0.141643966136,85,246,331
6157,-0.645953270361,0.929241202634,049-AAL,0.141643966136,72,128,200
6158,-0.645953270361,0.929241202634,049-AAM,0.141643966136,76,266,342
6159,-0.645953270361,0.929241202634,049-AAN,0.141643966136,94,397,491
6160,-0.645953270361,0.929241202634,049-AAO,0.141643966136,40,242,282
6161,-0.645953270361,0.929241202634,049-AAP,0.141643966136,100,316,416
6162,-0.645953270361,0.929241202634,049-AAQ,0.141643966136,106,412,518
6163,-0.645953270361,0.929241202634,049-AAR,0.141643966136,88,258,346
6164,-0.645953270361,0.929241202634,049-AAS,0.141643966136,58,180,238
6165,-0.645953270361,0.929241202634,049-AAT,0.141643966136,88,261,349
6166,-0.645953270361,0.929241202634,049-AAU,0.141643966136,81,287,368
6167,-0.645953270361,0.929241202634,049-AAV,0.141643966136,91,248,339
6168,-0.645953270361,0.929241202634,049-AAW,0.141643966136,90,369,459
6169,-0.645953270361,0.929241202634,049-AAX,0.141643966136,90,188,278
6170,-0.645953270361,0.929241202634,049-AAY,0.141643966136,126,280,406
6171,-0.645953270361,0.929241202634,049-AAZ,0.141643966136,89,187,276
6172,-0.645953270361,0.929241202634,049-ABA,0.141643966136,80,150,230
6173,-0.645953270361,0.929241202634,049-ABB,0.141643966136,94,315,409
6174,-0.645953270361,0.929241202634,049-ABC,0.141643966136,54,139,193
6175,-0.645953270361,0.929241202634,049-ABD,0.141643966136,48,183,231
6176,-0.645953270361,0.929241202634,049-ABE,0.141643966136,16,145,161
6177,-0.645953270361,0.929241202634,049-ABF,0.141643966136,59,187,246
6178,-0.645953270361,0.929241202634,049-ABG,0.141643966136,47,160,207
6179,-0.645953270361,0.929241202634,049-ABH,0.141643966136,76,185,261
6180,-0.645953270361,0.929241202634,049-ABI,0.141643966136,53,136,189
6181,-0.645953270361,0.929241202634,049-ABJ,0.141643966136,23,55,78
6182,-0.645953270361,0.929241202634,049-ABK,0.141643966136,60,212,272
6183,-0.645953270361,0.929241202634,049-ABL,0.141643966136,103,307,410
6184,-0.645953270361,0.929241202634,049-ABM,0.141643966136,134,348,482
6185,-0.645953270361,0.929241202634,049-ABN,0.141643966136,96,308,404
6186,-0.645953270361,0.929241202634,049-ABO,0.141643966136,12,82,94
6187,-0.645953270361,0.929241202634,049-ABP,0.141643966136,29,85,114
6188,-0.645953270361,0.929241202634,049-ABQ,0.141643966136,105,174,279
6189,-0.645953270361,0.929241202634,049-ABR,0.141643966136,37,147,184
6190,-0.645953270361,0.929241202634,049-ABS,0.141643966136,55,158,213
6191,-0.645953270361,0.929241202634,050-AAA,0.141643966136,127,22,149
6192,-0.645953270361,0.929241202634,050-AAB,0.141643966136,78,11,89
6193,-0.645953270361,0.929241202634,050-AAC,0.141643966136,181,31,212
6194,-0.645953270361,0.929241202634,050-AAE,0.141643966136,200,67,267
6195,-0.645953270361,0.929241202634,050-AAF,0.141643966136,230,65,295
6196,-0.645953270361,0.929241202634,050-AAG,0.141643966136,265,80,345
6197,-0.645953270361,0.929241202634,050-AAI,0.141643966136,189,50,239
6198,-0.645953270361,0.929241202634,050-AAJ,0.141643966136,253,90,343
6199,-0.645953270361,0.929241202634,050-AAM,0.141643966136,230,59,289
6200,-0.645953270361,0.929241202634,050-AAN,0.141643966136,182,51,233
6201,-0.645953270361,0.929241202634,050-AAO,0.141643966136,168,25,193
6202,-0.645953270361,0.929241202634,050-AAS,0.141643966136,129,160,289
6203,-0.645953270361,0.929241202634,050-AAT,0.141643966136,139,200,339
6204,-0.645953270361,0.929241202634,050-AAW,0.141643966136,150,217,367
6205,-0.645953270361,0.929241202634,050-AAX,0.141643966136,174,231,405
6206,-0.645953270361,0.929241202634,050-AAY,0.141643966136,138,217,355
6207,-0.645953270361,0.929241202634,050-AAZ,0.141643966136,160,231,391
6208,-0.645953270361,0.929241202634,050-ABB,0.141643966136,148,154,302
6209,-0.645953270361,0.929241202634,050-ABC,0.141643966136,130,190,320
6210,-0.645953270361,0.929241202634,050-ABD,0.141643966136,203,310,513
6211,-0.645953270361,0.929241202634,050-ABF,0.141643966136,113,47,160
6212,-0.645953270361,0.929241202634,050-ABJ,0.141643966136,118,64,182
6213,-0.645953270361,0.929241202634,050-ABK,0.141643966136,140,54,194
6214,-0.645953270361,0.929241202634,050-ABO,0.141643966136,163,46,209
6215,-0.645953270361,0.929241202634,050-ABP,0.141643966136,241,118,359
6216,-0.645953270361,0.929241202634,050-ABQ,0.141643966136,242,87,329
6217,-0.645953270361,0.929241202634,050-ABT,0.141643966136,166,75,241
6218,-0.645953270361,0.929241202634,050-ABU,0.141643966136,213,83,296
6219,-0.645953270361,0.929241202634,050-ABY,0.141643966136,154,33,187
6220,-0.645953270361,0.929241202634,050-ABZ,0.141643966136,219,1,220
6221,-0.645953270361,0.929241202634,050-ACB,0.141643966136,184,19,203
6222,-0.645953270361,0.929241202634,050-ACC,0.141643966136,125,17,142
6223,-0.645953270361,0.929241202634,050-ACK,0.141643966136,133,8,141
6224,-0.645953270361,0.929241202634,050-ACL,0.141643966136,257,21,278
6225,-0.645953270361,0.929241202634,050-ACM,0.141643966136,115,7,122
6226,-0.645953270361,0.929241202634,050-ACN,0.141643966136,266,12,278
6227,-0.645953270361,0.929241202634,050-ACO,0.141643966136,329,12,341
6228,-0.645953270361,0.929241202634,050-ACQ,0.141643966136,289,14,303
6229,-0.645953270361,0.929241202634,050-ACR,0.141643966136,154,9,163
6230,-0.645953270361,0.929241202634,050-ACT,0.141643966136,107,4,111
6231,-0.645953270361,0.929241202634,050-ADD,0.141643966136,167,28,195
6232,-0.645953270361,0.929241202634,050-ADK,0.141643966136,272,29,301
6233,-0.645953270361,0.929241202634,050-ADU,0.141643966136,152,76,228
6234,-0.645953270361,0.929241202634,050-ADW,0.141643966136,170,53,223
6235,-0.645953270361,0.929241202634,050-AEX,0.141643966136,203,20,223
6236,-0.645953270361,0.929241202634,050-AFP,0.141643966136,106,25,131
6237,-0.645953270361,0.929241202634,050-AFR,0.141643966136,219,10,229
6238,-0.645953270361,0.929241202634,050-AFS,0.141643966136,157,17,174
6239,-0.645953270361,0.929241202634,050-AFW,0.141643966136,131,59,190
6240,-0.645953270361,0.929241202634,050-AGJ,0.141643966136,185,90,275
6241,-0.645953270361,0.929241202634,050-AGK,0.141643966136,114,52,166
6242,-0.645953270361,0.929241202634,050-AGN,0.141643966136,142,57,199
6243,-0.645953270361,0.929241202634,050-AGP,0.141643966136,168,28,196
6244,-0.645953270361,0.929241202634,050-AGS,0.141643966136,145,77,222
6245,-0.645953270361,0.929241202634,050-AHE,0.141643966136,217,117,334
6246,-0.645953270361,0.929241202634,050-AHF,0.141643966136,110,53,163
6247,-0.645953270361,0.929241202634,050-AHG,0.141643966136,199,85,284
6248,-0.645953270361,0.929241202634,050-AHH,0.141643966136,182,77,259
6249,-0.645953270361,0.929241202634,050-AHJ,0.141643966136,158,108,266
6250,-0.645953270361,0.929241202634,050-AHL,0.141643966136,284,181,465
6251,-0.645953270361,0.929241202634,050-AHM,0.141643966136,184,117,301
6252,-0.645953270361,0.929241202634,050-AHN,0.141643966136,203,103,306
6253,-0.645953270361,0.929241202634,050-AHP,0.141643966136,168,94,262
6254,-0.645953270361,0.929241202634,050-AHR,0.141643966136,282,164,446
6255,-0.645953270361,0.929241202634,050-AHT,0.141643966136,117,50,167
6256,-0.645953270361,0.929241202634,050-AHU,0.141643966136,185,81,266
6257,-0.645953270361,0.929241202634,050-AHV,0.141643966136,274,188,462
6258,-0.645953270361,0.929241202634,050-AHX,0.141643966136,257,108,365
6259,-0.645953270361,0.929241202634,050-AHY,0.141643966136,249,119,368
6260,-0.645953270361,0.929241202634,050-AHZ,0.141643966136,162,87,249
6261,-0.645953270361,0.929241202634,050-AIA,0.141643966136,271,150,421
6262,-0.645953270361,0.929241202634,050-AIB,0.141643966136,144,91,235
6263,-0.645953270361,0.929241202634,050-AIC,0.141643966136,128,61,189
6264,-0.645953270361,0.929241202634,050-AID,0.141643966136,203,139,342
6265,-0.645953270361,0.929241202634,050-AIE,0.141643966136,171,75,246
6266,-0.645953270361,0.929241202634,050-AIG,0.141643966136,177,93,270
6267,-0.645953270361,0.929241202634,050-AIH,0.141643966136,173,106,279
6268,-0.645953270361,0.929241202634,050-AII,0.141643966136,248,132,380
6269,-0.645953270361,0.929241202634,050-AIJ,0.141643966136,194,98,292
6270,-0.645953270361,0.929241202634,050-AIK,0.141643966136,182,82,264
6271,-0.645953270361,0.929241202634,050-AIL,0.141643966136,109,61,170
6272,-0.645953270361,0.929241202634,050-AIV,0.141643966136,228,179,407
6273,-0.645953270361,0.929241202634,050-AJG,0.141643966136,278,154,432
6274,-0.645953270361,0.929241202634,050-AJJ,0.141643966136,226,163,389
6275,-0.645953270361,0.929241202634,050-AJK,0.141643966136,269,202,471
6276,-0.645953270361,0.929241202634,050-AJL,0.141643966136,84,30,114
6277,-0.645953270361,0.929241202634,050-AJM,0.141643966136,105,211,316
6278,-0.645953270361,0.929241202634,050-AJN,0.141643966136,140,219,359
6279,-0.645953270361,0.929241202634,050-AJO,0.141643966136,138,211,349
6280,-0.645953270361,0.929241202634,050-AJP,0.141643966136,186,381,567
6281,-0.645953270361,0.929241202634,050-AJQ,0.141643966136,260,225,485
6282,-0.645953270361,0.929241202634,050-AJR,0.141643966136,114,216,330
6283,-0.645953270361,0.929241202634,050-AJS,0.141643966136,101,96,197
6284,-0.645953270361,0.929241202634,050-AJT,0.141643966136,62,129,191
6285,-0.645953270361,0.929241202634,050-AJV,0.141643966136,220,257,477
6286,-0.645953270361,0.929241202634,050-AJW,0.141643966136,148,191,339
6287,-0.645953270361,0.929241202634,050-AJY,0.141643966136,227,247,474
6288,-0.645953270361,0.929241202634,050-AJZ,0.141643966136,243,236,479
6289,-0.645953270361,0.929241202634,050-AKA,0.141643966136,167,140,307
6290,-0.645953270361,0.929241202634,050-AKB,0.141643966136,216,168,384
6291,-0.645953270361,0.929241202634,050-AKD,0.141643966136,193,123,316
6292,-0.645953270361,0.929241202634,050-AKE,0.141643966136,167,92,259
6293,-0.645953270361,0.929241202634,050-AKF,0.141643966136,177,160,337
6294,-0.645953270361,0.929241202634,050-AKG,0.141643966136,161,135,296
6295,-0.645953270361,0.929241202634,050-AKH,0.141643966136,165,130,295
6296,-0.645953270361,0.929241202634,050-AKJ,0.141643966136,141,135,276
6297,-0.645953270361,0.929241202634,050-AKK,0.141643966136,161,198,359
6298,-0.645953270361,0.929241202634,050-AKM,0.141643966136,171,177,348
6299,-0.645953270361,0.929241202634,050-AKN,0.141643966136,184,122,306
6300,-0.645953270361,0.929241202634,050-AKP,0.141643966136,246,268,514
6301,-0.645953270361,0.929241202634,050-AKR,0.141643966136,134,86,220
6302,-0.645953270361,0.929241202634,050-AKS,0.141643966136,317,273,590
6303,-0.645953270361,0.929241202634,050-AKT,0.141643966136,159,104,263
6304,-0.645953270361,0.929241202634,050-AKU,0.141643966136,173,129,302
6305,-0.645953270361,0.929241202634,050-AKV,0.141643966136,142,92,234
6306,-0.645953270361,0.929241202634,050-AKW,0.141643966136,135,148,283
6307,-0.645953270361,0.929241202634,050-AKX,0.141643966136,180,102,282
6308,-0.645953270361,0.929241202634,050-AKY,0.141643966136,216,179,395
6309,-0.645953270361,0.929241202634,050-AKZ,0.141643966136,136,91,227
6310,-0.645953270361,0.929241202634,050-ALB,0.141643966136,160,156,316
6311,-0.645953270361,0.929241202634,050-ALC,0.141643966136,132,117,249
6312,-0.645953270361,0.929241202634,050-ALD,0.141643966136,157,121,278
6313,-0.645953270361,0.929241202634,050-ALE,0.141643966136,302,153,455
6314,-0.645953270361,0.929241202634,050-ALF,0.141643966136,133,106,239
6315,-0.645953270361,0.929241202634,050-ALG,0.141643966136,153,51,204
6316,-0.645953270361,0.929241202634,050-ALI,0.141643966136,173,203,376
6317,-0.645953270361,0.929241202634,050-ALJ,0.141643966136,201,145,346
6318,-0.645953270361,0.929241202634,050-ALK,0.141643966136,301,195,496
6319,-0.645953270361,0.929241202634,050-ALL,0.141643966136,148,196,344
6320,-0.645953270361,0.929241202634,050-ALN,0.141643966136,152,143,295
6321,-0.645953270361,0.929241202634,050-ALQ,0.141643966136,237,138,375
6322,-0.645953270361,0.929241202634,050-AMB,0.141643966136,199,99,298
6323,-0.645953270361,0.929241202634,050-AMM,0.141643966136,214,136,350
6324,-0.645953270361,0.929241202634,050-AMS,0.141643966136,217,124,341
6325,-0.645953270361,0.929241202634,050-AMT,0.141643966136,174,295,469
6326,-0.645953270361,0.929241202634,050-AMV,0.141643966136,155,164,319
6327,-0.645953270361,0.929241202634,050-AMW,0.141643966136,228,305,533
6328,-0.645953270361,0.929241202634,050-AMX,0.141643966136,205,260,465
6329,-0.645953270361,0.929241202634,050-AMY,0.141643966136,214,245,459
6330,-0.645953270361,0.929241202634,050-AMZ,0.141643966136,222,385,607
6331,-0.645953270361,0.929241202634,050-ANA,0.141643966136,152,304,456
6332,-0.645953270361,0.929241202634,050-AND,0.141643966136,149,85,234
6333,-0.645953270361,0.929241202634,050-ANE,0.141643966136,203,154,357
6334,-0.645953270361,0.929241202634,050-ANG,0.141643966136,194,229,423
6335,-0.645953270361,0.929241202634,050-ANH,0.141643966136,208,319,527
6336,-0.645953270361,0.929241202634,050-ANJ,0.141643966136,87,258,345
6337,-0.645953270361,0.929241202634,050-ANK,0.141643966136,118,283,401
6338,-0.645953270361,0.929241202634,050-ANL,0.141643966136,125,191,316
6339,-0.645953270361,0.929241202634,050-ANP,0.141643966136,140,240,380
6340,-0.645953270361,0.929241202634,050-ANQ,0.141643966136,178,370,548
6341,-0.645953270361,0.929241202634,050-ANR,0.141643966136,118,237,355
6342,-0.645953270361,0.929241202634,050-ANT,0.141643966136,44,43,87
6343,-0.645953270361,0.929241202634,050-ANU,0.141643966136,167,160,327
6344,-0.645953270361,0.929241202634,050-ANV,0.141643966136,226,265,491
6345,-0.645953270361,0.929241202634,050-ANX,0.141643966136,172,190,362
6346,-0.645953270361,0.929241202634,050-ANY,0.141643966136,159,159,318
6347,-0.645953270361,0.929241202634,050-ANZ,0.141643966136,131,136,267
6348,-0.645953270361,0.929241202634,050-AOA,0.141643966136,203,156,359
6349,-0.645953270361,0.929241202634,050-AOC,0.141643966136,218,165,383
6350,-0.645953270361,0.929241202634,050-AOE,0.141643966136,129,158,287
6351,-0.645953270361,0.929241202634,050-AOF,0.141643966136,183,155,338
6352,-0.645953270361,0.929241202634,050-AOG,0.141643966136,122,189,311
6353,-0.645953270361,0.929241202634,050-AOH,0.141643966136,300,373,673
6354,-0.645953270361,0.929241202634,050-AOI,0.141643966136,106,124,230
6355,-0.645953270361,0.929241202634,050-AOJ,0.141643966136,137,279,416
6356,-0.645953270361,0.929241202634,050-AON,0.141643966136,152,146,298
6357,-0.645953270361,0.929241202634,050-AOO,0.141643966136,135,77,212
6358,-0.645953270361,0.929241202634,050-AOP,0.141643966136,173,188,361
6359,-0.645953270361,0.929241202634,050-AOQ,0.141643966136,214,351,565
6360,-0.645953270361,0.929241202634,050-AOR,0.141643966136,172,81,253
6361,-0.645953270361,0.929241202634,050-AOS,0.141643966136,240,218,458
6362,-0.645953270361,0.929241202634,050-AOT,0.141643966136,151,117,268
6363,-0.645953270361,0.929241202634,050-AOU,0.141643966136,151,117,268
6364,-0.645953270361,0.929241202634,050-AOV,0.141643966136,129,64,193
6365,-0.645953270361,0.929241202634,050-AOW,0.141643966136,145,73,218
6366,-0.645953270361,0.929241202634,050-AOY,0.141643966136,285,288,573
6367,-0.645953270361,0.929241202634,050-AOZ,0.141643966136,126,193,319
6368,-0.645953270361,0.929241202634,050-APA,0.141643966136,156,186,342
6369,-0.645953270361,0.929241202634,050-APE,0.141643966136,69,162,231
6370,-0.645953270361,0.929241202634,050-APF,0.141643966136,90,187,277
6371,-0.645953270361,0.929241202634,050-APG,0.141643966136,35,36,71
6372,-0.645953270361,0.929241202634,050-APH,0.141643966136,86,177,263
6373,-0.645953270361,0.929241202634,050-API,0.141643966136,104,197,301
6374,-0.645953270361,0.929241202634,050-APJ,0.141643966136,162,247,409
6375,-0.645953270361,0.929241202634,050-APK,0.141643966136,158,238,396
6376,-0.645953270361,0.929241202634,050-APL,0.141643966136,97,168,265
6377,-0.645953270361,0.929241202634,050-APM,0.141643966136,295,292,587
6378,-0.645953270361,0.929241202634,050-APN,0.141643966136,194,273,467
6379,-0.645953270361,0.929241202634,050-APO,0.141643966136,132,152,284
6380,-0.645953270361,0.929241202634,050-APS,0.141643966136,195,144,339
6381,-0.645953270361,0.929241202634,050-APT,0.141643966136,173,132,305
6382,-0.645953270361,0.929241202634,050-APV,0.141643966136,191,197,388
6383,-0.645953270361,0.929241202634,050-APW,0.141643966136,109,213,322
6384,-0.645953270361,0.929241202634,050-APX,0.141643966136,140,145,285
6385,-0.645953270361,0.929241202634,050-APY,0.141643966136,109,129,238
6386,-0.645953270361,0.929241202634,050-AQA,0.141643966136,74,43,117
6387,-0.645953270361,0.929241202634,050-AQB,0.141643966136,111,52,163
6388,-0.645953270361,0.929241202634,050-AQC,0.141643966136,85,36,121
6389,-0.645953270361,0.929241202634,050-AQD,0.141643966136,115,49,164
6390,-0.645953270361,0.929241202634,050-AQE,0.141643966136,138,59,197
6391,-0.645953270361,0.929241202634,050-AQF,0.141643966136,154,99,253
6392,-0.645953270361,0.929241202634,050-AQG,0.141643966136,174,61,235
6393,-0.645953270361,0.929241202634,050-AQH,0.141643966136,147,35,182
6394,-0.645953270361,0.929241202634,050-AQI,0.141643966136,206,38,244
6395,-0.645953270361,0.929241202634,050-AQJ,0.141643966136,145,32,177
6396,-0.645953270361,0.929241202634,050-AQK,0.141643966136,89,28,117
6397,-0.645953270361,0.929241202634,050-AQL,0.141643966136,169,84,253
6398,-0.645953270361,0.929241202634,050-AQM,0.141643966136,109,61,170
6399,-0.645953270361,0.929241202634,050-AQN,0.141643966136,178,36,214
6400,-0.645953270361,0.929241202634,050-AQO,0.141643966136,160,89,249
6401,-0.645953270361,0.929241202634,050-AQR,0.141643966136,103,16,119
6402,-0.645953270361,0.929241202634,050-AQS,0.141643966136,148,12,160
6403,-0.645953270361,0.929241202634,050-AQT,0.141643966136,108,13,121
6404,-0.645953270361,0.929241202634,050-AQU,0.141643966136,145,6,151
6405,-0.645953270361,0.929241202634,050-AQV,0.141643966136,142,54,196
6406,-0.645953270361,0.929241202634,050-AQW,0.141643966136,154,14,168
6407,-0.645953270361,0.929241202634,050-AQX,0.141643966136,187,68,255
6408,-0.645953270361,0.929241202634,050-AQY,0.141643966136,290,185,475
6409,-0.645953270361,0.929241202634,050-AQZ,0.141643966136,234,81,315
6410,-0.645953270361,0.929241202634,050-ARA,0.141643966136,147,51,198
6411,-0.645953270361,0.929241202634,050-ARB,0.141643966136,225,90,315
6412,-0.645953270361,0.929241202634,050-ARC,0.141643966136,146,6,152
6413,-0.645953270361,0.929241202634,050-ARD,0.141643966136,179,14,193
6414,-0.645953270361,0.929241202634,050-ARE,0.141643966136,239,21,260
6415,-0.645953270361,0.929241202634,050-ARF,0.141643966136,156,16,172
6416,-0.645953270361,0.929241202634,050-ARG,0.141643966136,173,85,258
6417,-0.645953270361,0.929241202634,050-ARH,0.141643966136,210,114,324
6418,-0.645953270361,0.929241202634,050-ARI,0.141643966136,212,8,220
6419,-0.645953270361,0.929241202634,050-ARJ,0.141643966136,117,22,139
6420,-0.645953270361,0.929241202634,050-ARL,0.141643966136,215,91,306
6421,-0.645953270361,0.929241202634,050-ARM,0.141643966136,128,36,164
6422,-0.645953270361,0.929241202634,050-ARN,0.141643966136,171,65,236
6423,-0.645953270361,0.929241202634,050-ARO,0.141643966136,113,67,180
6424,-0.645953270361,0.929241202634,050-ARP,0.141643966136,141,47,188
6425,-0.645953270361,0.929241202634,050-ARQ,0.141643966136,207,101,308
6426,-0.645953270361,0.929241202634,050-ARR,0.141643966136,193,66,259
6427,-0.645953270361,0.929241202634,050-ARS,0.141643966136,126,41,167
6428,-0.645953270361,0.929241202634,050-ART,0.141643966136,165,35,200
6429,-0.645953270361,0.929241202634,050-ARU,0.141643966136,171,59,230
6430,-0.645953270361,0.929241202634,050-ARV,0.141643966136,239,109,348
6431,-0.645953270361,0.929241202634,050-ARX,0.141643966136,113,12,125
6432,-0.645953270361,0.929241202634,050-ARY,0.141643966136,176,21,197
6433,-0.645953270361,0.929241202634,050-ARZ,0.141643966136,123,4,127
6434,-0.645953270361,0.929241202634,050-ASA,0.141643966136,194,3,197
6435,-0.645953270361,0.929241202634,050-ASB,0.141643966136,279,62,341
6436,-0.645953270361,0.929241202634,050-ASC,0.141643966136,160,30,190
6437,-0.645953270361,0.929241202634,050-ASD,0.141643966136,167,12,179
6438,-0.645953270361,0.929241202634,050-ASE,0.141643966136,372,63,435
6439,-0.645953270361,0.929241202634,050-ASG,0.141643966136,65,7,72
6440,-0.645953270361,0.929241202634,050-ASH,0.141643966136,321,15,336
6441,-0.645953270361,0.929241202634,050-ASI,0.141643966136,80,8,88
6442,-0.645953270361,0.929241202634,050-ASJ,0.141643966136,295,13,308
6443,-0.645953270361,0.929241202634,050-ASK,0.141643966136,179,7,186
6444,-0.645953270361,0.929241202634,050-ASL,0.141643966136,131,198,329
6445,-0.645953270361,0.929241202634,050-ASM,0.141643966136,239,157,396
6446,-0.645953270361,0.929241202634,050-ASN,0.141643966136,236,152,388
6447,-0.645953270361,0.929241202634,050-ASO,0.141643966136,172,82,254
6448,-0.645953270361,0.929241202634,050-ASP,0.141643966136,223,123,346
6449,-0.645953270361,0.929241202634,050-ASQ,0.141643966136,98,62,160
6450,-0.645953270361,0.929241202634,050-ASR,0.141643966136,160,134,294
6451,-0.645953270361,0.929241202634,050-ASS,0.141643966136,212,187,399
6452,-0.645953270361,0.929241202634,050-AST,0.141643966136,308,242,550
6453,-0.645953270361,0.929241202634,050-ASW,0.141643966136,332,310,642
6454,-0.645953270361,0.929241202634,050-ASX,0.141643966136,174,136,310
6455,-0.645953270361,0.929241202634,050-ASY,0.141643966136,203,134,337
6456,-0.645953270361,0.929241202634,050-ASZ,0.141643966136,151,148,299
6457,-0.645953270361,0.929241202634,050-ATA,0.141643966136,120,78,198
6458,-0.645953270361,0.929241202634,050-ATB,0.141643966136,214,239,453
6459,-0.645953270361,0.929241202634,050-ATC,0.141643966136,173,160,333
6460,-0.645953270361,0.929241202634,050-ATD,0.141643966136,183,161,344
6461,-0.645953270361,0.929241202634,050-ATE,0.141643966136,194,169,363
6462,-0.645953270361,0.929241202634,050-ATG,0.141643966136,114,175,289
6463,-0.645953270361,0.929241202634,050-ATH,0.141643966136,161,274,435
6464,-0.645953270361,0.929241202634,050-ZZZ,0.141643966136,47708,33152,80860
6465,-0.645953270361,0.929241202634,051-AAA,0.141643966136,59,43,102
6466,-0.645953270361,0.929241202634,051-AAB,0.141643966136,69,52,121
6467,-0.645953270361,0.929241202634,051-AAC,0.141643966136,97,107,204
6468,-0.645953270361,0.929241202634,051-AAD,0.141643966136,107,126,233
6469,-0.645953270361,0.929241202634,051-AAE,0.141643966136,99,90,189
6470,-0.645953270361,0.929241202634,051-AAH,0.141643966136,69,45,114
6471,-0.645953270361,0.929241202634,051-AAI,0.141643966136,63,56,119
6472,-0.645953270361,0.929241202634,051-AAJ,0.141643966136,56,70,126
6473,-0.645953270361,0.929241202634,051-AAK,0.141643966136,62,95,157
6474,-0.645953270361,0.929241202634,051-AAN,0.141643966136,91,93,184
6475,-0.645953270361,0.929241202634,051-AAO,0.141643966136,65,34,99
6476,-0.645953270361,0.929241202634,051-AAP,0.141643966136,65,63,128
6477,-0.645953270361,0.929241202634,051-AAQ,0.141643966136,97,83,180
6478,-0.645953270361,0.929241202634,051-AAR,0.141643966136,72,100,172
6479,-0.645953270361,0.929241202634,051-AAS,0.141643966136,57,68,125
6480,-0.645953270361,0.929241202634,051-AAT,0.141643966136,94,145,239
6481,-0.645953270361,0.929241202634,051-AAU,0.141643966136,48,38,86
6482,-0.645953270361,0.929241202634,051-AAV,0.141643966136,48,43,91
6483,-0.645953270361,0.929241202634,051-AAW,0.141643966136,47,65,112
6484,-0.645953270361,0.929241202634,051-AAX,0.141643966136,41,83,124
6485,-0.645953270361,0.929241202634,051-AAY,0.141643966136,83,110,193
6486,-0.645953270361,0.929241202634,051-AAZ,0.141643966136,75,125,200
6487,-0.645953270361,0.929241202634,051-ABA,0.141643966136,83,104,187
6488,-0.645953270361,0.929241202634,051-ABB,0.141643966136,76,100,176
6489,-0.645953270361,0.929241202634,051-ABC,0.141643966136,61,63,124
6490,-0.645953270361,0.929241202634,051-ABD,0.141643966136,50,56,106
6491,-0.645953270361,0.929241202634,051-ABE,0.141643966136,24,48,72
6492,-0.645953270361,0.929241202634,051-ABF,0.141643966136,71,95,166
6493,-0.645953270361,0.929241202634,051-ABG,0.141643966136,79,146,225
6494,-0.645953270361,0.929241202634,051-ABH,0.141643966136,108,132,240
6495,-0.645953270361,0.929241202634,051-ABI,0.141643966136,62,117,179
6496,-0.645953270361,0.929241202634,051-ABJ,0.141643966136,141,375,516
6497,-0.645953270361,0.929241202634,051-ABK,0.141643966136,91,211,302
6498,-0.645953270361,0.929241202634,051-ABL,0.141643966136,94,175,269
6499,-0.645953270361,0.929241202634,051-ABM,0.141643966136,79,120,199
6500,-0.645953270361,0.929241202634,051-ABN,0.141643966136,105,145,250
6501,-0.645953270361,0.929241202634,051-ABO,0.141643966136,72,160,232
6502,-0.645953270361,0.929241202634,051-ABP,0.141643966136,97,211,308
6503,-0.645953270361,0.929241202634,051-ABQ,0.141643966136,108,252,360
6504,-0.645953270361,0.929241202634,051-ABR,0.141643966136,42,55,97
6505,-0.645953270361,0.929241202634,051-ABT,0.141643966136,64,136,200
6506,-0.645953270361,0.929241202634,051-ABU,0.141643966136,67,167,234
6507,-0.645953270361,0.929241202634,051-ABV,0.141643966136,52,136,188
6508,-0.645953270361,0.929241202634,051-ABW,0.141643966136,65,110,175
6509,-0.645953270361,0.929241202634,051-ABX,0.141643966136,73,151,224
6510,-0.645953270361,0.929241202634,051-ABY,0.141643966136,107,237,344
6511,-0.645953270361,0.929241202634,051-ABZ,0.141643966136,60,186,246
6512,-0.645953270361,0.929241202634,051-ACA,0.141643966136,29,126,155
6513,-0.645953270361,0.929241202634,051-ACB,0.141643966136,63,160,223
6514,-0.645953270361,0.929241202634,051-ACC,0.141643966136,74,170,244
6515,-0.645953270361,0.929241202634,051-ACD,0.141643966136,57,108,165
6516,-0.645953270361,0.929241202634,051-ACE,0.141643966136,24,70,94
6517,-0.645953270361,0.929241202634,051-ACF,0.141643966136,79,220,299
6518,-0.645953270361,0.929241202634,051-ACG,0.141643966136,109,198,307
6519,-0.645953270361,0.929241202634,051-ACH,0.141643966136,113,274,387
6520,-0.645953270361,0.929241202634,051-ACI,0.141643966136,71,221,292
6521,-0.645953270361,0.929241202634,051-ACJ,0.141643966136,66,203,269
6522,-0.645953270361,0.929241202634,051-ACK,0.141643966136,69,177,246
6523,-0.645953270361,0.929241202634,051-ACL,0.141643966136,67,127,194
6524,-0.645953270361,0.929241202634,051-ACM,0.141643966136,95,118,213
6525,-0.645953270361,0.929241202634,051-ACN,0.141643966136,79,113,192
6526,-0.645953270361,0.929241202634,051-ACO,0.141643966136,76,196,272
6527,-0.645953270361,0.929241202634,051-ACP,0.141643966136,58,131,189
6528,-0.645953270361,0.929241202634,051-ACQ,0.141643966136,62,103,165
6529,-0.645953270361,0.929241202634,051-ACR,0.141643966136,48,159,207
6530,-0.645953270361,0.929241202634,051-ACS,0.141643966136,41,159,200
6531,-0.645953270361,0.929241202634,051-ACT,0.141643966136,90,171,261
6532,-0.645953270361,0.929241202634,051-ACU,0.141643966136,113,320,433
6533,-0.645953270361,0.929241202634,051-ACV,0.141643966136,154,316,470
6534,-0.645953270361,0.929241202634,051-ACW,0.141643966136,58,158,216
6535,-0.645953270361,0.929241202634,051-ACX,0.141643966136,81,251,332
6536,-0.645953270361,0.929241202634,051-ACY,0.141643966136,90,288,378
6537,-0.645953270361,0.929241202634,051-ACZ,0.141643966136,111,219,330
6538,-0.645953270361,0.929241202634,051-ADA,0.141643966136,85,292,377
6539,-0.645953270361,0.929241202634,051-ADC,0.141643966136,62,145,207
6540,-0.645953270361,0.929241202634,051-ADD,0.141643966136,52,97,149
6541,-0.645953270361,0.929241202634,051-ADE,0.141643966136,78,226,304
6542,-0.645953270361,0.929241202634,051-ADF,0.141643966136,43,222,265
6543,-0.645953270361,0.929241202634,051-ADG,0.141643966136,57,187,244
6544,-0.645953270361,0.929241202634,051-ADH,0.141643966136,67,203,270
6545,-0.645953270361,0.929241202634,051-ADI,0.141643966136,57,151,208
6546,-0.645953270361,0.929241202634,051-ADJ,0.141643966136,101,209,310
6547,-0.645953270361,0.929241202634,051-ADK,0.141643966136,42,93,135
6548,-0.645953270361,0.929241202634,051-ADL,0.141643966136,75,293,368
6549,-0.645953270361,0.929241202634,052-AAA,0.141643966136,152,232,384
6550,-0.645953270361,0.929241202634,052-AAB,0.141643966136,148,237,385
6551,-0.645953270361,0.929241202634,052-AAC,0.141643966136,124,172,296
6552,-0.645953270361,0.929241202634,052-AAD,0.141643966136,114,218,332
6553,-0.645953270361,0.929241202634,052-AAE,0.141643966136,163,255,418
6554,-0.645953270361,0.929241202634,052-AAF,0.141643966136,92,214,306
6555,-0.645953270361,0.929241202634,052-AAG,0.141643966136,149,327,476
6556,-0.645953270361,0.929241202634,052-AAI,0.141643966136,156,222,378
6557,-0.645953270361,0.929241202634,052-AAJ,0.141643966136,91,179,270
6558,-0.645953270361,0.929241202634,052-AAK,0.141643966136,133,197,330
6559,-0.645953270361,0.929241202634,052-AAL,0.141643966136,130,188,318
6560,-0.645953270361,0.929241202634,052-AAM,0.141643966136,125,175,300
6561,-0.645953270361,0.929241202634,052-AAN,0.141643966136,96,176,272
6562,-0.645953270361,0.929241202634,052-AAO,0.141643966136,134,195,329
6563,-0.645953270361,0.929241202634,052-AAP,0.141643966136,155,190,345
6564,-0.645953270361,0.929241202634,052-AAQ,0.141643966136,87,140,227
6565,-0.645953270361,0.929241202634,052-AAR,0.141643966136,147,339,486
6566,-0.645953270361,0.929241202634,052-AAS,0.141643966136,141,186,327
6567,-0.645953270361,0.929241202634,052-AAT,0.141643966136,93,152,245
6568,-0.645953270361,0.929241202634,052-AAU,0.141643966136,100,176,276
6569,-0.645953270361,0.929241202634,052-AAV,0.141643966136,79,111,190
6570,-0.645953270361,0.929241202634,052-AAW,0.141643966136,162,216,378
6571,-0.645953270361,0.929241202634,052-AAX,0.141643966136,191,272,463
6572,-0.645953270361,0.929241202634,052-AAY,0.141643966136,56,94,150
6573,-0.645953270361,0.929241202634,052-AAZ,0.141643966136,68,107,175
6574,-0.645953270361,0.929241202634,052-ABA,0.141643966136,144,224,368
6575,-0.645953270361,0.929241202634,052-ABB,0.141643966136,118,168,286
6576,-0.645953270361,0.929241202634,052-ABC,0.141643966136,159,266,425
6577,-0.645953270361,0.929241202634,052-ABD,0.141643966136,85,107,192
6578,-0.645953270361,0.929241202634,052-ABE,0.141643966136,111,143,254
6579,-0.645953270361,0.929241202634,052-ABF,0.141643966136,169,147,316
6580,-0.645953270361,0.929241202634,052-ABG,0.141643966136,200,307,507
6581,-0.645953270361,0.929241202634,052-ABH,0.141643966136,95,158,253
6582,-0.645953270361,0.929241202634,052-ABI,0.141643966136,113,232,345
6583,-0.645953270361,0.929241202634,052-ABJ,0.141643966136,120,123,243
6584,-0.645953270361,0.929241202634,052-ABK,0.141643966136,132,305,437
6585,-0.645953270361,0.929241202634,052-ABL,0.141643966136,167,289,456
6586,-0.645953270361,0.929241202634,052-ABM,0.141643966136,152,354,506
6587,-0.645953270361,0.929241202634,052-ABN,0.141643966136,58,118,176
6588,-0.645953270361,0.929241202634,052-ABP,0.141643966136,127,237,364
6589,-0.645953270361,0.929241202634,052-ABQ,0.141643966136,110,181,291
6590,-0.645953270361,0.929241202634,052-ABR,0.141643966136,91,126,217
6591,-0.645953270361,0.929241202634,052-ABS,0.141643966136,136,213,349
6592,-0.645953270361,0.929241202634,052-ABT,0.141643966136,112,252,364
6593,-0.645953270361,0.929241202634,052-ABU,0.141643966136,213,492,705
6594,-0.645953270361,0.929241202634,052-ABW,0.141643966136,131,160,291
6595,-0.645953270361,0.929241202634,052-ABX,0.141643966136,124,239,363
6596,-0.645953270361,0.929241202634,052-ABY,0.141643966136,114,268,382
6597,-0.645953270361,0.929241202634,052-ABZ,0.141643966136,151,343,494
6598,-0.645953270361,0.929241202634,052-ACA,0.141643966136,164,345,509
6599,-0.645953270361,0.929241202634,052-ACB,0.141643966136,173,410,583
6600,-0.645953270361,0.929241202634,052-ACD,0.141643966136,179,275,454
6601,-0.645953270361,0.929241202634,052-ACE,0.141643966136,122,216,338
6602,-0.645953270361,0.929241202634,052-ACF,0.141643966136,167,307,474
6603,-0.645953270361,0.929241202634,052-ACG,0.141643966136,108,181,289
6604,-0.645953270361,0.929241202634,052-ACJ,0.141643966136,95,168,263
6605,-0.645953270361,0.929241202634,052-ACK,0.141643966136,144,242,386
6606,-0.645953270361,0.929241202634,052-ACL,0.141643966136,66,102,168
6607,-0.645953270361,0.929241202634,052-ACM,0.141643966136,173,414,587
6608,-0.645953270361,0.929241202634,052-ACN,0.141643966136,107,289,396
6609,-0.645953270361,0.929241202634,052-ACO,0.141643966136,76,203,279
6610,-0.645953270361,0.929241202634,052-ACP,0.141643966136,188,281,469
6611,-0.645953270361,0.929241202634,052-ACQ,0.141643966136,90,122,212
6612,-0.645953270361,0.929241202634,052-ACR,0.141643966136,94,123,217
6613,-0.645953270361,0.929241202634,052-ACS,0.141643966136,187,400,587
6614,-0.645953270361,0.929241202634,052-ACT,0.141643966136,69,100,169
6615,-0.645953270361,0.929241202634,052-ACU,0.141643966136,140,299,439
6616,-0.645953270361,0.929241202634,052-ACV,0.141643966136,91,264,355
6617,-0.645953270361,0.929241202634,052-ACW,0.141643966136,90,113,203
6618,-0.645953270361,0.929241202634,052-ACX,0.141643966136,120,175,295
6619,-0.645953270361,0.929241202634,052-ACY,0.141643966136,186,361,547
6620,-0.645953270361,0.929241202634,052-ACZ,0.141643966136,164,394,558
6621,-0.645953270361,0.929241202634,052-ADA,0.141643966136,204,318,522
6622,-0.645953270361,0.929241202634,052-ADB,0.141643966136,144,286,430
6623,-0.645953270361,0.929241202634,052-ADC,0.141643966136,148,347,495
6624,-0.645953270361,0.929241202634,052-ADD,0.141643966136,144,315,459
6625,-0.645953270361,0.929241202634,052-ADE,0.141643966136,131,272,403
6626,-0.645953270361,0.929241202634,052-ADF,0.141643966136,126,338,464
6627,-0.645953270361,0.929241202634,052-ADG,0.141643966136,121,360,481
6628,-0.645953270361,0.929241202634,052-ADH,0.141643966136,147,424,571
6629,-0.645953270361,0.929241202634,052-ADI,0.141643966136,101,320,421
6630,-0.645953270361,0.929241202634,052-ADJ,0.141643966136,97,258,355
6631,-0.645953270361,0.929241202634,052-ADK,0.141643966136,91,202,293
6632,-0.645953270361,0.929241202634,052-ADL,0.141643966136,103,245,348
6633,-0.645953270361,0.929241202634,052-ADM,0.141643966136,69,183,252
6634,-0.645953270361,0.929241202634,052-ADN,0.141643966136,127,261,388
6635,-0.645953270361,0.929241202634,052-ADO,0.141643966136,127,280,407
6636,-0.645953270361,0.929241202634,052-ADP,0.141643966136,86,209,295
6637,-0.645953270361,0.929241202634,052-ADQ,0.141643966136,113,257,370
6638,-0.645953270361,0.929241202634,052-ADR,0.141643966136,68,119,187
6639,-0.645953270361,0.929241202634,052-ADS,0.141643966136,71,160,231
6640,-0.645953270361,0.929241202634,052-ADT,0.141643966136,104,214,318
6641,-0.645953270361,0.929241202634,052-ADU,0.141643966136,107,228,335
6642,-0.645953270361,0.929241202634,052-ADV,0.141643966136,100,306,406
6643,-0.645953270361,0.929241202634,052-ADW,0.141643966136,142,363,505
6644,-0.645953270361,0.929241202634,052-ADX,0.141643966136,71,258,329
6645,-0.645953270361,0.929241202634,052-ADY,0.141643966136,117,411,528
6646,-0.645953270361,0.929241202634,052-ADZ,0.141643966136,93,299,392
6647,-0.645953270361,0.929241202634,052-AEA,0.141643966136,78,176,254
6648,-0.645953270361,0.929241202634,052-AEB,0.141643966136,87,214,301
6649,-0.645953270361,0.929241202634,052-AEC,0.141643966136,147,253,400
6650,-0.645953270361,0.929241202634,052-AED,0.141643966136,78,153,231
6651,-0.645953270361,0.929241202634,052-AEE,0.141643966136,98,202,300
6652,-0.645953270361,0.929241202634,052-AEF,0.141643966136,116,271,387
6653,-0.645953270361,0.929241202634,052-AEG,0.141643966136,151,376,527
6654,-0.645953270361,0.929241202634,052-AEH,0.141643966136,146,281,427
6655,-0.645953270361,0.929241202634,052-AEI,0.141643966136,131,243,374
6656,-0.645953270361,0.929241202634,052-AEJ,0.141643966136,143,265,408
6657,-0.645953270361,0.929241202634,052-AEK,0.141643966136,103,210,313
6658,-0.645953270361,0.929241202634,052-AEL,0.141643966136,134,361,495
6659,-0.645953270361,0.929241202634,052-AEM,0.141643966136,166,352,518
6660,-0.645953270361,0.929241202634,052-AEN,0.141643966136,186,429,615
6661,-0.645953270361,0.929241202634,052-AEO,0.141643966136,123,274,397
6662,-0.645953270361,0.929241202634,052-AEP,0.141643966136,142,274,416
6663,-0.645953270361,0.929241202634,052-AEQ,0.141643966136,139,414,553
6664,-0.645953270361,0.929241202634,052-AER,0.141643966136,117,358,475
6665,-0.645953270361,0.929241202634,052-AES,0.141643966136,208,392,600
6666,-0.645953270361,0.929241202634,052-AET,0.141643966136,153,344,497
6667,-0.645953270361,0.929241202634,052-AEU,0.141643966136,164,393,557
6668,-0.645953270361,0.929241202634,052-AEV,0.141643966136,97,213,310
6669,-0.645953270361,0.929241202634,052-AEW,0.141643966136,142,275,417
6670,-0.645953270361,0.929241202634,052-AEX,0.141643966136,205,387,592
6671,-0.645953270361,0.929241202634,052-AEY,0.141643966136,213,466,679
6672,-0.645953270361,0.929241202634,052-AEZ,0.141643966136,151,722,873
6673,-0.645953270361,0.929241202634,052-AFA,0.141643966136,212,666,878
6674,-0.645953270361,0.929241202634,052-AFB,0.141643966136,149,296,445
6675,-0.645953270361,0.929241202634,052-AFC,0.141643966136,133,395,528
6676,-0.645953270361,0.929241202634,052-AFD,0.141643966136,212,434,646
6677,-0.645953270361,0.929241202634,052-AFE,0.141643966136,124,404,528
6678,-0.645953270361,0.929241202634,052-AFF,0.141643966136,126,411,537
6679,-0.645953270361,0.929241202634,052-AFG,0.141643966136,104,273,377
6680,-0.645953270361,0.929241202634,052-AFH,0.141643966136,165,420,585
6681,-0.645953270361,0.929241202634,052-AFI,0.141643966136,71,132,203
6682,-0.645953270361,0.929241202634,052-AFJ,0.141643966136,149,343,492
6683,-0.645953270361,0.929241202634,052-AFK,0.141643966136,118,285,403
6684,-0.645953270361,0.929241202634,052-AFL,0.141643966136,111,213,324
6685,-0.645953270361,0.929241202634,052-AFM,0.141643966136,132,312,444
6686,-0.645953270361,0.929241202634,052-AFN,0.141643966136,57,82,139
6687,-0.645953270361,0.929241202634,052-AFO,0.141643966136,148,297,445
6688,-0.645953270361,0.929241202634,052-AFP,0.141643966136,188,386,574
6689,-0.645953270361,0.929241202634,052-AFQ,0.141643966136,146,419,565
6690,-0.645953270361,0.929241202634,052-AFR,0.141643966136,117,237,354
6691,-0.645953270361,0.929241202634,052-AFS,0.141643966136,82,214,296
6692,-0.645953270361,0.929241202634,052-AFT,0.141643966136,209,428,637
6693,-0.645953270361,0.929241202634,052-AFU,0.141643966136,40,48,88
6694,-0.645953270361,0.929241202634,052-AFV,0.141643966136,134,205,339
6695,-0.645953270361,0.929241202634,052-AFW,0.141643966136,148,314,462
6696,-0.645953270361,0.929241202634,052-AFX,0.141643966136,48,139,187
6697,-0.645953270361,0.929241202634,052-AFY,0.141643966136,125,352,477
6698,-0.645953270361,0.929241202634,052-AFZ,0.141643966136,149,369,518
6699,-0.645953270361,0.929241202634,052-AGA,0.141643966136,152,304,456
6700,-0.645953270361,0.929241202634,053-AAA,0.141643966136,180,239,419
6701,-0.645953270361,0.929241202634,053-AAC,0.141643966136,111,293,404
6702,-0.645953270361,0.929241202634,053-AAD,0.141643966136,103,338,441
6703,-0.645953270361,0.929241202634,053-AAE,0.141643966136,176,201,377
6704,-0.645953270361,0.929241202634,053-AAF,0.141643966136,100,152,252
6705,-0.645953270361,0.929241202634,053-AAG,0.141643966136,79,138,217
6706,-0.645953270361,0.929241202634,053-AAH,0.141643966136,103,169,272
6707,-0.645953270361,0.929241202634,053-AAI,0.141643966136,99,147,246
6708,-0.645953270361,0.929241202634,053-AAJ,0.141643966136,101,228,329
6709,-0.645953270361,0.929241202634,053-AAK,0.141643966136,97,128,225
6710,-0.645953270361,0.929241202634,053-AAL,0.141643966136,43,84,127
6711,-0.645953270361,0.929241202634,053-AAM,0.141643966136,104,161,265
6712,-0.645953270361,0.929241202634,053-AAN,0.141643966136,107,163,270
6713,-0.645953270361,0.929241202634,053-AAO,0.141643966136,78,93,171
6714,-0.645953270361,0.929241202634,053-AAP,0.141643966136,67,133,200
6715,-0.645953270361,0.929241202634,053-AAQ,0.141643966136,59,104,163
6716,-0.645953270361,0.929241202634,053-AAR,0.141643966136,82,93,175
6717,-0.645953270361,0.929241202634,053-AAS,0.141643966136,78,98,176
6718,-0.645953270361,0.929241202634,053-AAT,0.141643966136,109,111,220
6719,-0.645953270361,0.929241202634,053-AAU,0.141643966136,41,56,97
6720,-0.645953270361,0.929241202634,053-AAV,0.141643966136,73,119,192
6721,-0.645953270361,0.929241202634,053-AAW,0.141643966136,60,38,98
6722,-0.645953270361,0.929241202634,053-AAX,0.141643966136,144,175,319
6723,-0.645953270361,0.929241202634,053-AAY,0.141643966136,98,143,241
6724,-0.645953270361,0.929241202634,053-AAZ,0.141643966136,80,196,276
6725,-0.645953270361,0.929241202634,053-ABA,0.141643966136,64,153,217
6726,-0.645953270361,0.929241202634,053-ABB,0.141643966136,97,164,261
6727,-0.645953270361,0.929241202634,054-AAA,0.141643966136,81,249,330
6728,-0.645953270361,0.929241202634,054-AAB,0.141643966136,102,330,432
6729,-0.645953270361,0.929241202634,054-AAC,0.141643966136,109,355,464
6730,-0.645953270361,0.929241202634,054-AAD,0.141643966136,55,161,216
6731,-0.645953270361,0.929241202634,054-AAE,0.141643966136,78,208,286
6732,-0.645953270361,0.929241202634,054-AAF,0.141643966136,39,114,153
6733,-0.645953270361,0.929241202634,054-AAG,0.141643966136,77,142,219
6734,-0.645953270361,0.929241202634,054-AAH,0.141643966136,76,178,254
6735,-0.645953270361,0.929241202634,054-AAI,0.141643966136,92,225,317
6736,-0.645953270361,0.929241202634,054-AAJ,0.141643966136,127,372,499
6737,-0.645953270361,0.929241202634,054-AAK,0.141643966136,60,147,207
6738,-0.645953270361,0.929241202634,054-AAL,0.141643966136,53,342,395
6739,-0.645953270361,0.929241202634,054-AAM,0.141643966136,71,388,459
6740,-0.645953270361,0.929241202634,054-AAN,0.141643966136,99,322,421
6741,-0.645953270361,0.929241202634,054-AAO,0.141643966136,74,228,302
6742,-0.645953270361,0.929241202634,054-AAQ,0.141643966136,92,244,336
6743,-0.645953270361,0.929241202634,054-AAS,0.141643966136,70,328,398
6744,-0.645953270361,0.929241202634,054-AAT,0.141643966136,89,332,421
6745,-0.645953270361,0.929241202634,054-AAU,0.141643966136,104,223,327
6746,-0.645953270361,0.929241202634,054-AAW,0.141643966136,153,498,651
6747,-0.645953270361,0.929241202634,054-AAX,0.141643966136,80,304,384
6748,-0.645953270361,0.929241202634,054-AAY,0.141643966136,40,383,423
6749,-0.645953270361,0.929241202634,054-AAZ,0.141643966136,35,310,345
6750,-0.645953270361,0.929241202634,054-ABC,0.141643966136,110,475,585
6751,-0.645953270361,0.929241202634,054-ABD,0.141643966136,63,332,395
6752,-0.645953270361,0.929241202634,054-ABE,0.141643966136,60,293,353
6753,-0.645953270361,0.929241202634,054-ABF,0.141643966136,74,222,296
6754,-0.645953270361,0.929241202634,054-ABG,0.141643966136,103,213,316
6755,-0.645953270361,0.929241202634,054-ABH,0.141643966136,106,366,472
6756,-0.645953270361,0.929241202634,054-ABI,0.141643966136,69,202,271
6757,-0.645953270361,0.929241202634,054-ABL,0.141643966136,102,538,640
6758,-0.645953270361,0.929241202634,054-ABM,0.141643966136,75,603,678
6759,-0.645953270361,0.929241202634,054-ABN,0.141643966136,102,437,539
6760,-0.645953270361,0.929241202634,054-ABO,0.141643966136,47,469,516
6761,-0.645953270361,0.929241202634,054-ABQ,0.141643966136,113,340,453
6762,-0.645953270361,0.929241202634,054-ABS,0.141643966136,52,355,407
6763,-0.645953270361,0.929241202634,054-ABT,0.141643966136,107,442,549
6764,-0.645953270361,0.929241202634,054-ABU,0.141643966136,34,330,364
6765,-0.645953270361,0.929241202634,055-AAA,0.141643966136,77,111,188
6766,-0.645953270361,0.929241202634,055-AAB,0.141643966136,95,173,268
6767,-0.645953270361,0.929241202634,055-AAC,0.141643966136,81,148,229
6768,-0.645953270361,0.929241202634,055-AAD,0.141643966136,103,222,325
6769,-0.645953270361,0.929241202634,055-AAE,0.141643966136,109,204,313
6770,-0.645953270361,0.929241202634,055-AAF,0.141643966136,106,259,365
6771,-0.645953270361,0.929241202634,055-AAG,0.141643966136,142,329,471
6772,-0.645953270361,0.929241202634,055-AAH,0.141643966136,71,230,301
6773,-0.645953270361,0.929241202634,055-AAI,0.141643966136,74,183,257
6774,-0.645953270361,0.929241202634,055-AAJ,0.141643966136,108,218,326
6775,-0.645953270361,0.929241202634,055-AAK,0.141643966136,63,161,224
6776,-0.645953270361,0.929241202634,055-AAL,0.141643966136,95,172,267
6777,-0.645953270361,0.929241202634,055-AAM,0.141643966136,78,155,233
6778,-0.645953270361,0.929241202634,055-AAN,0.141643966136,153,502,655
6779,-0.645953270361,0.929241202634,055-AAO,0.141643966136,100,293,393
6780,-0.645953270361,0.929241202634,055-AAP,0.141643966136,144,403,547
6781,-0.645953270361,0.929241202634,055-AAQ,0.141643966136,121,268,389
6782,-0.645953270361,0.929241202634,055-AAR,0.141643966136,127,304,431
6783,-0.645953270361,0.929241202634,055-AAS,0.141643966136,136,683,819
6784,-0.645953270361,0.929241202634,055-AAT,0.141643966136,139,370,509
6785,-0.645953270361,0.929241202634,055-AAU,0.141643966136,139,394,533
6786,-0.645953270361,0.929241202634,055-AAV,0.141643966136,99,323,422
6787,-0.645953270361,0.929241202634,055-AAW,0.141643966136,98,622,720
6788,-0.645953270361,0.929241202634,055-AAX,0.141643966136,85,160,245
6789,-0.645953270361,0.929241202634,055-AAY,0.141643966136,70,166,236
6790,-0.645953270361,0.929241202634,055-AAZ,0.141643966136,78,232,310
6791,-0.645953270361,0.929241202634,055-ABA,0.141643966136,103,347,450
6792,-0.645953270361,0.929241202634,055-ABB,0.141643966136,114,271,385
6793,-0.645953270361,0.929241202634,055-ABC,0.141643966136,119,373,492
6794,-0.645953270361,0.929241202634,055-ABD,0.141643966136,104,214,318
6795,-0.645953270361,0.929241202634,055-ABE,0.141643966136,102,238,340
6796,-0.645953270361,0.929241202634,055-ABF,0.141643966136,114,330,444
6797,-0.645953270361,0.929241202634,055-ABG,0.141643966136,96,124,220
6798,-0.645953270361,0.929241202634,055-ABH,0.141643966136,129,248,377
6799,-0.645953270361,0.929241202634,055-ABI,0.141643966136,110,215,325
6800,-0.645953270361,0.929241202634,055-ABJ,0.141643966136,81,242,323
6801,-0.645953270361,0.929241202634,055-ABL,0.141643966136,84,192,276
6802,-0.645953270361,0.929241202634,055-ABM,0.141643966136,85,174,259
6803,-0.645953270361,0.929241202634,055-ABN,0.141643966136,168,389,557
6804,-0.645953270361,0.929241202634,055-ABO,0.141643966136,65,161,226
6805,-0.645953270361,0.929241202634,055-ABP,0.141643966136,124,464,588
6806,-0.645953270361,0.929241202634,055-ABQ,0.141643966136,204,645,849
6807,-0.645953270361,0.929241202634,055-ABR,0.141643966136,134,438,572
6808,-0.645953270361,0.929241202634,055-ABS,0.141643966136,87,317,404
6809,-0.645953270361,0.929241202634,055-ABT,0.141643966136,94,431,525
6810,-0.645953270361,0.929241202634,055-ABU,0.141643966136,75,277,352
6811,-0.645953270361,0.929241202634,055-ABV,0.141643966136,52,157,209
6812,-0.645953270361,0.929241202634,055-ABW,0.141643966136,74,289,363
6813,-0.645953270361,0.929241202634,055-ABX,0.141643966136,146,608,754
6814,-0.645953270361,0.929241202634,055-ABY,0.141643966136,76,309,385
6815,-0.645953270361,0.929241202634,055-ABZ,0.141643966136,77,311,388
6816,-0.645953270361,0.929241202634,055-ACA,0.141643966136,147,573,720
6817,-0.645953270361,0.929241202634,055-ACB,0.141643966136,157,554,711
6818,-0.645953270361,0.929241202634,055-ACC,0.141643966136,131,442,573
6819,-0.645953270361,0.929241202634,055-ACD,0.141643966136,76,344,420
6820,-0.645953270361,0.929241202634,055-ACE,0.141643966136,108,367,475
6821,-0.645953270361,0.929241202634,055-ACF,0.141643966136,133,551,684
6822,-0.645953270361,0.929241202634,055-ACG,0.141643966136,124,528,652
6823,-0.645953270361,0.929241202634,055-ACH,0.141643966136,100,397,497
6824,-0.645953270361,0.929241202634,055-ACI,0.141643966136,90,349,439
6825,-0.645953270361,0.929241202634,055-ACJ,0.141643966136,81,176,257
6826,-0.645953270361,0.929241202634,055-ACK,0.141643966136,76,238,314
6827,-0.645953270361,0.929241202634,055-ACL,0.141643966136,118,330,448
6828,-0.645953270361,0.929241202634,055-ACM,0.141643966136,80,365,445
6829,-0.645953270361,0.929241202634,055-ACN,0.141643966136,67,315,382
6830,-0.645953270361,0.929241202634,055-ACO,0.141643966136,76,342,418
6831,-0.645953270361,0.929241202634,055-ACP,0.141643966136,156,635,791
6832,-0.645953270361,0.929241202634,055-ACQ,0.141643966136,93,422,515
6833,-0.645953270361,0.929241202634,055-ACR,0.141643966136,98,282,380
6834,-0.645953270361,0.929241202634,055-ACS,0.141643966136,144,511,655
6835,-0.645953270361,0.929241202634,055-ACT,0.141643966136,80,346,426
6836,-0.645953270361,0.929241202634,055-ACU,0.141643966136,87,310,397
6837,-0.645953270361,0.929241202634,055-ACV,0.141643966136,78,310,388
6838,-0.645953270361,0.929241202634,055-ACW,0.141643966136,78,372,450
6839,-0.645953270361,0.929241202634,055-ACX,0.141643966136,116,352,468
6840,-0.645953270361,0.929241202634,055-ACY,0.141643966136,139,481,620
6841,-0.645953270361,0.929241202634,055-ACZ,0.141643966136,96,348,444
6842,-0.645953270361,0.929241202634,055-ADA,0.141643966136,136,513,649
6843,-0.645953270361,0.929241202634,055-ADB,0.141643966136,100,316,416
6844,-0.645953270361,0.929241202634,055-ADC,0.141643966136,130,554,684
6845,-0.645953270361,0.929241202634,055-ADD,0.141643966136,93,473,566
6846,-0.645953270361,0.929241202634,056-AAA,0.141643966136,114,102,216
6847,-0.645953270361,0.929241202634,056-AAB,0.141643966136,67,54,121
6848,-0.645953270361,0.929241202634,056-AAC,0.141643966136,41,74,115
6849,-0.645953270361,0.929241202634,056-AAD,0.141643966136,128,89,217
6850,-0.645953270361,0.929241202634,056-AAE,0.141643966136,155,94,249
6851,-0.645953270361,0.929241202634,056-AAG,0.141643966136,113,98,211
6852,-0.645953270361,0.929241202634,056-AAH,0.141643966136,96,59,155
6853,-0.645953270361,0.929241202634,056-AAI,0.141643966136,127,101,228
6854,-0.645953270361,0.929241202634,056-AAJ,0.141643966136,98,76,174
6855,-0.645953270361,0.929241202634,056-AAK,0.141643966136,57,93,150
6856,-0.645953270361,0.929241202634,056-AAL,0.141643966136,99,71,170
6857,-0.645953270361,0.929241202634,056-AAM,0.141643966136,93,73,166
6858,-0.645953270361,0.929241202634,056-AAN,0.141643966136,138,86,224
6859,-0.645953270361,0.929241202634,056-AAO,0.141643966136,99,87,186
6860,-0.645953270361,0.929241202634,056-AAP,0.141643966136,84,56,140
6861,-0.645953270361,0.929241202634,056-AAQ,0.141643966136,95,95,190
6862,-0.645953270361,0.929241202634,056-AAR,0.141643966136,109,85,194
6863,-0.645953270361,0.929241202634,056-AAS,0.141643966136,98,84,182
6864,-0.645953270361,0.929241202634,056-AAT,0.141643966136,91,77,168
6865,-0.645953270361,0.929241202634,056-AAU,0.141643966136,62,32,94
6866,-0.645953270361,0.929241202634,056-AAV,0.141643966136,109,106,215
6867,-0.645953270361,0.929241202634,056-AAW,0.141643966136,54,45,99
6868,-0.645953270361,0.929241202634,056-AAX,0.141643966136,159,99,258
6869,-0.645953270361,0.929241202634,056-AAY,0.141643966136,39,38,77
6870,-0.645953270361,0.929241202634,056-AAZ,0.141643966136,149,189,338
6871,-0.645953270361,0.929241202634,056-ABA,0.141643966136,88,86,174
6872,-0.645953270361,0.929241202634,056-ABB,0.141643966136,100,99,199
6873,-0.645953270361,0.929241202634,056-ABC,0.141643966136,76,67,143
6874,-0.645953270361,0.929241202634,057-AAA,0.141643966136,133,283,416
6875,-0.645953270361,0.929241202634,057-AAC,0.141643966136,215,475,690
6876,-0.645953270361,0.929241202634,057-AAE,0.141643966136,114,303,417
6877,-0.645953270361,0.929241202634,057-AAF,0.141643966136,238,428,666
6878,-0.645953270361,0.929241202634,057-AAG,0.141643966136,217,677,894
6879,-0.645953270361,0.929241202634,057-AAH,0.141643966136,193,487,680
6880,-0.645953270361,0.929241202634,057-AAI,0.141643966136,251,580,831
6881,-0.645953270361,0.929241202634,057-AAK,0.141643966136,163,447,610
6882,-0.645953270361,0.929241202634,057-AAL,0.141643966136,137,465,602
6883,-0.645953270361,0.929241202634,057-AAM,0.141643966136,234,532,766
6884,-0.645953270361,0.929241202634,057-AAO,0.141643966136,182,378,560
6885,-0.645953270361,0.929241202634,057-AAP,0.141643966136,199,488,687
6886,-0.645953270361,0.929241202634,057-AAQ,0.141643966136,203,794,997
6887,-0.645953270361,0.929241202634,057-AAR,0.141643966136,216,529,745
6888,-0.645953270361,0.929241202634,057-AAS,0.141643966136,192,478,670
6889,-0.645953270361,0.929241202634,057-AAT,0.141643966136,225,633,858
6890,-0.645953270361,0.929241202634,057-ABC,0.141643966136,43,38,81
6891,-0.645953270361,0.929241202634,057-ABD,0.141643966136,327,158,485
6892,-0.645953270361,0.929241202634,057-ABE,0.141643966136,334,126,460
6893,-0.645953270361,0.929241202634,057-ABF,0.141643966136,91,87,178
6894,-0.645953270361,0.929241202634,057-ABG,0.141643966136,212,135,347
6895,-0.645953270361,0.929241202634,057-ABH,0.141643966136,108,76,184
6896,-0.645953270361,0.929241202634,057-ABM,0.141643966136,179,198,377
6897,-0.645953270361,0.929241202634,057-ABN,0.141643966136,170,111,281
6898,-0.645953270361,0.929241202634,057-ABP,0.141643966136,126,178,304
6899,-0.645953270361,0.929241202634,057-ABU,0.141643966136,97,93,190
6900,-0.645953270361,0.929241202634,057-ABV,0.141643966136,78,155,233
6901,-0.645953270361,0.929241202634,057-ABW,0.141643966136,174,329,503
6902,-0.645953270361,0.929241202634,057-ABX,0.141643966136,187,182,369
6903,-0.645953270361,0.929241202634,057-ABY,0.141643966136,125,119,244
6904,-0.645953270361,0.929241202634,057-ABZ,0.141643966136,290,301,591
6905,-0.645953270361,0.929241202634,057-ACA,0.141643966136,130,202,332
6906,-0.645953270361,0.929241202634,057-ACB,0.141643966136,137,188,325
6907,-0.645953270361,0.929241202634,057-ACC,0.141643966136,286,405,691
6908,-0.645953270361,0.929241202634,057-ACD,0.141643966136,195,242,437
6909,-0.645953270361,0.929241202634,057-ACE,0.141643966136,207,438,645
6910,-0.645953270361,0.929241202634,057-ACF,0.141643966136,155,282,437
6911,-0.645953270361,0.929241202634,057-ACK,0.141643966136,185,71,256
6912,-0.645953270361,0.929241202634,057-ACL,0.141643966136,249,119,368
6913,-0.645953270361,0.929241202634,057-ACM,0.141643966136,177,55,232
6914,-0.645953270361,0.929241202634,057-ACO,0.141643966136,153,43,196
6915,-0.645953270361,0.929241202634,057-ACR,0.141643966136,227,17,244
6916,-0.645953270361,0.929241202634,057-ACT,0.141643966136,264,47,311
6917,-0.645953270361,0.929241202634,057-ACU,0.141643966136,230,6,236
6918,-0.645953270361,0.929241202634,057-ACV,0.141643966136,220,8,228
6919,-0.645953270361,0.929241202634,057-ACW,0.141643966136,302,39,341
6920,-0.645953270361,0.929241202634,057-ADA,0.141643966136,405,17,422
6921,-0.645953270361,0.929241202634,057-ADB,0.141643966136,265,10,275
6922,-0.645953270361,0.929241202634,057-ADC,0.141643966136,431,12,443
6923,-0.645953270361,0.929241202634,057-ADD,0.141643966136,336,10,346
6924,-0.645953270361,0.929241202634,057-ADJ,0.141643966136,333,10,343
6925,-0.645953270361,0.929241202634,057-ADK,0.141643966136,195,17,212
6926,-0.645953270361,0.929241202634,057-ADO,0.141643966136,257,311,568
6927,-0.645953270361,0.929241202634,057-ADP,0.141643966136,190,259,449
6928,-0.645953270361,0.929241202634,057-ADQ,0.141643966136,153,150,303
6929,-0.645953270361,0.929241202634,057-ADS,0.141643966136,157,219,376
6930,-0.645953270361,0.929241202634,057-ADY,0.141643966136,205,353,558
6931,-0.645953270361,0.929241202634,057-ADZ,0.141643966136,207,300,507
6932,-0.645953270361,0.929241202634,057-AEA,0.141643966136,169,238,407
6933,-0.645953270361,0.929241202634,057-AEC,0.141643966136,250,353,603
6934,-0.645953270361,0.929241202634,057-AEH,0.141643966136,151,208,359
6935,-0.645953270361,0.929241202634,057-AEJ,0.141643966136,111,150,261
6936,-0.645953270361,0.929241202634,057-AEK,0.141643966136,151,233,384
6937,-0.645953270361,0.929241202634,057-AEM,0.141643966136,99,219,318
6938,-0.645953270361,0.929241202634,057-AEN,0.141643966136,139,205,344
6939,-0.645953270361,0.929241202634,057-AEQ,0.141643966136,178,207,385
6940,-0.645953270361,0.929241202634,057-AER,0.141643966136,114,138,252
6941,-0.645953270361,0.929241202634,057-AET,0.141643966136,231,265,496
6942,-0.645953270361,0.929241202634,057-AEU,0.141643966136,180,236,416
6943,-0.645953270361,0.929241202634,057-AEZ,0.141643966136,178,286,464
6944,-0.645953270361,0.929241202634,057-AFA,0.141643966136,128,124,252
6945,-0.645953270361,0.929241202634,057-AFC,0.141643966136,129,109,238
6946,-0.645953270361,0.929241202634,057-AFE,0.141643966136,186,225,411
6947,-0.645953270361,0.929241202634,057-AFH,0.141643966136,412,15,427
6948,-0.645953270361,0.929241202634,057-AFI,0.141643966136,239,8,247
6949,-0.645953270361,0.929241202634,057-AFO,0.141643966136,367,23,390
6950,-0.645953270361,0.929241202634,057-AFP,0.141643966136,237,4,241
6951,-0.645953270361,0.929241202634,057-AFQ,0.141643966136,457,23,480
6952,-0.645953270361,0.929241202634,057-AFR,0.141643966136,351,1,352
6953,-0.645953270361,0.929241202634,057-AFX,0.141643966136,480,13,493
6954,-0.645953270361,0.929241202634,057-AFY,0.141643966136,523,21,544
6955,-0.645953270361,0.929241202634,057-AFZ,0.141643966136,327,10,337
6956,-0.645953270361,0.929241202634,057-AGA,0.141643966136,369,20,389
6957,-0.645953270361,0.929241202634,057-AGG,0.141643966136,384,24,408
6958,-0.645953270361,0.929241202634,057-AGH,0.141643966136,305,16,321
6959,-0.645953270361,0.929241202634,057-AGI,0.141643966136,345,20,365
6960,-0.645953270361,0.929241202634,057-AGJ,0.141643966136,667,27,694
6961,-0.645953270361,0.929241202634,057-AGK,0.141643966136,402,24,426
6962,-0.645953270361,0.929241202634,057-AGO,0.141643966136,210,54,264
6963,-0.645953270361,0.929241202634,057-AGQ,0.141643966136,450,54,504
6964,-0.645953270361,0.929241202634,057-AGR,0.141643966136,186,52,238
6965,-0.645953270361,0.929241202634,057-AGS,0.141643966136,289,66,355
6966,-0.645953270361,0.929241202634,057-AGZ,0.141643966136,284,42,326
6967,-0.645953270361,0.929241202634,057-AHA,0.141643966136,375,118,493
6968,-0.645953270361,0.929241202634,057-AHB,0.141643966136,231,73,304
6969,-0.645953270361,0.929241202634,057-AHC,0.141643966136,232,94,326
6970,-0.645953270361,0.929241202634,057-AHH,0.141643966136,140,4,144
6971,-0.645953270361,0.929241202634,057-AHI,0.141643966136,330,9,339
6972,-0.645953270361,0.929241202634,057-AHJ,0.141643966136,424,14,438
6973,-0.645953270361,0.929241202634,057-AHK,0.141643966136,168,6,174
6974,-0.645953270361,0.929241202634,057-AHO,0.141643966136,244,384,628
6975,-0.645953270361,0.929241202634,057-AHP,0.141643966136,205,359,564
6976,-0.645953270361,0.929241202634,057-AHQ,0.141643966136,165,353,518
6977,-0.645953270361,0.929241202634,057-AHR,0.141643966136,93,145,238
6978,-0.645953270361,0.929241202634,057-AHW,0.141643966136,237,14,251
6979,-0.645953270361,0.929241202634,057-AHX,0.141643966136,339,13,352
6980,-0.645953270361,0.929241202634,057-AHY,0.141643966136,520,19,539
6981,-0.645953270361,0.929241202634,057-AID,0.141643966136,563,53,616
6982,-0.645953270361,0.929241202634,057-AIE,0.141643966136,640,79,719
6983,-0.645953270361,0.929241202634,057-AIF,0.141643966136,585,14,599
6984,-0.645953270361,0.929241202634,057-AIM,0.141643966136,215,369,584
6985,-0.645953270361,0.929241202634,057-AIN,0.141643966136,230,429,659
6986,-0.645953270361,0.929241202634,057-AIO,0.141643966136,137,253,390
6987,-0.645953270361,0.929241202634,057-AIP,0.141643966136,205,382,587
6988,-0.645953270361,0.929241202634,057-AIQ,0.141643966136,179,281,460
6989,-0.645953270361,0.929241202634,057-AIR,0.141643966136,166,396,562
6990,-0.645953270361,0.929241202634,057-AIS,0.141643966136,210,406,616
6991,-0.645953270361,0.929241202634,057-AIT,0.141643966136,139,301,440
6992,-0.645953270361,0.929241202634,057-AIV,0.141643966136,181,309,490
6993,-0.645953270361,0.929241202634,057-AIX,0.141643966136,133,235,368
6994,-0.645953270361,0.929241202634,057-AJA,0.141643966136,128,213,341
6995,-0.645953270361,0.929241202634,057-AJB,0.141643966136,303,477,780
6996,-0.645953270361,0.929241202634,057-AJC,0.141643966136,174,117,291
6997,-0.645953270361,0.929241202634,057-AJD,0.141643966136,237,412,649
6998,-0.645953270361,0.929241202634,057-AJF,0.141643966136,248,416,664
6999,-0.645953270361,0.929241202634,057-AJG,0.141643966136,175,290,465
7000,-0.645953270361,0.929241202634,057-AJI,0.141643966136,268,456,724
7001,-0.645953270361,0.929241202634,057-AJJ,0.141643966136,262,476,738
7002,-0.645953270361,0.929241202634,057-AJN,0.141643966136,232,384,616
7003,-0.645953270361,0.929241202634,057-AJO,0.141643966136,106,69,175
7004,-0.645953270361,0.929241202634,057-AJP,0.141643966136,182,414,596
7005,-0.645953270361,0.929241202634,057-AJQ,0.141643966136,144,276,420
7006,-0.645953270361,0.929241202634,057-AJU,0.141643966136,174,228,402
7007,-0.645953270361,0.929241202634,057-AJV,0.141643966136,162,237,399
7008,-0.645953270361,0.929241202634,057-AJW,0.141643966136,259,389,648
7009,-0.645953270361,0.929241202634,057-AJY,0.141643966136,140,142,282
7010,-0.645953270361,0.929241202634,057-AKB,0.141643966136,150,220,370
7011,-0.645953270361,0.929241202634,057-AKD,0.141643966136,261,369,630
7012,-0.645953270361,0.929241202634,057-AKF,0.141643966136,211,283,494
7013,-0.645953270361,0.929241202634,057-AKJ,0.141643966136,271,530,801
7014,-0.645953270361,0.929241202634,057-AKK,0.141643966136,250,528,778
7015,-0.645953270361,0.929241202634,057-AKM,0.141643966136,297,417,714
7016,-0.645953270361,0.929241202634,057-AKQ,0.141643966136,153,216,369
7017,-0.645953270361,0.929241202634,057-AKR,0.141643966136,154,322,476
7018,-0.645953270361,0.929241202634,057-AKS,0.141643966136,142,314,456
7019,-0.645953270361,0.929241202634,057-AKT,0.141643966136,99,134,233
7020,-0.645953270361,0.929241202634,057-AKU,0.141643966136,170,302,472
7021,-0.645953270361,0.929241202634,057-AKV,0.141643966136,159,333,492
7022,-0.645953270361,0.929241202634,057-AKW,0.141643966136,209,383,592
7023,-0.645953270361,0.929241202634,057-AKY,0.141643966136,168,354,522
7024,-0.645953270361,0.929241202634,057-AKZ,0.141643966136,274,556,830
7025,-0.645953270361,0.929241202634,057-ALH,0.141643966136,243,454,697
7026,-0.645953270361,0.929241202634,057-ALI,0.141643966136,267,573,840
7027,-0.645953270361,0.929241202634,057-ALJ,0.141643966136,178,429,607
7028,-0.645953270361,0.929241202634,057-ALK,0.141643966136,286,411,697
7029,-0.645953270361,0.929241202634,057-ALL,0.141643966136,237,622,859
7030,-0.645953270361,0.929241202634,057-ALN,0.141643966136,144,347,491
7031,-0.645953270361,0.929241202634,057-ALO,0.141643966136,203,510,713
7032,-0.645953270361,0.929241202634,057-ALP,0.141643966136,89,195,284
7033,-0.645953270361,0.929241202634,057-ALQ,0.141643966136,132,308,440
7034,-0.645953270361,0.929241202634,057-AMB,0.141643966136,182,324,506
7035,-0.645953270361,0.929241202634,057-AMC,0.141643966136,166,397,563
7036,-0.645953270361,0.929241202634,057-AMD,0.141643966136,140,167,307
7037,-0.645953270361,0.929241202634,057-AME,0.141643966136,179,309,488
7038,-0.645953270361,0.929241202634,057-AMF,0.141643966136,127,299,426
7039,-0.645953270361,0.929241202634,057-AMH,0.141643966136,211,348,559
7040,-0.645953270361,0.929241202634,057-AMI,0.141643966136,133,403,536
7041,-0.645953270361,0.929241202634,057-AMK,0.141643966136,206,367,573
7042,-0.645953270361,0.929241202634,057-AML,0.141643966136,297,670,967
7043,-0.645953270361,0.929241202634,057-AMM,0.141643966136,147,322,469
7044,-0.645953270361,0.929241202634,057-AMO,0.141643966136,152,403,555
7045,-0.645953270361,0.929241202634,057-AMX,0.141643966136,267,463,730
7046,-0.645953270361,0.929241202634,057-AMY,0.141643966136,310,368,678
7047,-0.645953270361,0.929241202634,057-AMZ,0.141643966136,158,320,478
7048,-0.645953270361,0.929241202634,057-ANA,0.141643966136,206,362,568
7049,-0.645953270361,0.929241202634,057-ANB,0.141643966136,153,338,491
7050,-0.645953270361,0.929241202634,057-ANC,0.141643966136,243,375,618
7051,-0.645953270361,0.929241202634,057-AND,0.141643966136,214,552,766
7052,-0.645953270361,0.929241202634,057-ANE,0.141643966136,171,242,413
7053,-0.645953270361,0.929241202634,057-ANF,0.141643966136,211,383,594
7054,-0.645953270361,0.929241202634,057-ANG,0.141643966136,174,307,481
7055,-0.645953270361,0.929241202634,057-ANH,0.141643966136,176,337,513
7056,-0.645953270361,0.929241202634,057-ANU,0.141643966136,131,387,518
7057,-0.645953270361,0.929241202634,057-ANV,0.141643966136,147,363,510
7058,-0.645953270361,0.929241202634,057-ANX,0.141643966136,135,351,486
7059,-0.645953270361,0.929241202634,057-ANZ,0.141643966136,79,144,223
7060,-0.645953270361,0.929241202634,057-AOA,0.141643966136,153,274,427
7061,-0.645953270361,0.929241202634,057-AOB,0.141643966136,157,474,631
7062,-0.645953270361,0.929241202634,057-AOE,0.141643966136,107,300,407
7063,-0.645953270361,0.929241202634,057-AOF,0.141643966136,201,529,730
7064,-0.645953270361,0.929241202634,057-AOG,0.141643966136,173,430,603
7065,-0.645953270361,0.929241202634,057-AOJ,0.141643966136,194,505,699
7066,-0.645953270361,0.929241202634,057-AOK,0.141643966136,110,373,483
7067,-0.645953270361,0.929241202634,057-AON,0.141643966136,108,347,455
7068,-0.645953270361,0.929241202634,057-AOO,0.141643966136,164,564,728
7069,-0.645953270361,0.929241202634,057-AOP,0.141643966136,127,191,318
7070,-0.645953270361,0.929241202634,057-AOR,0.141643966136,167,301,468
7071,-0.645953270361,0.929241202634,057-AOT,0.141643966136,118,218,336
7072,-0.645953270361,0.929241202634,057-AOU,0.141643966136,204,228,432
7073,-0.645953270361,0.929241202634,057-AOV,0.141643966136,256,476,732
7074,-0.645953270361,0.929241202634,057-AOW,0.141643966136,266,478,744
7075,-0.645953270361,0.929241202634,057-AOX,0.141643966136,213,286,499
7076,-0.645953270361,0.929241202634,057-AOY,0.141643966136,239,380,619
7077,-0.645953270361,0.929241202634,057-AOZ,0.141643966136,208,259,467
7078,-0.645953270361,0.929241202634,057-APA,0.141643966136,214,257,471
7079,-0.645953270361,0.929241202634,057-APB,0.141643966136,265,536,801
7080,-0.645953270361,0.929241202634,057-API,0.141643966136,36,102,138
7081,-0.645953270361,0.929241202634,057-APJ,0.141643966136,183,323,506
7082,-0.645953270361,0.929241202634,057-APK,0.141643966136,169,326,495
7083,-0.645953270361,0.929241202634,057-APL,0.141643966136,163,283,446
7084,-0.645953270361,0.929241202634,057-APM,0.141643966136,219,450,669
7085,-0.645953270361,0.929241202634,057-APN,0.141643966136,95,179,274
7086,-0.645953270361,0.929241202634,057-APP,0.141643966136,142,230,372
7087,-0.645953270361,0.929241202634,057-APQ,0.141643966136,106,109,215
7088,-0.645953270361,0.929241202634,057-APR,0.141643966136,231,410,641
7089,-0.645953270361,0.929241202634,057-APS,0.141643966136,134,223,357
7090,-0.645953270361,0.929241202634,057-APT,0.141643966136,156,390,546
7091,-0.645953270361,0.929241202634,057-APU,0.141643966136,198,383,581
7092,-0.645953270361,0.929241202634,057-APY,0.141643966136,226,333,559
7093,-0.645953270361,0.929241202634,057-APZ,0.141643966136,173,283,456
7094,-0.645953270361,0.929241202634,057-AQI,0.141643966136,494,152,646
7095,-0.645953270361,0.929241202634,057-AQJ,0.141643966136,262,93,355
7096,-0.645953270361,0.929241202634,057-AQK,0.141643966136,325,26,351
7097,-0.645953270361,0.929241202634,057-AQL,0.141643966136,326,33,359
7098,-0.645953270361,0.929241202634,057-AQM,0.141643966136,483,49,532
7099,-0.645953270361,0.929241202634,057-AQN,0.141643966136,348,94,442
7100,-0.645953270361,0.929241202634,057-AQQ,0.141643966136,525,96,621
7101,-0.645953270361,0.929241202634,057-AQR,0.141643966136,501,46,547
7102,-0.645953270361,0.929241202634,057-AQS,0.141643966136,395,52,447
7103,-0.645953270361,0.929241202634,057-AQT,0.141643966136,232,163,395
7104,-0.645953270361,0.929241202634,057-AQU,0.141643966136,404,41,445
7105,-0.645953270361,0.929241202634,057-AQX,0.141643966136,406,164,570
7106,-0.645953270361,0.929241202634,057-AQY,0.141643966136,465,334,799
7107,-0.645953270361,0.929241202634,057-AQZ,0.141643966136,193,129,322
7108,-0.645953270361,0.929241202634,057-ARD,0.141643966136,621,53,674
7109,-0.645953270361,0.929241202634,057-ARE,0.141643966136,441,45,486
7110,-0.645953270361,0.929241202634,057-ARF,0.141643966136,143,33,176
7111,-0.645953270361,0.929241202634,057-ARI,0.141643966136,153,395,548
7112,-0.645953270361,0.929241202634,057-ARJ,0.141643966136,158,374,532
7113,-0.645953270361,0.929241202634,057-ARK,0.141643966136,171,521,692
7114,-0.645953270361,0.929241202634,057-ARL,0.141643966136,121,335,456
7115,-0.645953270361,0.929241202634,057-ARO,0.141643966136,151,446,597
7116,-0.645953270361,0.929241202634,057-ARP,0.141643966136,106,258,364
7117,-0.645953270361,0.929241202634,057-ARQ,0.141643966136,219,421,640
7118,-0.645953270361,0.929241202634,057-ARR,0.141643966136,127,278,405
7119,-0.645953270361,0.929241202634,057-ARS,0.141643966136,86,276,362
7120,-0.645953270361,0.929241202634,057-ART,0.141643966136,118,216,334
7121,-0.645953270361,0.929241202634,057-ARU,0.141643966136,131,420,551
7122,-0.645953270361,0.929241202634,057-ARV,0.141643966136,192,681,873
7123,-0.645953270361,0.929241202634,057-ARX,0.141643966136,223,545,768
7124,-0.645953270361,0.929241202634,057-ASA,0.141643966136,209,509,718
7125,-0.645953270361,0.929241202634,057-ASE,0.141643966136,217,401,618
7126,-0.645953270361,0.929241202634,057-ASF,0.141643966136,152,343,495
7127,-0.645953270361,0.929241202634,057-ASG,0.141643966136,135,273,408
7128,-0.645953270361,0.929241202634,057-ASH,0.141643966136,198,500,698
7129,-0.645953270361,0.929241202634,057-ASI,0.141643966136,194,203,397
7130,-0.645953270361,0.929241202634,057-ASJ,0.141643966136,218,372,590
7131,-0.645953270361,0.929241202634,057-ASK,0.141643966136,214,417,631
7132,-0.645953270361,0.929241202634,057-ASU,0.141643966136,181,605,786
7133,-0.645953270361,0.929241202634,057-ASV,0.141643966136,142,280,422
7134,-0.645953270361,0.929241202634,057-ASW,0.141643966136,174,545,719
7135,-0.645953270361,0.929241202634,057-ASX,0.141643966136,192,525,717
7136,-0.645953270361,0.929241202634,057-ASZ,0.141643966136,131,354,485
7137,-0.645953270361,0.929241202634,057-ATA,0.141643966136,135,249,384
7138,-0.645953270361,0.929241202634,057-ATB,0.141643966136,133,383,516
7139,-0.645953270361,0.929241202634,057-ATE,0.141643966136,35,160,195
7140,-0.645953270361,0.929241202634,057-ATF,0.141643966136,104,334,438
7141,-0.645953270361,0.929241202634,057-ATG,0.141643966136,84,383,467
7142,-0.645953270361,0.929241202634,057-ATH,0.141643966136,149,522,671
7143,-0.645953270361,0.929241202634,057-ATJ,0.141643966136,107,353,460
7144,-0.645953270361,0.929241202634,057-ATK,0.141643966136,139,452,591
7145,-0.645953270361,0.929241202634,057-ATL,0.141643966136,134,483,617
7146,-0.645953270361,0.929241202634,057-ATM,0.141643966136,95,379,474
7147,-0.645953270361,0.929241202634,057-ATO,0.141643966136,185,509,694
7148,-0.645953270361,0.929241202634,057-ATP,0.141643966136,119,435,554
7149,-0.645953270361,0.929241202634,057-ATR,0.141643966136,200,507,707
7150,-0.645953270361,0.929241202634,057-ATS,0.141643966136,172,445,617
7151,-0.645953270361,0.929241202634,057-ATU,0.141643966136,109,348,457
7152,-0.645953270361,0.929241202634,057-ATX,0.141643966136,85,131,216
7153,-0.645953270361,0.929241202634,057-ATZ,0.141643966136,176,272,448
7154,-0.645953270361,0.929241202634,057-AUB,0.141643966136,139,210,349
7155,-0.645953270361,0.929241202634,057-AUD,0.141643966136,410,346,756
7156,-0.645953270361,0.929241202634,057-AUE,0.141643966136,74,156,230
7157,-0.645953270361,0.929241202634,057-AUF,0.141643966136,486,125,611
7158,-0.645953270361,0.929241202634,057-AUG,0.141643966136,352,81,433
7159,-0.645953270361,0.929241202634,057-AUH,0.141643966136,301,132,433
7160,-0.645953270361,0.929241202634,057-AUI,0.141643966136,524,109,633
7161,-0.645953270361,0.929241202634,057-AUJ,0.141643966136,273,53,326
7162,-0.645953270361,0.929241202634,057-AUK,0.141643966136,542,329,871
7163,-0.645953270361,0.929241202634,057-AUL,0.141643966136,397,69,466
7164,-0.645953270361,0.929241202634,057-AUM,0.141643966136,136,205,341
7165,-0.645953270361,0.929241202634,057-AUN,0.141643966136,214,34,248
7166,-0.645953270361,0.929241202634,057-AUZ,0.141643966136,81,273,354
7167,-0.645953270361,0.929241202634,057-AVA,0.141643966136,73,210,283
7168,-0.645953270361,0.929241202634,057-AVB,0.141643966136,159,322,481
7169,-0.645953270361,0.929241202634,057-AVD,0.141643966136,152,573,725
7170,-0.645953270361,0.929241202634,057-AVE,0.141643966136,105,342,447
7171,-0.645953270361,0.929241202634,057-AVG,0.141643966136,452,213,665
7172,-0.645953270361,0.929241202634,057-AVH,0.141643966136,300,89,389
7173,-0.645953270361,0.929241202634,057-AVI,0.141643966136,456,225,681
7174,-0.645953270361,0.929241202634,057-AVJ,0.141643966136,470,28,498
7175,-0.645953270361,0.929241202634,057-AVP,0.141643966136,153,362,515
7176,-0.645953270361,0.929241202634,057-AVQ,0.141643966136,221,455,676
7177,-0.645953270361,0.929241202634,057-AVR,0.141643966136,136,378,514
7178,-0.645953270361,0.929241202634,057-AVS,0.141643966136,132,211,343
7179,-0.645953270361,0.929241202634,057-AVT,0.141643966136,187,623,810
7180,-0.645953270361,0.929241202634,057-AVU,0.141643966136,123,269,392
7181,-0.645953270361,0.929241202634,057-AVV,0.141643966136,132,273,405
7182,-0.645953270361,0.929241202634,057-AVW,0.141643966136,162,280,442
7183,-0.645953270361,0.929241202634,057-AVX,0.141643966136,123,152,275
7184,-0.645953270361,0.929241202634,057-AVY,0.141643966136,111,272,383
7185,-0.645953270361,0.929241202634,057-AVZ,0.141643966136,168,425,593
7186,-0.645953270361,0.929241202634,057-AWA,0.141643966136,136,368,504
7187,-0.645953270361,0.929241202634,057-AWC,0.141643966136,111,457,568
7188,-0.645953270361,0.929241202634,057-AWD,0.141643966136,245,498,743
7189,-0.645953270361,0.929241202634,057-AWE,0.141643966136,103,76,179
7190,-0.645953270361,0.929241202634,057-AWF,0.141643966136,119,237,356
7191,-0.645953270361,0.929241202634,057-AWG,0.141643966136,112,158,270
7192,-0.645953270361,0.929241202634,057-AWH,0.141643966136,143,449,592
7193,-0.645953270361,0.929241202634,057-AWI,0.141643966136,162,432,594
7194,-0.645953270361,0.929241202634,057-AWJ,0.141643966136,136,263,399
7195,-0.645953270361,0.929241202634,057-AWO,0.141643966136,86,204,290
7196,-0.645953270361,0.929241202634,057-AWQ,0.141643966136,82,322,404
7197,-0.645953270361,0.929241202634,057-AWR,0.141643966136,128,371,499
7198,-0.645953270361,0.929241202634,057-AWS,0.141643966136,117,380,497
7199,-0.645953270361,0.929241202634,057-AWT,0.141643966136,121,363,484
7200,-0.645953270361,0.929241202634,057-AWU,0.141643966136,236,320,556
7201,-0.645953270361,0.929241202634,057-AWV,0.141643966136,174,414,588
7202,-0.645953270361,0.929241202634,057-AWW,0.141643966136,262,318,580
7203,-0.645953270361,0.929241202634,057-AWY,0.141643966136,134,185,319
7204,-0.645953270361,0.929241202634,057-AWZ,0.141643966136,274,408,682
7205,-0.645953270361,0.929241202634,057-AXA,0.141643966136,324,374,698
7206,-0.645953270361,0.929241202634,057-AXD,0.141643966136,281,340,621
7207,-0.645953270361,0.929241202634,057-AXE,0.141643966136,240,261,501
7208,-0.645953270361,0.929241202634,057-AXF,0.141643966136,341,325,666
7209,-0.645953270361,0.929241202634,057-AXI,0.141643966136,232,571,803
7210,-0.645953270361,0.929241202634,057-AXK,0.141643966136,172,511,683
7211,-0.645953270361,0.929241202634,057-AXM,0.141643966136,120,349,469
7212,-0.645953270361,0.929241202634,057-AXO,0.141643966136,209,552,761
7213,-0.645953270361,0.929241202634,057-AXQ,0.141643966136,211,564,775
7214,-0.645953270361,0.929241202634,057-AXS,0.141643966136,134,288,422
7215,-0.645953270361,0.929241202634,057-AXU,0.141643966136,255,669,924
7216,-0.645953270361,0.929241202634,057-AXW,0.141643966136,181,627,808
7217,-0.645953270361,0.929241202634,057-AXY,0.141643966136,176,289,465
7218,-0.645953270361,0.929241202634,057-AYA,0.141643966136,205,449,654
7219,-0.645953270361,0.929241202634,057-AYC,0.141643966136,214,649,863
7220,-0.645953270361,0.929241202634,057-AYE,0.141643966136,184,369,553
7221,-0.645953270361,0.929241202634,057-AYF,0.141643966136,140,419,559
7222,-0.645953270361,0.929241202634,057-AYH,0.141643966136,129,499,628
7223,-0.645953270361,0.929241202634,057-AYI,0.141643966136,134,439,573
7224,-0.645953270361,0.929241202634,057-AYJ,0.141643966136,179,419,598
7225,-0.645953270361,0.929241202634,057-AYL,0.141643966136,143,364,507
7226,-0.645953270361,0.929241202634,057-AYM,0.141643966136,144,294,438
7227,-0.645953270361,0.929241202634,057-AYN,0.141643966136,110,295,405
7228,-0.645953270361,0.929241202634,057-AYO,0.141643966136,171,472,643
7229,-0.645953270361,0.929241202634,057-AYP,0.141643966136,133,236,369
7230,-0.645953270361,0.929241202634,057-AYQ,0.141643966136,143,393,536
7231,-0.645953270361,0.929241202634,057-AYR,0.141643966136,186,447,633
7232,-0.645953270361,0.929241202634,057-AYS,0.141643966136,155,503,658
7233,-0.645953270361,0.929241202634,057-AYZ,0.141643966136,133,128,261
7234,-0.645953270361,0.929241202634,058-AAA,0.141643966136,101,156,257
7235,-0.645953270361,0.929241202634,058-AAB,0.141643966136,90,231,321
7236,-0.645953270361,0.929241202634,058-AAC,0.141643966136,52,78,130
7237,-0.645953270361,0.929241202634,058-AAD,0.141643966136,76,138,214
7238,-0.645953270361,0.929241202634,058-AAF,0.141643966136,218,271,489
7239,-0.645953270361,0.929241202634,058-AAI,0.141643966136,170,371,541
7240,-0.645953270361,0.929241202634,058-AAL,0.141643966136,151,207,358
7241,-0.645953270361,0.929241202634,058-AAN,0.141643966136,85,258,343
7242,-0.645953270361,0.929241202634,058-AAP,0.141643966136,109,299,408
7243,-0.645953270361,0.929241202634,058-AAQ,0.141643966136,111,226,337
7244,-0.645953270361,0.929241202634,058-AAS,0.141643966136,94,128,222
7245,-0.645953270361,0.929241202634,058-AAU,0.141643966136,214,388,602
7246,-0.645953270361,0.929241202634,058-AAW,0.141643966136,130,124,254
7247,-0.645953270361,0.929241202634,059-AAA,0.141643966136,116,285,401
7248,-0.645953270361,0.929241202634,059-AAC,0.141643966136,128,397,525
7249,-0.645953270361,0.929241202634,059-AAD,0.141643966136,88,262,350
7250,-0.645953270361,0.929241202634,059-AAE,0.141643966136,116,319,435
7251,-0.645953270361,0.929241202634,059-AAF,0.141643966136,65,159,224
7252,-0.645953270361,0.929241202634,059-AAG,0.141643966136,50,152,202
7253,-0.645953270361,0.929241202634,059-AAH,0.141643966136,78,265,343
7254,-0.645953270361,0.929241202634,059-AAI,0.141643966136,74,202,276
7255,-0.645953270361,0.929241202634,059-AAJ,0.141643966136,114,284,398
7256,-0.645953270361,0.929241202634,059-AAK,0.141643966136,139,410,549
7257,-0.645953270361,0.929241202634,059-AAL,0.141643966136,114,413,527
7258,-0.645953270361,0.929241202634,059-AAM,0.141643966136,38,83,121
7259,-0.645953270361,0.929241202634,059-AAN,0.141643966136,51,180,231
7260,-0.645953270361,0.929241202634,059-AAO,0.141643966136,72,213,285
7261,-0.645953270361,0.929241202634,059-AAP,0.141643966136,73,254,327
7262,-0.645953270361,0.929241202634,059-AAQ,0.141643966136,68,151,219
7263,-0.645953270361,0.929241202634,059-AAR,0.141643966136,93,188,281
7264,-0.645953270361,0.929241202634,059-AAS,0.141643966136,93,218,311
7265,-0.645953270361,0.929241202634,059-AAT,0.141643966136,50,119,169
7266,-0.645953270361,0.929241202634,059-AAV,0.141643966136,95,256,351
7267,-0.645953270361,0.929241202634,059-AAW,0.141643966136,73,171,244
7268,-0.645953270361,0.929241202634,059-AAX,0.141643966136,109,219,328
7269,-0.645953270361,0.929241202634,059-AAY,0.141643966136,83,270,353
7270,-0.645953270361,0.929241202634,059-AAZ,0.141643966136,81,162,243
7271,-0.645953270361,0.929241202634,059-ABA,0.141643966136,66,188,254
7272,-0.645953270361,0.929241202634,059-ABB,0.141643966136,46,133,179
7273,-0.645953270361,0.929241202634,059-ABC,0.141643966136,130,324,454
7274,-0.645953270361,0.929241202634,059-ABD,0.141643966136,69,249,318
7275,-0.645953270361,0.929241202634,059-ABE,0.141643966136,77,222,299
7276,-0.645953270361,0.929241202634,059-ABF,0.141643966136,104,294,398
7277,-0.645953270361,0.929241202634,059-ABH,0.141643966136,131,284,415
7278,-0.645953270361,0.929241202634,059-ABI,0.141643966136,94,309,403
7279,-0.645953270361,0.929241202634,059-ABJ,0.141643966136,131,280,411
7280,-0.645953270361,0.929241202634,060-AAA,0.141643966136,71,66,137
7281,-0.645953270361,0.929241202634,060-AAB,0.141643966136,72,72,144
7282,-0.645953270361,0.929241202634,060-AAC,0.141643966136,63,71,134
7283,-0.645953270361,0.929241202634,060-AAD,0.141643966136,58,76,134
7284,-0.645953270361,0.929241202634,060-AAE,0.141643966136,57,96,153
7285,-0.645953270361,0.929241202634,060-AAF,0.141643966136,107,130,237
7286,-0.645953270361,0.929241202634,060-AAG,0.141643966136,115,92,207
7287,-0.645953270361,0.929241202634,060-AAH,0.141643966136,113,91,204
7288,-0.645953270361,0.929241202634,060-AAI,0.141643966136,113,74,187
7289,-0.645953270361,0.929241202634,060-AAJ,0.141643966136,121,58,179
7290,-0.645953270361,0.929241202634,060-AAK,0.141643966136,152,33,185
7291,-0.645953270361,0.929241202634,060-AAL,0.141643966136,111,92,203
7292,-0.645953270361,0.929241202634,060-AAM,0.141643966136,173,88,261
7293,-0.645953270361,0.929241202634,060-AAN,0.141643966136,134,199,333
7294,-0.645953270361,0.929241202634,060-AAO,0.141643966136,126,152,278
7295,-0.645953270361,0.929241202634,060-AAP,0.141643966136,99,193,292
7296,-0.645953270361,0.929241202634,060-AAQ,0.141643966136,101,153,254
7297,-0.645953270361,0.929241202634,060-AAR,0.141643966136,112,178,290
7298,-0.645953270361,0.929241202634,060-AAS,0.141643966136,119,187,306
7299,-0.645953270361,0.929241202634,060-AAT,0.141643966136,121,190,311
7300,-0.645953270361,0.929241202634,060-AAU,0.141643966136,131,182,313
7301,-0.645953270361,0.929241202634,060-AAV,0.141643966136,80,237,317
7302,-0.645953270361,0.929241202634,060-AAX,0.141643966136,18,99,117
7303,-0.645953270361,0.929241202634,060-AAY,0.141643966136,63,126,189
7304,-0.645953270361,0.929241202634,060-AAZ,0.141643966136,58,122,180
7305,-0.645953270361,0.929241202634,060-ABA,0.141643966136,62,63,125
7306,-0.645953270361,0.929241202634,060-ABB,0.141643966136,142,350,492
7307,-0.645953270361,0.929241202634,060-ABC,0.141643966136,94,125,219
7308,-0.645953270361,0.929241202634,060-ABD,0.141643966136,125,337,462
7309,-0.645953270361,0.929241202634,060-ABE,0.141643966136,152,271,423
7310,-0.645953270361,0.929241202634,060-ABF,0.141643966136,117,166,283
7311,-0.645953270361,0.929241202634,060-ABG,0.141643966136,97,255,352
7312,-0.645953270361,0.929241202634,060-ABH,0.141643966136,78,214,292
7313,-0.645953270361,0.929241202634,060-ABI,0.141643966136,90,147,237
7314,-0.645953270361,0.929241202634,060-ABJ,0.141643966136,90,216,306
7315,-0.645953270361,0.929241202634,060-ABK,0.141643966136,146,358,504
7316,-0.645953270361,0.929241202634,060-ABL,0.141643966136,111,223,334
7317,-0.645953270361,0.929241202634,060-ABM,0.141643966136,89,181,270
7318,-0.645953270361,0.929241202634,060-ABN,0.141643966136,100,168,268
7319,-0.645953270361,0.929241202634,060-ABO,0.141643966136,82,109,191
7320,-0.645953270361,0.929241202634,060-ABP,0.141643966136,74,240,314
7321,-0.645953270361,0.929241202634,060-ABQ,0.141643966136,96,200,296
7322,-0.645953270361,0.929241202634,060-ABR,0.141643966136,98,238,336
7323,-0.645953270361,0.929241202634,060-ABS,0.141643966136,115,317,432
7324,-0.645953270361,0.929241202634,060-ABT,0.141643966136,106,209,315
7325,-0.645953270361,0.929241202634,060-ABU,0.141643966136,111,249,360
7326,-0.645953270361,0.929241202634,060-ABV,0.141643966136,81,174,255
7327,-0.645953270361,0.929241202634,060-ABW,0.141643966136,85,174,259
7328,-0.645953270361,0.929241202634,060-ABX,0.141643966136,130,277,407
7329,-0.645953270361,0.929241202634,060-ABY,0.141643966136,149,280,429
7330,-0.645953270361,0.929241202634,060-ABZ,0.141643966136,48,78,126
7331,-0.645953270361,0.929241202634,060-ACA,0.141643966136,9,54,63
7332,-0.645953270361,0.929241202634,060-ACB,0.141643966136,39,115,154
7333,-0.645953270361,0.929241202634,060-ACC,0.141643966136,145,321,466
7334,-0.645953270361,0.929241202634,060-ACD,0.141643966136,135,355,490
7335,-0.645953270361,0.929241202634,060-ACE,0.141643966136,118,395,513
7336,-0.645953270361,0.929241202634,060-ACF,0.141643966136,82,152,234
7337,-0.645953270361,0.929241202634,060-ACG,0.141643966136,35,96,131
7338,-0.645953270361,0.929241202634,060-ACH,0.141643966136,109,231,340
7339,-0.645953270361,0.929241202634,060-ACI,0.141643966136,153,255,408
7340,-0.645953270361,0.929241202634,060-ACJ,0.141643966136,102,256,358
7341,-0.645953270361,0.929241202634,060-ACK,0.141643966136,102,319,421
7342,-0.645953270361,0.929241202634,060-ACL,0.141643966136,146,446,592
7343,-0.645953270361,0.929241202634,060-ACM,0.141643966136,42,157,199
7344,-0.645953270361,0.929241202634,060-ACN,0.141643966136,64,224,288
7345,-0.645953270361,0.929241202634,060-ACO,0.141643966136,95,263,358
7346,-0.645953270361,0.929241202634,060-ACP,0.141643966136,139,217,356
7347,-0.645953270361,0.929241202634,060-ACQ,0.141643966136,137,221,358
7348,-0.645953270361,0.929241202634,060-ACR,0.141643966136,66,163,229
7349,-0.645953270361,0.929241202634,060-ACS,0.141643966136,69,118,187
7350,-0.645953270361,0.929241202634,060-ACT,0.141643966136,101,140,241
7351,-0.645953270361,0.929241202634,060-ACU,0.141643966136,54,67,121
7352,-0.645953270361,0.929241202634,060-ACV,0.141643966136,101,307,408
7353,-0.645953270361,0.929241202634,060-ACW,0.141643966136,67,210,277
7354,-0.645953270361,0.929241202634,060-ACX,0.141643966136,64,110,174
7355,-0.645953270361,0.929241202634,060-ACY,0.141643966136,116,192,308
7356,-0.645953270361,0.929241202634,060-ACZ,0.141643966136,131,268,399
7357,-0.645953270361,0.929241202634,060-ADA,0.141643966136,120,287,407
7358,-0.645953270361,0.929241202634,060-ADB,0.141643966136,96,199,295
7359,-0.645953270361,0.929241202634,060-ADC,0.141643966136,65,113,178
7360,-0.645953270361,0.929241202634,060-ADD,0.141643966136,146,277,423
7361,-0.645953270361,0.929241202634,060-ADE,0.141643966136,118,149,267
7362,-0.645953270361,0.929241202634,060-ADF,0.141643966136,123,314,437
7363,-0.645953270361,0.929241202634,060-ADG,0.141643966136,125,361,486
7364,-0.645953270361,0.929241202634,060-ADH,0.141643966136,158,233,391
7365,-0.645953270361,0.929241202634,061-AAA,0.141643966136,65,162,227
7366,-0.645953270361,0.929241202634,061-AAB,0.141643966136,19,47,66
7367,-0.645953270361,0.929241202634,061-AAC,0.141643966136,125,181,306
7368,-0.645953270361,0.929241202634,061-AAD,0.141643966136,73,126,199
7369,-0.645953270361,0.929241202634,061-AAE,0.141643966136,22,36,58
7370,-0.645953270361,0.929241202634,061-AAF,0.141643966136,66,132,198
7371,-0.645953270361,0.929241202634,061-AAG,0.141643966136,15,37,52
7372,-0.645953270361,0.929241202634,061-AAH,0.141643966136,47,70,117
7373,-0.645953270361,0.929241202634,061-AAI,0.141643966136,83,102,185
7374,-0.645953270361,0.929241202634,061-AAJ,0.141643966136,62,114,176
7375,-0.645953270361,0.929241202634,061-AAK,0.141643966136,24,42,66
7376,-0.645953270361,0.929241202634,061-AAL,0.141643966136,54,103,157
7377,-0.645953270361,0.929241202634,061-AAM,0.141643966136,45,35,80
7378,-0.645953270361,0.929241202634,061-AAN,0.141643966136,41,60,101
7379,-0.645953270361,0.929241202634,061-AAO,0.141643966136,55,39,94
7380,-0.645953270361,0.929241202634,061-AAP,0.141643966136,127,164,291
7381,-0.645953270361,0.929241202634,061-AAQ,0.141643966136,178,245,423
7382,-0.645953270361,0.929241202634,061-AAR,0.141643966136,100,138,238
7383,-0.645953270361,0.929241202634,061-AAS,0.141643966136,123,233,356
7384,-0.645953270361,0.929241202634,061-AAT,0.141643966136,54,112,166
7385,-0.645953270361,0.929241202634,061-AAU,0.141643966136,75,123,198
7386,-0.645953270361,0.929241202634,061-AAV,0.141643966136,52,86,138
7387,-0.645953270361,0.929241202634,061-AAW,0.141643966136,64,131,195
7388,-0.645953270361,0.929241202634,061-AAX,0.141643966136,72,165,237
7389,-0.645953270361,0.929241202634,061-AAY,0.141643966136,46,82,128
7390,-0.645953270361,0.929241202634,061-AAZ,0.141643966136,71,65,136
7391,-0.645953270361,0.929241202634,061-ABA,0.141643966136,79,150,229
7392,-0.645953270361,0.929241202634,062-AAA,0.141643966136,95,94,189
7393,-0.645953270361,0.929241202634,062-AAC,0.141643966136,80,152,232
7394,-0.645953270361,0.929241202634,062-AAD,0.141643966136,75,99,174
7395,-0.645953270361,0.929241202634,062-AAF,0.141643966136,134,182,316
7396,-0.645953270361,0.929241202634,062-AAH,0.141643966136,76,84,160
7397,-0.645953270361,0.929241202634,062-AAI,0.141643966136,129,159,288
7398,-0.645953270361,0.929241202634,062-AAK,0.141643966136,93,119,212
7399,-0.645953270361,0.929241202634,062-AAL,0.141643966136,107,100,207
7400,-0.645953270361,0.929241202634,062-AAM,0.141643966136,204,184,388
7401,-0.645953270361,0.929241202634,062-AAO,0.141643966136,185,248,433
7402,-0.645953270361,0.929241202634,062-AAP,0.141643966136,256,250,506
7403,-0.645953270361,0.929241202634,062-AAR,0.141643966136,42,31,73
7404,-0.645953270361,0.929241202634,062-AAT,0.141643966136,212,281,493
7405,-0.645953270361,0.929241202634,062-AAU,0.141643966136,220,254,474
7406,-0.645953270361,0.929241202634,062-AAW,0.141643966136,147,223,370
7407,-0.645953270361,0.929241202634,062-AAX,0.141643966136,59,43,102
7408,-0.645953270361,0.929241202634,062-AAY,0.141643966136,167,215,382
7409,-0.645953270361,0.929241202634,062-AAZ,0.141643966136,159,221,380
7410,-0.645953270361,0.929241202634,062-ABB,0.141643966136,86,273,359
7411,-0.645953270361,0.929241202634,062-ABC,0.141643966136,112,338,450
7412,-0.645953270361,0.929241202634,062-ABF,0.141643966136,144,362,506
7413,-0.645953270361,0.929241202634,062-ABG,0.141643966136,161,380,541
7414,-0.645953270361,0.929241202634,062-ABH,0.141643966136,174,289,463
7415,-0.645953270361,0.929241202634,062-ABL,0.141643966136,266,304,570
7416,-0.645953270361,0.929241202634,062-ABO,0.141643966136,172,206,378
7417,-0.645953270361,0.929241202634,062-ABP,0.141643966136,154,193,347
7418,-0.645953270361,0.929241202634,062-ABR,0.141643966136,159,268,427
7419,-0.645953270361,0.929241202634,062-ABT,0.141643966136,159,275,434
7420,-0.645953270361,0.929241202634,062-ABW,0.141643966136,152,237,389
7421,-0.645953270361,0.929241202634,062-ABX,0.141643966136,145,257,402
7422,-0.645953270361,0.929241202634,062-ACA,0.141643966136,157,270,427
7423,-0.645953270361,0.929241202634,062-ACC,0.141643966136,148,197,345
7424,-0.645953270361,0.929241202634,062-ACE,0.141643966136,148,229,377
7425,-0.645953270361,0.929241202634,062-ACG,0.141643966136,109,234,343
7426,-0.645953270361,0.929241202634,062-ACH,0.141643966136,131,221,352
7427,-0.645953270361,0.929241202634,062-ACJ,0.141643966136,94,139,233
7428,-0.645953270361,0.929241202634,062-ACL,0.141643966136,90,161,251
7429,-0.645953270361,0.929241202634,062-ACM,0.141643966136,103,125,228
7430,-0.645953270361,0.929241202634,062-ACQ,0.141643966136,139,268,407
7431,-0.645953270361,0.929241202634,062-ACS,0.141643966136,167,329,496
7432,-0.645953270361,0.929241202634,062-ACU,0.141643966136,222,279,501
7433,-0.645953270361,0.929241202634,062-ACV,0.141643966136,129,182,311
7434,-0.645953270361,0.929241202634,062-ACW,0.141643966136,128,205,333
7435,-0.645953270361,0.929241202634,062-ACY,0.141643966136,104,139,243
7436,-0.645953270361,0.929241202634,063-AAB,0.141643966136,213,235,448
7437,-0.645953270361,0.929241202634,063-AAC,0.141643966136,134,280,414
7438,-0.645953270361,0.929241202634,063-AAE,0.141643966136,52,207,259
7439,-0.645953270361,0.929241202634,063-AAF,0.141643966136,136,279,415
7440,-0.645953270361,0.929241202634,063-AAG,0.141643966136,79,132,211
7441,-0.645953270361,0.929241202634,063-AAJ,0.141643966136,151,309,460
7442,-0.645953270361,0.929241202634,063-AAM,0.141643966136,207,271,478
7443,-0.645953270361,0.929241202634,063-AAO,0.141643966136,140,313,453
7444,-0.645953270361,0.929241202634,063-AAP,0.141643966136,98,191,289
7445,-0.645953270361,0.929241202634,063-AAQ,0.141643966136,183,350,533
7446,-0.645953270361,0.929241202634,063-AAU,0.141643966136,123,259,382
7447,-0.645953270361,0.929241202634,063-AAV,0.141643966136,125,150,275
7448,-0.645953270361,0.929241202634,063-AAX,0.141643966136,91,237,328
7449,-0.645953270361,0.929241202634,063-AAY,0.141643966136,125,326,451
7450,-0.645953270361,0.929241202634,063-ABD,0.141643966136,152,284,436
7451,-0.645953270361,0.929241202634,063-ABE,0.141643966136,154,180,334
7452,-0.645953270361,0.929241202634,063-ABG,0.141643966136,73,164,237
7453,-0.645953270361,0.929241202634,064-AAA,0.141643966136,86,163,249
7454,-0.645953270361,0.929241202634,064-AAB,0.141643966136,54,91,145
7455,-0.645953270361,0.929241202634,064-AAC,0.141643966136,54,113,167
7456,-0.645953270361,0.929241202634,064-AAD,0.141643966136,91,131,222
7457,-0.645953270361,0.929241202634,064-AAE,0.141643966136,27,31,58
7458,-0.645953270361,0.929241202634,064-AAF,0.141643966136,70,53,123
7459,-0.645953270361,0.929241202634,064-AAG,0.141643966136,117,135,252
7460,-0.645953270361,0.929241202634,064-AAH,0.141643966136,69,112,181
7461,-0.645953270361,0.929241202634,064-AAI,0.141643966136,84,128,212
7462,-0.645953270361,0.929241202634,064-AAJ,0.141643966136,55,51,106
7463,-0.645953270361,0.929241202634,064-AAK,0.141643966136,83,107,190
7464,-0.645953270361,0.929241202634,064-AAL,0.141643966136,93,68,161
7465,-0.645953270361,0.929241202634,064-AAM,0.141643966136,59,183,242
7466,-0.645953270361,0.929241202634,064-AAN,0.141643966136,14,40,54
7467,-0.645953270361,0.929241202634,064-AAO,0.141643966136,106,292,398
7468,-0.645953270361,0.929241202634,064-AAP,0.141643966136,110,173,283
7469,-0.645953270361,0.929241202634,064-AAQ,0.141643966136,78,117,195
7470,-0.645953270361,0.929241202634,064-AAR,0.141643966136,84,215,299
7471,-0.645953270361,0.929241202634,064-AAS,0.141643966136,89,231,320
7472,-0.645953270361,0.929241202634,064-AAT,0.141643966136,50,162,212
7473,-0.645953270361,0.929241202634,064-AAU,0.141643966136,73,55,128
7474,-0.645953270361,0.929241202634,064-AAV,0.141643966136,99,120,219
7475,-0.645953270361,0.929241202634,064-AAW,0.141643966136,4,1,5
7476,-0.645953270361,0.929241202634,064-AAX,0.141643966136,120,124,244
7477,-0.645953270361,0.929241202634,064-AAY,0.141643966136,207,251,458
7478,-0.645953270361,0.929241202634,064-AAZ,0.141643966136,117,161,278
7479,-0.645953270361,0.929241202634,064-ABA,0.141643966136,115,204,319
7480,-0.645953270361,0.929241202634,064-ABB,0.141643966136,90,198,288
7481,-0.645953270361,0.929241202634,064-ABC,0.141643966136,86,237,323
7482,-0.645953270361,0.929241202634,064-ABD,0.141643966136,66,135,201
7483,-0.645953270361,0.929241202634,064-ABE,0.141643966136,90,139,229
7484,-0.645953270361,0.929241202634,064-ABF,0.141643966136,21,28,49
7485,-0.645953270361,0.929241202634,064-ABG,0.141643966136,59,41,100
7486,-0.645953270361,0.929241202634,064-ABH,0.141643966136,84,60,144
7487,-0.645953270361,0.929241202634,064-ABI,0.141643966136,93,272,365
7488,-0.645953270361,0.929241202634,064-ABJ,0.141643966136,96,229,325
7489,-0.645953270361,0.929241202634,064-ABK,0.141643966136,56,130,186
7490,-0.645953270361,0.929241202634,064-ABM,0.141643966136,73,68,141
7491,-0.645953270361,0.929241202634,064-ABN,0.141643966136,78,74,152
7492,-0.645953270361,0.929241202634,064-ABO,0.141643966136,91,90,181
7493,-0.645953270361,0.929241202634,064-ABP,0.141643966136,47,40,87
7494,-0.645953270361,0.929241202634,064-ABQ,0.141643966136,64,78,142
7495,-0.645953270361,0.929241202634,064-ABR,0.141643966136,97,92,189
7496,-0.645953270361,0.929241202634,064-ABS,0.141643966136,68,72,140
7497,-0.645953270361,0.929241202634,064-ABT,0.141643966136,91,274,365
7498,-0.645953270361,0.929241202634,064-ABU,0.141643966136,65,125,190
7499,-0.645953270361,0.929241202634,065-AAA,0.141643966136,137,302,439
7500,-0.645953270361,0.929241202634,065-AAB,0.141643966136,95,167,262
7501,-0.645953270361,0.929241202634,065-AAC,0.141643966136,111,373,484
7502,-0.645953270361,0.929241202634,065-AAD,0.141643966136,89,218,307
7503,-0.645953270361,0.929241202634,065-AAE,0.141643966136,75,117,192
7504,-0.645953270361,0.929241202634,065-AAF,0.141643966136,90,198,288
7505,-0.645953270361,0.929241202634,065-AAG,0.141643966136,73,188,261
7506,-0.645953270361,0.929241202634,065-AAH,0.141643966136,107,108,215
7507,-0.645953270361,0.929241202634,065-AAI,0.141643966136,96,159,255
7508,-0.645953270361,0.929241202634,065-AAJ,0.141643966136,50,72,122
7509,-0.645953270361,0.929241202634,065-AAK,0.141643966136,64,74,138
7510,-0.645953270361,0.929241202634,065-AAL,0.141643966136,45,71,116
7511,-0.645953270361,0.929241202634,065-AAM,0.141643966136,74,58,132
7512,-0.645953270361,0.929241202634,065-AAN,0.141643966136,64,122,186
7513,-0.645953270361,0.929241202634,065-AAO,0.141643966136,56,69,125
7514,-0.645953270361,0.929241202634,065-AAP,0.141643966136,57,155,212
7515,-0.645953270361,0.929241202634,065-AAQ,0.141643966136,48,180,228
7516,-0.645953270361,0.929241202634,065-AAR,0.141643966136,187,286,473
7517,-0.645953270361,0.929241202634,065-AAS,0.141643966136,104,262,366
7518,-0.645953270361,0.929241202634,065-AAT,0.141643966136,108,306,414
7519,-0.645953270361,0.929241202634,065-AAU,0.141643966136,67,228,295
7520,-0.645953270361,0.929241202634,065-AAV,0.141643966136,95,143,238
7521,-0.645953270361,0.929241202634,065-AAW,0.141643966136,106,123,229
7522,-0.645953270361,0.929241202634,065-AAX,0.141643966136,129,283,412
7523,-0.645953270361,0.929241202634,065-AAY,0.141643966136,135,288,423
7524,-0.645953270361,0.929241202634,065-ABA,0.141643966136,69,188,257
7525,-0.645953270361,0.929241202634,065-ABB,0.141643966136,114,390,504
7526,-0.645953270361,0.929241202634,065-ABC,0.141643966136,51,138,189
7527,-0.645953270361,0.929241202634,065-ABD,0.141643966136,102,312,414
7528,-0.645953270361,0.929241202634,065-ABG,0.141643966136,114,326,440
7529,-0.645953270361,0.929241202634,065-ABI,0.141643966136,74,196,270
7530,-0.645953270361,0.929241202634,065-ABJ,0.141643966136,45,135,180
7531,-0.645953270361,0.929241202634,065-ABK,0.141643966136,62,112,174
7532,-0.645953270361,0.929241202634,065-ABL,0.141643966136,149,351,500
7533,-0.645953270361,0.929241202634,065-ABM,0.141643966136,105,232,337
7534,-0.645953270361,0.929241202634,065-ABN,0.141643966136,150,268,418
7535,-0.645953270361,0.929241202634,065-ABO,0.141643966136,141,335,476
7536,-0.645953270361,0.929241202634,065-ABQ,0.141643966136,108,319,427
7537,-0.645953270361,0.929241202634,065-ABT,0.141643966136,128,364,492
7538,-0.645953270361,0.929241202634,065-ABU,0.141643966136,127,420,547
7539,-0.645953270361,0.929241202634,065-ABV,0.141643966136,131,396,527
7540,-0.645953270361,0.929241202634,065-ABW,0.141643966136,76,297,373
7541,-0.645953270361,0.929241202634,065-ABX,0.141643966136,115,369,484
7542,-0.645953270361,0.929241202634,065-ABY,0.141643966136,109,333,442
7543,-0.645953270361,0.929241202634,065-ABZ,0.141643966136,49,123,172
7544,-0.645953270361,0.929241202634,065-ACA,0.141643966136,120,309,429
7545,-0.645953270361,0.929241202634,065-ACB,0.141643966136,180,409,589
7546,-0.645953270361,0.929241202634,065-ACC,0.141643966136,102,267,369
7547,-0.645953270361,0.929241202634,066-AAA,0.141643966136,103,169,272
7548,-0.645953270361,0.929241202634,066-AAB,0.141643966136,75,135,210
7549,-0.645953270361,0.929241202634,066-AAC,0.141643966136,124,185,309
7550,-0.645953270361,0.929241202634,066-AAE,0.141643966136,119,149,268
7551,-0.645953270361,0.929241202634,066-AAF,0.141643966136,82,111,193
7552,-0.645953270361,0.929241202634,066-AAG,0.141643966136,112,142,254
7553,-0.645953270361,0.929241202634,066-AAH,0.141643966136,189,185,374
7554,-0.645953270361,0.929241202634,066-AAI,0.141643966136,50,70,120
7555,-0.645953270361,0.929241202634,066-AAJ,0.141643966136,277,235,512
7556,-0.645953270361,0.929241202634,066-AAK,0.141643966136,149,130,279
7557,-0.645953270361,0.929241202634,066-AAL,0.141643966136,87,73,160
7558,-0.645953270361,0.929241202634,066-AAM,0.141643966136,79,142,221
7559,-0.645953270361,0.929241202634,066-AAN,0.141643966136,148,179,327
7560,-0.645953270361,0.929241202634,066-AAO,0.141643966136,143,137,280
7561,-0.645953270361,0.929241202634,066-AAP,0.141643966136,230,324,554
7562,-0.645953270361,0.929241202634,066-AAQ,0.141643966136,250,370,620
7563,-0.645953270361,0.929241202634,066-AAR,0.141643966136,221,375,596
7564,-0.645953270361,0.929241202634,066-AAS,0.141643966136,83,79,162
7565,-0.645953270361,0.929241202634,066-AAT,0.141643966136,186,183,369
7566,-0.645953270361,0.929241202634,066-AAU,0.141643966136,186,177,363
7567,-0.645953270361,0.929241202634,066-AAV,0.141643966136,164,194,358
7568,-0.645953270361,0.929241202634,066-AAW,0.141643966136,178,293,471
7569,-0.645953270361,0.929241202634,066-AAX,0.141643966136,265,284,549
7570,-0.645953270361,0.929241202634,066-AAY,0.141643966136,189,281,470
7571,-0.645953270361,0.929241202634,067-AAA,0.141643966136,82,100,182
7572,-0.645953270361,0.929241202634,067-AAB,0.141643966136,123,200,323
7573,-0.645953270361,0.929241202634,067-AAC,0.141643966136,92,359,451
7574,-0.645953270361,0.929241202634,067-AAD,0.141643966136,140,318,458
7575,-0.645953270361,0.929241202634,067-AAE,0.141643966136,80,272,352
7576,-0.645953270361,0.929241202634,067-AAF,0.141643966136,143,293,436
7577,-0.645953270361,0.929241202634,067-AAG,0.141643966136,125,395,520
7578,-0.645953270361,0.929241202634,067-AAH,0.141643966136,167,398,565
7579,-0.645953270361,0.929241202634,067-AAJ,0.141643966136,117,296,413
7580,-0.645953270361,0.929241202634,067-AAK,0.141643966136,89,264,353
7581,-0.645953270361,0.929241202634,067-AAL,0.141643966136,131,329,460
7582,-0.645953270361,0.929241202634,067-AAM,0.141643966136,127,359,486
7583,-0.645953270361,0.929241202634,067-AAN,0.141643966136,139,294,433
7584,-0.645953270361,0.929241202634,067-AAO,0.141643966136,259,223,482
7585,-0.645953270361,0.929241202634,067-AAP,0.141643966136,262,106,368
7586,-0.645953270361,0.929241202634,067-AAQ,0.141643966136,163,113,276
7587,-0.645953270361,0.929241202634,067-AAT,0.141643966136,248,220,468
7588,-0.645953270361,0.929241202634,067-AAU,0.141643966136,179,143,322
7589,-0.645953270361,0.929241202634,067-AAV,0.141643966136,188,124,312
7590,-0.645953270361,0.929241202634,067-AAW,0.141643966136,188,90,278
7591,-0.645953270361,0.929241202634,067-AAZ,0.141643966136,197,111,308
7592,-0.645953270361,0.929241202634,067-ABA,0.141643966136,179,72,251
7593,-0.645953270361,0.929241202634,067-ABB,0.141643966136,93,49,142
7594,-0.645953270361,0.929241202634,067-ABC,0.141643966136,107,67,174
7595,-0.645953270361,0.929241202634,067-ABE,0.141643966136,65,26,91
7596,-0.645953270361,0.929241202634,067-ABG,0.141643966136,114,41,155
7597,-0.645953270361,0.929241202634,067-ABH,0.141643966136,170,62,232
7598,-0.645953270361,0.929241202634,067-ABJ,0.141643966136,143,67,210
7599,-0.645953270361,0.929241202634,067-ABK,0.141643966136,213,111,324
7600,-0.645953270361,0.929241202634,067-ABL,0.141643966136,89,73,162
7601,-0.645953270361,0.929241202634,067-ABN,0.141643966136,110,102,212
7602,-0.645953270361,0.929241202634,067-ABO,0.141643966136,127,97,224
7603,-0.645953270361,0.929241202634,067-ABQ,0.141643966136,128,97,225
7604,-0.645953270361,0.929241202634,067-ABR,0.141643966136,176,224,400
7605,-0.645953270361,0.929241202634,067-ABS,0.141643966136,116,128,244
7606,-0.645953270361,0.929241202634,067-ABV,0.141643966136,104,99,203
7607,-0.645953270361,0.929241202634,067-ABW,0.141643966136,122,139,261
7608,-0.645953270361,0.929241202634,067-ABX,0.141643966136,176,176,352
7609,-0.645953270361,0.929241202634,067-ACA,0.141643966136,126,93,219
7610,-0.645953270361,0.929241202634,067-ACB,0.141643966136,181,202,383
7611,-0.645953270361,0.929241202634,067-ACD,0.141643966136,139,163,302
7612,-0.645953270361,0.929241202634,067-ACE,0.141643966136,166,193,359
7613,-0.645953270361,0.929241202634,067-ACG,0.141643966136,275,268,543
7614,-0.645953270361,0.929241202634,067-ACH,0.141643966136,116,84,200
7615,-0.645953270361,0.929241202634,067-ACI,0.141643966136,254,267,521
7616,-0.645953270361,0.929241202634,067-ACK,0.141643966136,107,154,261
7617,-0.645953270361,0.929241202634,067-ACL,0.141643966136,198,301,499
7618,-0.645953270361,0.929241202634,067-ACN,0.141643966136,108,259,367
7619,-0.645953270361,0.929241202634,067-ACO,0.141643966136,165,235,400
7620,-0.645953270361,0.929241202634,067-ACP,0.141643966136,155,135,290
7621,-0.645953270361,0.929241202634,067-ACQ,0.141643966136,117,274,391
7622,-0.645953270361,0.929241202634,067-ACR,0.141643966136,151,293,444
7623,-0.645953270361,0.929241202634,067-ACT,0.141643966136,187,224,411
7624,-0.645953270361,0.929241202634,067-ACU,0.141643966136,206,238,444
7625,-0.645953270361,0.929241202634,067-ACV,0.141643966136,224,325,549
7626,-0.645953270361,0.929241202634,067-ACW,0.141643966136,144,242,386
7627,-0.645953270361,0.929241202634,067-ACX,0.141643966136,170,291,461
7628,-0.645953270361,0.929241202634,067-ACY,0.141643966136,189,251,440
7629,-0.645953270361,0.929241202634,067-ACZ,0.141643966136,119,187,306
7630,-0.645953270361,0.929241202634,067-ADE,0.141643966136,102,157,259
7631,-0.645953270361,0.929241202634,067-ADF,0.141643966136,81,107,188
7632,-0.645953270361,0.929241202634,067-ADG,0.141643966136,121,205,326
7633,-0.645953270361,0.929241202634,067-ADH,0.141643966136,186,319,505
7634,-0.645953270361,0.929241202634,067-ADJ,0.141643966136,126,250,376
7635,-0.645953270361,0.929241202634,067-ADK,0.141643966136,109,280,389
7636,-0.645953270361,0.929241202634,067-ADL,0.141643966136,91,67,158
7637,-0.645953270361,0.929241202634,067-ADM,0.141643966136,150,219,369
7638,-0.645953270361,0.929241202634,067-ADN,0.141643966136,273,270,543
7639,-0.645953270361,0.929241202634,067-ADO,0.141643966136,166,183,349
7640,-0.645953270361,0.929241202634,067-ADP,0.141643966136,154,96,250
7641,-0.645953270361,0.929241202634,067-ADQ,0.141643966136,210,156,366
7642,-0.645953270361,0.929241202634,067-ADU,0.141643966136,157,261,418
7643,-0.645953270361,0.929241202634,067-ADV,0.141643966136,152,258,410
7644,-0.645953270361,0.929241202634,067-ADX,0.141643966136,159,283,442
7645,-0.645953270361,0.929241202634,067-ADY,0.141643966136,110,161,271
7646,-0.645953270361,0.929241202634,067-ADZ,0.141643966136,139,81,220
7647,-0.645953270361,0.929241202634,067-AEA,0.141643966136,176,290,466
7648,-0.645953270361,0.929241202634,067-AEB,0.141643966136,144,338,482
7649,-0.645953270361,0.929241202634,067-AED,0.141643966136,106,287,393
7650,-0.645953270361,0.929241202634,067-AEE,0.141643966136,122,287,409
7651,-0.645953270361,0.929241202634,067-AEF,0.141643966136,135,248,383
7652,-0.645953270361,0.929241202634,067-AEG,0.141643966136,97,276,373
7653,-0.645953270361,0.929241202634,067-AEJ,0.141643966136,121,217,338
7654,-0.645953270361,0.929241202634,067-AEL,0.141643966136,135,225,360
7655,-0.645953270361,0.929241202634,067-AEN,0.141643966136,134,238,372
7656,-0.645953270361,0.929241202634,067-AEO,0.141643966136,127,251,378
7657,-0.645953270361,0.929241202634,067-AEQ,0.141643966136,69,178,247
7658,-0.645953270361,0.929241202634,067-AER,0.141643966136,91,196,287
7659,-0.645953270361,0.929241202634,067-AET,0.141643966136,110,147,257
7660,-0.645953270361,0.929241202634,067-AEU,0.141643966136,112,164,276
7661,-0.645953270361,0.929241202634,067-AEV,0.141643966136,173,279,452
7662,-0.645953270361,0.929241202634,067-AEW,0.141643966136,161,256,417
7663,-0.645953270361,0.929241202634,067-AEX,0.141643966136,200,288,488
7664,-0.645953270361,0.929241202634,067-AEY,0.141643966136,167,311,478
7665,-0.645953270361,0.929241202634,067-AFB,0.141643966136,141,211,352
7666,-0.645953270361,0.929241202634,067-AFC,0.141643966136,161,118,279
7667,-0.645953270361,0.929241202634,067-AFD,0.141643966136,120,137,257
7668,-0.645953270361,0.929241202634,067-AFE,0.141643966136,144,126,270
7669,-0.645953270361,0.929241202634,067-AFF,0.141643966136,200,261,461
7670,-0.645953270361,0.929241202634,067-AFG,0.141643966136,175,194,369
7671,-0.645953270361,0.929241202634,067-AFH,0.141643966136,147,295,442
7672,-0.645953270361,0.929241202634,067-AFL,0.141643966136,276,381,657
7673,-0.645953270361,0.929241202634,067-AFM,0.141643966136,153,246,399
7674,-0.645953270361,0.929241202634,067-AFN,0.141643966136,118,211,329
7675,-0.645953270361,0.929241202634,067-AFO,0.141643966136,115,178,293
7676,-0.645953270361,0.929241202634,067-AFP,0.141643966136,117,261,378
7677,-0.645953270361,0.929241202634,067-AFQ,0.141643966136,146,256,402
7678,-0.645953270361,0.929241202634,067-AFR,0.141643966136,172,312,484
7679,-0.645953270361,0.929241202634,067-AFS,0.141643966136,121,200,321
7680,-0.645953270361,0.929241202634,067-AFT,0.141643966136,105,242,347
7681,-0.645953270361,0.929241202634,067-AFU,0.141643966136,109,159,268
7682,-0.645953270361,0.929241202634,067-AFV,0.141643966136,140,294,434
7683,-0.645953270361,0.929241202634,067-AFX,0.141643966136,184,291,475
7684,-0.645953270361,0.929241202634,067-AFY,0.141643966136,153,242,395
7685,-0.645953270361,0.929241202634,067-AFZ,0.141643966136,128,313,441
7686,-0.645953270361,0.929241202634,067-AGA,0.141643966136,151,248,399
7687,-0.645953270361,0.929241202634,067-AGB,0.141643966136,162,264,426
7688,-0.645953270361,0.929241202634,067-AGE,0.141643966136,40,59,99
7689,-0.645953270361,0.929241202634,067-AGF,0.141643966136,73,140,213
7690,-0.645953270361,0.929241202634,067-AGG,0.141643966136,116,153,269
7691,-0.645953270361,0.929241202634,067-AGH,0.141643966136,56,78,134
7692,-0.645953270361,0.929241202634,067-AGI,0.141643966136,126,90,216
7693,-0.645953270361,0.929241202634,067-AGJ,0.141643966136,207,153,360
7694,-0.645953270361,0.929241202634,067-AGK,0.141643966136,39,16,55
7695,-0.645953270361,0.929241202634,067-AGL,0.141643966136,100,37,137
7696,-0.645953270361,0.929241202634,067-AGM,0.141643966136,88,41,129
7697,-0.645953270361,0.929241202634,067-AGN,0.141643966136,151,341,492
7698,-0.645953270361,0.929241202634,067-AGP,0.141643966136,125,191,316
7699,-0.645953270361,0.929241202634,067-AGQ,0.141643966136,148,183,331
7700,-0.645953270361,0.929241202634,067-AGR,0.141643966136,169,214,383
7701,-0.645953270361,0.929241202634,067-AGS,0.141643966136,181,247,428
7702,-0.645953270361,0.929241202634,068-AAA,0.141643966136,76,248,324
7703,-0.645953270361,0.929241202634,068-AAB,0.141643966136,67,259,326
7704,-0.645953270361,0.929241202634,068-AAC,0.141643966136,54,170,224
7705,-0.645953270361,0.929241202634,068-AAD,0.141643966136,114,310,424
7706,-0.645953270361,0.929241202634,068-AAE,0.141643966136,66,159,225
7707,-0.645953270361,0.929241202634,068-AAF,0.141643966136,84,177,261
7708,-0.645953270361,0.929241202634,068-AAG,0.141643966136,129,292,421
7709,-0.645953270361,0.929241202634,068-AAH,0.141643966136,87,240,327
7710,-0.645953270361,0.929241202634,068-AAI,0.141643966136,43,168,211
7711,-0.645953270361,0.929241202634,068-AAJ,0.141643966136,33,161,194
7712,-0.645953270361,0.929241202634,068-AAK,0.141643966136,117,467,584
7713,-0.645953270361,0.929241202634,068-AAL,0.141643966136,130,431,561
7714,-0.645953270361,0.929241202634,068-AAM,0.141643966136,85,193,278
7715,-0.645953270361,0.929241202634,068-AAN,0.141643966136,127,342,469
7716,-0.645953270361,0.929241202634,068-AAO,0.141643966136,64,223,287
7717,-0.645953270361,0.929241202634,068-AAP,0.141643966136,116,287,403
7718,-0.645953270361,0.929241202634,068-AAQ,0.141643966136,89,326,415
7719,-0.645953270361,0.929241202634,068-AAR,0.141643966136,43,219,262
7720,-0.645953270361,0.929241202634,068-AAS,0.141643966136,73,236,309
7721,-0.645953270361,0.929241202634,068-AAT,0.141643966136,88,249,337
7722,-0.645953270361,0.929241202634,068-AAU,0.141643966136,47,175,222
7723,-0.645953270361,0.929241202634,068-AAV,0.141643966136,35,138,173
7724,-0.645953270361,0.929241202634,068-AAW,0.141643966136,71,262,333
7725,-0.645953270361,0.929241202634,068-AAX,0.141643966136,99,299,398
7726,-0.645953270361,0.929241202634,068-AAY,0.141643966136,91,317,408
7727,-0.645953270361,0.929241202634,068-AAZ,0.141643966136,57,181,238
7728,-0.645953270361,0.929241202634,068-ABA,0.141643966136,69,107,176
7729,-0.645953270361,0.929241202634,068-ABB,0.141643966136,86,158,244
7730,-0.645953270361,0.929241202634,068-ABC,0.141643966136,59,249,308
7731,-0.645953270361,0.929241202634,068-ABD,0.141643966136,111,371,482
7732,-0.645953270361,0.929241202634,068-ABE,0.141643966136,57,219,276
7733,-0.645953270361,0.929241202634,068-ABF,0.141643966136,93,206,299
7734,-0.645953270361,0.929241202634,068-ABG,0.141643966136,85,340,425
7735,-0.645953270361,0.929241202634,068-ABH,0.141643966136,55,146,201
7736,-0.645953270361,0.929241202634,068-ABI,0.141643966136,39,91,130
7737,-0.645953270361,0.929241202634,068-ABK,0.141643966136,84,254,338
7738,-0.645953270361,0.929241202634,068-ABL,0.141643966136,70,305,375
7739,-0.645953270361,0.929241202634,068-ABM,0.141643966136,45,118,163
7740,-0.645953270361,0.929241202634,068-ABN,0.141643966136,50,155,205
7741,-0.645953270361,0.929241202634,068-ABO,0.141643966136,52,112,164
7742,-0.645953270361,0.929241202634,068-ABP,0.141643966136,78,334,412
7743,-0.645953270361,0.929241202634,068-ABQ,0.141643966136,97,333,430
7744,-0.645953270361,0.929241202634,068-ABR,0.141643966136,50,116,166
7745,-0.645953270361,0.929241202634,068-ABS,0.141643966136,67,267,334
7746,-0.645953270361,0.929241202634,068-ABT,0.141643966136,92,353,445
7747,-0.645953270361,0.929241202634,069-AAB,0.141643966136,105,401,506
7748,-0.645953270361,0.929241202634,069-AAC,0.141643966136,115,465,580
7749,-0.645953270361,0.929241202634,069-AAF,0.141643966136,72,296,368
7750,-0.645953270361,0.929241202634,069-AAG,0.141643966136,156,599,755
7751,-0.645953270361,0.929241202634,069-AAK,0.141643966136,128,457,585
7752,-0.645953270361,0.929241202634,069-AAN,0.141643966136,184,478,662
7753,-0.645953270361,0.929241202634,069-AAO,0.141643966136,120,336,456
7754,-0.645953270361,0.929241202634,069-AAP,0.141643966136,105,264,369
7755,-0.645953270361,0.929241202634,069-AAQ,0.141643966136,136,468,604
7756,-0.645953270361,0.929241202634,069-AAT,0.141643966136,170,665,835
7757,-0.645953270361,0.929241202634,069-AAU,0.141643966136,163,491,654
7758,-0.645953270361,0.929241202634,069-AAV,0.141643966136,113,269,382
7759,-0.645953270361,0.929241202634,069-AAX,0.141643966136,130,375,505
7760,-0.645953270361,0.929241202634,069-ABA,0.141643966136,122,292,414
7761,-0.645953270361,0.929241202634,069-ABE,0.141643966136,85,259,344
7762,-0.645953270361,0.929241202634,069-ABF,0.141643966136,100,638,738
7763,-0.645953270361,0.929241202634,069-ABH,0.141643966136,169,527,696
7764,-0.645953270361,0.929241202634,069-ABK,0.141643966136,56,413,469
7765,-0.645953270361,0.929241202634,069-ABM,0.141643966136,98,345,443
7766,-0.645953270361,0.929241202634,069-ABO,0.141643966136,69,385,454
7767,-0.645953270361,0.929241202634,069-ABQ,0.141643966136,117,545,662
7768,-0.645953270361,0.929241202634,069-ABR,0.141643966136,97,444,541
7769,-0.645953270361,0.929241202634,069-ABT,0.141643966136,54,194,248
7770,-0.645953270361,0.929241202634,069-ABW,0.141643966136,169,344,513
7771,-0.645953270361,0.929241202634,070-AAA,0.141643966136,184,225,409
7772,-0.645953270361,0.929241202634,070-AAD,0.141643966136,194,398,592
7773,-0.645953270361,0.929241202634,070-AAE,0.141643966136,142,324,466
7774,-0.645953270361,0.929241202634,070-AAF,0.141643966136,180,394,574
7775,-0.645953270361,0.929241202634,070-AAH,0.141643966136,112,367,479
7776,-0.645953270361,0.929241202634,070-AAI,0.141643966136,138,262,400
7777,-0.645953270361,0.929241202634,070-AAK,0.141643966136,102,162,264
7778,-0.645953270361,0.929241202634,070-AAL,0.141643966136,134,157,291
7779,-0.645953270361,0.929241202634,070-AAN,0.141643966136,149,373,522
7780,-0.645953270361,0.929241202634,070-AAP,0.141643966136,153,283,436
7781,-0.645953270361,0.929241202634,070-AAQ,0.141643966136,114,149,263
7782,-0.645953270361,0.929241202634,070-AAR,0.141643966136,149,256,405
7783,-0.645953270361,0.929241202634,070-AAS,0.141643966136,144,295,439
7784,-0.645953270361,0.929241202634,070-AAW,0.141643966136,244,302,546
7785,-0.645953270361,0.929241202634,070-AAX,0.141643966136,171,172,343
7786,-0.645953270361,0.929241202634,070-AAY,0.141643966136,187,346,533
7787,-0.645953270361,0.929241202634,070-ABA,0.141643966136,139,290,429
7788,-0.645953270361,0.929241202634,070-ABB,0.141643966136,155,248,403
7789,-0.645953270361,0.929241202634,070-ABD,0.141643966136,183,215,398
7790,-0.645953270361,0.929241202634,070-ABF,0.141643966136,123,127,250
7791,-0.645953270361,0.929241202634,070-ABG,0.141643966136,163,102,265
7792,-0.645953270361,0.929241202634,070-ABH,0.141643966136,196,63,259
7793,-0.645953270361,0.929241202634,070-ABJ,0.141643966136,209,57,266
7794,-0.645953270361,0.929241202634,070-ABL,0.141643966136,150,29,179
7795,-0.645953270361,0.929241202634,070-ABN,0.141643966136,182,62,244
7796,-0.645953270361,0.929241202634,070-ABO,0.141643966136,84,39,123
7797,-0.645953270361,0.929241202634,070-ABP,0.141643966136,127,110,237
7798,-0.645953270361,0.929241202634,070-ABQ,0.141643966136,123,71,194
7799,-0.645953270361,0.929241202634,070-ABR,0.141643966136,122,77,199
7800,-0.645953270361,0.929241202634,070-ABS,0.141643966136,146,206,352
7801,-0.645953270361,0.929241202634,070-ABT,0.141643966136,260,48,308
7802,-0.645953270361,0.929241202634,070-ABW,0.141643966136,155,99,254
7803,-0.645953270361,0.929241202634,070-ABX,0.141643966136,140,291,431
7804,-0.645953270361,0.929241202634,070-ABY,0.141643966136,92,193,285
7805,-0.645953270361,0.929241202634,070-ACA,0.141643966136,197,407,604
7806,-0.645953270361,0.929241202634,070-ACC,0.141643966136,137,229,366
7807,-0.645953270361,0.929241202634,070-ACE,0.141643966136,185,359,544
7808,-0.645953270361,0.929241202634,070-ACF,0.141643966136,126,372,498
7809,-0.645953270361,0.929241202634,070-ACH,0.141643966136,63,171,234
7810,-0.645953270361,0.929241202634,070-ACI,0.141643966136,35,159,194
7811,-0.645953270361,0.929241202634,070-ACK,0.141643966136,88,224,312
7812,-0.645953270361,0.929241202634,070-ACL,0.141643966136,151,409,560
7813,-0.645953270361,0.929241202634,070-ACN,0.141643966136,128,355,483
7814,-0.645953270361,0.929241202634,070-ACO,0.141643966136,126,375,501
7815,-0.645953270361,0.929241202634,070-ACQ,0.141643966136,116,353,469
7816,-0.645953270361,0.929241202634,070-ACR,0.141643966136,120,481,601
7817,-0.645953270361,0.929241202634,070-ACS,0.141643966136,166,629,795
7818,-0.645953270361,0.929241202634,070-ACU,0.141643966136,180,362,542
7819,-0.645953270361,0.929241202634,070-ACY,0.141643966136,156,250,406
7820,-0.645953270361,0.929241202634,070-ACZ,0.141643966136,207,402,609
7821,-0.645953270361,0.929241202634,070-ADB,0.141643966136,179,272,451
7822,-0.645953270361,0.929241202634,070-ADC,0.141643966136,222,344,566
7823,-0.645953270361,0.929241202634,070-ADG,0.141643966136,188,330,518
7824,-0.645953270361,0.929241202634,070-ADH,0.141643966136,117,215,332
7825,-0.645953270361,0.929241202634,070-ADI,0.141643966136,144,322,466
7826,-0.645953270361,0.929241202634,070-ADJ,0.141643966136,141,241,382
7827,-0.645953270361,0.929241202634,070-ADK,0.141643966136,104,240,344
7828,-0.645953270361,0.929241202634,070-ADL,0.141643966136,126,173,299
7829,-0.645953270361,0.929241202634,070-ADM,0.141643966136,146,219,365
7830,-0.645953270361,0.929241202634,070-ADN,0.141643966136,156,412,568
7831,-0.645953270361,0.929241202634,070-ADP,0.141643966136,116,404,520
7832,-0.645953270361,0.929241202634,070-ADQ,0.141643966136,104,344,448
7833,-0.645953270361,0.929241202634,070-ADS,0.141643966136,148,373,521
7834,-0.645953270361,0.929241202634,070-ADT,0.141643966136,123,245,368
7835,-0.645953270361,0.929241202634,070-ADU,0.141643966136,99,276,375
7836,-0.645953270361,0.929241202634,070-ADV,0.141643966136,106,262,368
7837,-0.645953270361,0.929241202634,070-ADW,0.141643966136,173,523,696
7838,-0.645953270361,0.929241202634,070-ADX,0.141643966136,169,310,479
7839,-0.645953270361,0.929241202634,070-ADY,0.141643966136,118,353,471
7840,-0.645953270361,0.929241202634,070-AEF,0.141643966136,122,403,525
7841,-0.645953270361,0.929241202634,070-AEG,0.141643966136,137,442,579
7842,-0.645953270361,0.929241202634,070-AEI,0.141643966136,127,359,486
7843,-0.645953270361,0.929241202634,070-AEJ,0.141643966136,111,407,518
7844,-0.645953270361,0.929241202634,070-AEL,0.141643966136,195,575,770
7845,-0.645953270361,0.929241202634,070-AEM,0.141643966136,118,311,429
7846,-0.645953270361,0.929241202634,070-AEN,0.141643966136,81,213,294
7847,-0.645953270361,0.929241202634,070-AEO,0.141643966136,151,358,509
7848,-0.645953270361,0.929241202634,070-AEP,0.141643966136,124,349,473
7849,-0.645953270361,0.929241202634,070-AEQ,0.141643966136,96,263,359
7850,-0.645953270361,0.929241202634,070-AER,0.141643966136,147,485,632
7851,-0.645953270361,0.929241202634,070-AET,0.141643966136,162,502,664
7852,-0.645953270361,0.929241202634,070-AEV,0.141643966136,128,236,364
7853,-0.645953270361,0.929241202634,070-AEW,0.141643966136,69,215,284
7854,-0.645953270361,0.929241202634,070-AEX,0.141643966136,76,209,285
7855,-0.645953270361,0.929241202634,070-AEY,0.141643966136,189,550,739
7856,-0.645953270361,0.929241202634,070-AFB,0.141643966136,216,329,545
7857,-0.645953270361,0.929241202634,070-AFD,0.141643966136,172,324,496
7858,-0.645953270361,0.929241202634,070-AFF,0.141643966136,200,476,676
7859,-0.645953270361,0.929241202634,070-AFH,0.141643966136,204,554,758
7860,-0.645953270361,0.929241202634,071-AAA,0.141643966136,99,183,282
7861,-0.645953270361,0.929241202634,071-AAB,0.141643966136,121,253,374
7862,-0.645953270361,0.929241202634,071-AAC,0.141643966136,137,304,441
7863,-0.645953270361,0.929241202634,071-AAD,0.141643966136,119,251,370
7864,-0.645953270361,0.929241202634,071-AAE,0.141643966136,105,166,271
7865,-0.645953270361,0.929241202634,071-AAG,0.141643966136,64,63,127
7866,-0.645953270361,0.929241202634,071-AAH,0.141643966136,129,221,350
7867,-0.645953270361,0.929241202634,071-AAI,0.141643966136,128,143,271
7868,-0.645953270361,0.929241202634,071-AAJ,0.141643966136,136,226,362
7869,-0.645953270361,0.929241202634,071-AAK,0.141643966136,164,257,421
7870,-0.645953270361,0.929241202634,071-AAL,0.141643966136,135,131,266
7871,-0.645953270361,0.929241202634,071-AAM,0.141643966136,114,113,227
7872,-0.645953270361,0.929241202634,071-AAN,0.141643966136,43,46,89
7873,-0.645953270361,0.929241202634,071-AAO,0.141643966136,130,149,279
7874,-0.645953270361,0.929241202634,071-AAP,0.141643966136,50,62,112
7875,-0.645953270361,0.929241202634,071-AAQ,0.141643966136,78,71,149
7876,-0.645953270361,0.929241202634,071-AAR,0.141643966136,91,66,157
7877,-0.645953270361,0.929241202634,071-AAS,0.141643966136,68,43,111
7878,-0.645953270361,0.929241202634,071-AAT,0.141643966136,129,123,252
7879,-0.645953270361,0.929241202634,071-AAU,0.141643966136,36,42,78
7880,-0.645953270361,0.929241202634,071-AAV,0.141643966136,112,112,224
7881,-0.645953270361,0.929241202634,071-AAW,0.141643966136,57,19,76
7882,-0.645953270361,0.929241202634,071-AAX,0.141643966136,56,160,216
7883,-0.645953270361,0.929241202634,071-AAY,0.141643966136,142,197,339
7884,-0.645953270361,0.929241202634,071-AAZ,0.141643966136,75,84,159
7885,-0.645953270361,0.929241202634,071-ABA,0.141643966136,121,111,232
7886,-0.645953270361,0.929241202634,071-ABB,0.141643966136,59,91,150
7887,-0.645953270361,0.929241202634,071-ABC,0.141643966136,88,92,180
7888,-0.645953270361,0.929241202634,071-ABD,0.141643966136,36,47,83
7889,-0.645953270361,0.929241202634,071-ABE,0.141643966136,75,180,255
7890,-0.645953270361,0.929241202634,071-ABF,0.141643966136,94,114,208
7891,-0.645953270361,0.929241202634,071-ABG,0.141643966136,22,34,56
7892,-0.645953270361,0.929241202634,071-ABH,0.141643966136,35,49,84
7893,-0.645953270361,0.929241202634,071-ABI,0.141643966136,68,98,166
7894,-0.645953270361,0.929241202634,071-ABJ,0.141643966136,101,216,317
7895,-0.645953270361,0.929241202634,071-ABK,0.141643966136,78,135,213
7896,-0.645953270361,0.929241202634,071-ABL,0.141643966136,139,210,349
7897,-0.645953270361,0.929241202634,071-ABM,0.141643966136,126,292,418
7898,-0.645953270361,0.929241202634,071-ABN,0.141643966136,121,246,367
7899,-0.645953270361,0.929241202634,071-ABO,0.141643966136,37,51,88
7900,-0.645953270361,0.929241202634,071-ABP,0.141643966136,54,142,196
7901,-0.645953270361,0.929241202634,071-ABQ,0.141643966136,88,95,183
7902,-0.645953270361,0.929241202634,071-ABR,0.141643966136,84,115,199
7903,-0.645953270361,0.929241202634,071-ABS,0.141643966136,98,204,302
7904,-0.645953270361,0.929241202634,071-ABT,0.141643966136,100,252,352
7905,-0.645953270361,0.929241202634,071-ABU,0.141643966136,175,279,454
7906,-0.645953270361,0.929241202634,071-ABV,0.141643966136,124,196,320
7907,-0.645953270361,0.929241202634,071-ABW,0.141643966136,135,230,365
7908,-0.645953270361,0.929241202634,071-ABX,0.141643966136,201,284,485
7909,-0.645953270361,0.929241202634,071-ABY,0.141643966136,127,136,263
7910,-0.645953270361,0.929241202634,071-ABZ,0.141643966136,132,161,293
7911,-0.645953270361,0.929241202634,071-ACA,0.141643966136,139,197,336
7912,-0.645953270361,0.929241202634,071-ACB,0.141643966136,128,228,356
7913,-0.645953270361,0.929241202634,071-ACC,0.141643966136,150,255,405
7914,-0.645953270361,0.929241202634,071-ACD,0.141643966136,92,227,319
7915,-0.645953270361,0.929241202634,071-ACE,0.141643966136,102,124,226
7916,-0.645953270361,0.929241202634,071-ACF,0.141643966136,110,186,296
7917,-0.645953270361,0.929241202634,071-ACG,0.141643966136,138,170,308
7918,-0.645953270361,0.929241202634,071-ACI,0.141643966136,97,162,259
7919,-0.645953270361,0.929241202634,071-ACJ,0.141643966136,27,32,59
7920,-0.645953270361,0.929241202634,071-ACK,0.141643966136,82,137,219
7921,-0.645953270361,0.929241202634,071-ACL,0.141643966136,130,175,305
7922,-0.645953270361,0.929241202634,071-ACM,0.141643966136,124,203,327
7923,-0.645953270361,0.929241202634,071-ACN,0.141643966136,199,354,553
7924,-0.645953270361,0.929241202634,071-ACO,0.141643966136,96,166,262
7925,-0.645953270361,0.929241202634,071-ACP,0.141643966136,99,146,245
7926,-0.645953270361,0.929241202634,071-ACQ,0.141643966136,71,127,198
7927,-0.645953270361,0.929241202634,071-ACR,0.141643966136,118,181,299
7928,-0.645953270361,0.929241202634,071-ACS,0.141643966136,103,199,302
7929,-0.645953270361,0.929241202634,071-ACT,0.141643966136,91,218,309
7930,-0.645953270361,0.929241202634,071-ACU,0.141643966136,108,235,343
7931,-0.645953270361,0.929241202634,071-ACV,0.141643966136,48,90,138
7932,-0.645953270361,0.929241202634,071-ACW,0.141643966136,186,371,557
7933,-0.645953270361,0.929241202634,071-ACX,0.141643966136,149,264,413
7934,-0.645953270361,0.929241202634,071-ACY,0.141643966136,182,312,494
7935,-0.645953270361,0.929241202634,071-ADA,0.141643966136,149,325,474
7936,-0.645953270361,0.929241202634,072-AAA,0.141643966136,171,314,485
7937,-0.645953270361,0.929241202634,072-AAC,0.141643966136,114,148,262
7938,-0.645953270361,0.929241202634,072-AAD,0.141643966136,69,115,184
7939,-0.645953270361,0.929241202634,072-AAE,0.141643966136,159,241,400
7940,-0.645953270361,0.929241202634,072-AAG,0.141643966136,119,221,340
7941,-0.645953270361,0.929241202634,072-AAI,0.141643966136,109,180,289
7942,-0.645953270361,0.929241202634,072-AAJ,0.141643966136,83,136,219
7943,-0.645953270361,0.929241202634,072-AAK,0.141643966136,89,168,257
7944,-0.645953270361,0.929241202634,072-AAL,0.141643966136,185,345,530
7945,-0.645953270361,0.929241202634,072-AAM,0.141643966136,117,114,231
7946,-0.645953270361,0.929241202634,072-AAO,0.141643966136,129,130,259
7947,-0.645953270361,0.929241202634,072-AAQ,0.141643966136,60,101,161
7948,-0.645953270361,0.929241202634,072-AAR,0.141643966136,113,222,335
7949,-0.645953270361,0.929241202634,072-AAT,0.141643966136,98,111,209
7950,-0.645953270361,0.929241202634,072-AAU,0.141643966136,131,104,235
7951,-0.645953270361,0.929241202634,072-AAW,0.141643966136,130,171,301
7952,-0.645953270361,0.929241202634,072-AAY,0.141643966136,94,86,180
7953,-0.645953270361,0.929241202634,072-ABA,0.141643966136,99,97,196
7954,-0.645953270361,0.929241202634,072-ABC,0.141643966136,197,241,438
7955,-0.645953270361,0.929241202634,072-ABE,0.141643966136,158,204,362
7956,-0.645953270361,0.929241202634,072-ABH,0.141643966136,108,186,294
7957,-0.645953270361,0.929241202634,072-ABJ,0.141643966136,134,180,314
7958,-0.645953270361,0.929241202634,072-ABL,0.141643966136,51,58,109
7959,-0.645953270361,0.929241202634,072-ABM,0.141643966136,86,107,193
7960,-0.645953270361,0.929241202634,072-ABN,0.141643966136,126,355,481
7961,-0.645953270361,0.929241202634,072-ABO,0.141643966136,73,212,285
7962,-0.645953270361,0.929241202634,072-ABR,0.141643966136,144,375,519
7963,-0.645953270361,0.929241202634,072-ABS,0.141643966136,142,263,405
7964,-0.645953270361,0.929241202634,072-ABV,0.141643966136,101,272,373
7965,-0.645953270361,0.929241202634,072-ABW,0.141643966136,111,225,336
7966,-0.645953270361,0.929241202634,072-ABX,0.141643966136,69,104,173
7967,-0.645953270361,0.929241202634,072-ABY,0.141643966136,74,147,221
7968,-0.645953270361,0.929241202634,072-ABZ,0.141643966136,89,217,306
7969,-0.645953270361,0.929241202634,072-ACA,0.141643966136,93,219,312
7970,-0.645953270361,0.929241202634,072-ACB,0.141643966136,83,183,266
7971,-0.645953270361,0.929241202634,072-ACC,0.141643966136,121,230,351
7972,-0.645953270361,0.929241202634,072-ACD,0.141643966136,72,151,223
7973,-0.645953270361,0.929241202634,072-ACE,0.141643966136,137,296,433
7974,-0.645953270361,0.929241202634,072-ACG,0.141643966136,118,198,316
7975,-0.645953270361,0.929241202634,072-ACI,0.141643966136,172,230,402
7976,-0.645953270361,0.929241202634,072-ACK,0.141643966136,143,237,380
7977,-0.645953270361,0.929241202634,072-ACM,0.141643966136,160,301,461
7978,-0.645953270361,0.929241202634,072-ACO,0.141643966136,110,228,338
7979,-0.645953270361,0.929241202634,072-ACP,0.141643966136,64,149,213
7980,-0.645953270361,0.929241202634,072-ACQ,0.141643966136,152,165,317
7981,-0.645953270361,0.929241202634,072-ACV,0.141643966136,143,307,450
7982,-0.645953270361,0.929241202634,072-ACX,0.141643966136,198,325,523
7983,-0.645953270361,0.929241202634,072-ACZ,0.141643966136,32,51,83
7984,-0.645953270361,0.929241202634,072-ADA,0.141643966136,50,121,171
7985,-0.645953270361,0.929241202634,072-ADB,0.141643966136,61,175,236
7986,-0.645953270361,0.929241202634,072-ADC,0.141643966136,117,255,372
7987,-0.645953270361,0.929241202634,072-ADE,0.141643966136,191,335,526
7988,-0.645953270361,0.929241202634,072-ADG,0.141643966136,200,340,540
7989,-0.645953270361,0.929241202634,072-ADI,0.141643966136,139,168,307
7990,-0.645953270361,0.929241202634,072-ADJ,0.141643966136,109,251,360
7991,-0.645953270361,0.929241202634,072-ADK,0.141643966136,131,335,466
7992,-0.645953270361,0.929241202634,072-ADS,0.141643966136,124,327,451
7993,-0.645953270361,0.929241202634,073-AAA,0.141643966136,166,169,335
7994,-0.645953270361,0.929241202634,073-AAB,0.141643966136,129,113,242
7995,-0.645953270361,0.929241202634,073-AAC,0.141643966136,193,220,413
7996,-0.645953270361,0.929241202634,073-AAI,0.141643966136,58,53,111
7997,-0.645953270361,0.929241202634,073-AAJ,0.141643966136,125,20,145
7998,-0.645953270361,0.929241202634,073-AAK,0.141643966136,92,92,184
7999,-0.645953270361,0.929241202634,073-AAO,0.141643966136,87,205,292
8000,-0.645953270361,0.929241202634,073-AAP,0.141643966136,99,87,186
8001,-0.645953270361,0.929241202634,073-AAQ,0.141643966136,159,260,419
8002,-0.645953270361,0.929241202634,073-AAR,0.141643966136,206,325,531
8003,-0.645953270361,0.929241202634,073-AAX,0.141643966136,149,107,256
8004,-0.645953270361,0.929241202634,073-AAY,0.141643966136,142,109,251
8005,-0.645953270361,0.929241202634,073-ABD,0.141643966136,85,110,195
8006,-0.645953270361,0.929241202634,073-ABE,0.141643966136,77,201,278
8007,-0.645953270361,0.929241202634,073-ABF,0.141643966136,60,219,279
8008,-0.645953270361,0.929241202634,073-ABG,0.141643966136,116,159,275
8009,-0.645953270361,0.929241202634,073-ABJ,0.141643966136,130,96,226
8010,-0.645953270361,0.929241202634,073-ABK,0.141643966136,112,134,246
8011,-0.645953270361,0.929241202634,073-ABL,0.141643966136,160,166,326
8012,-0.645953270361,0.929241202634,073-ABQ,0.141643966136,123,195,318
8013,-0.645953270361,0.929241202634,073-ABR,0.141643966136,119,165,284
8014,-0.645953270361,0.929241202634,073-ABS,0.141643966136,113,162,275
8015,-0.645953270361,0.929241202634,073-ABU,0.141643966136,149,204,353
8016,-0.645953270361,0.929241202634,073-ABV,0.141643966136,167,274,441
8017,-0.645953270361,0.929241202634,073-ABW,0.141643966136,157,149,306
8018,-0.645953270361,0.929241202634,073-ABX,0.141643966136,75,162,237
8019,-0.645953270361,0.929241202634,073-ABY,0.141643966136,109,175,284
8020,-0.645953270361,0.929241202634,073-ACB,0.141643966136,130,187,317
8021,-0.645953270361,0.929241202634,073-ACC,0.141643966136,119,133,252
8022,-0.645953270361,0.929241202634,073-ACD,0.141643966136,135,154,289
8023,-0.645953270361,0.929241202634,073-ACE,0.141643966136,112,117,229
8024,-0.645953270361,0.929241202634,073-ACF,0.141643966136,162,165,327
8025,-0.645953270361,0.929241202634,073-ACG,0.141643966136,101,184,285
8026,-0.645953270361,0.929241202634,073-ACH,0.141643966136,122,203,325
8027,-0.645953270361,0.929241202634,073-ACI,0.141643966136,118,139,257
8028,-0.645953270361,0.929241202634,073-ACJ,0.141643966136,85,167,252
8029,-0.645953270361,0.929241202634,073-ACK,0.141643966136,82,158,240
8030,-0.645953270361,0.929241202634,073-ACL,0.141643966136,150,216,366
8031,-0.645953270361,0.929241202634,073-ACM,0.141643966136,92,114,206
8032,-0.645953270361,0.929241202634,073-ACN,0.141643966136,91,203,294
8033,-0.645953270361,0.929241202634,073-ACO,0.141643966136,136,210,346
8034,-0.645953270361,0.929241202634,073-ACP,0.141643966136,117,190,307
8035,-0.645953270361,0.929241202634,073-ACQ,0.141643966136,116,211,327
8036,-0.645953270361,0.929241202634,073-ACR,0.141643966136,143,284,427
8037,-0.645953270361,0.929241202634,073-ACS,0.141643966136,167,131,298
8038,-0.645953270361,0.929241202634,073-ACT,0.141643966136,188,158,346
8039,-0.645953270361,0.929241202634,073-ACU,0.141643966136,145,119,264
8040,-0.645953270361,0.929241202634,073-ACW,0.141643966136,137,95,232
8041,-0.645953270361,0.929241202634,073-ADC,0.141643966136,136,185,321
8042,-0.645953270361,0.929241202634,073-ADD,0.141643966136,161,266,427
8043,-0.645953270361,0.929241202634,073-ADE,0.141643966136,62,44,106
8044,-0.645953270361,0.929241202634,073-ADF,0.141643966136,143,209,352
8045,-0.645953270361,0.929241202634,073-ADG,0.141643966136,121,180,301
8046,-0.645953270361,0.929241202634,073-ADH,0.141643966136,147,195,342
8047,-0.645953270361,0.929241202634,073-ADI,0.141643966136,96,99,195
8048,-0.645953270361,0.929241202634,073-ADJ,0.141643966136,88,140,228
8049,-0.645953270361,0.929241202634,073-ADK,0.141643966136,120,296,416
8050,-0.645953270361,0.929241202634,073-ADL,0.141643966136,160,272,432
8051,-0.645953270361,0.929241202634,073-ADM,0.141643966136,160,286,446
8052,-0.645953270361,0.929241202634,073-ADN,0.141643966136,152,262,414
8053,-0.645953270361,0.929241202634,073-ADR,0.141643966136,111,158,269
8054,-0.645953270361,0.929241202634,073-ADT,0.141643966136,124,159,283
8055,-0.645953270361,0.929241202634,073-ADU,0.141643966136,129,204,333
8056,-0.645953270361,0.929241202634,073-ADV,0.141643966136,138,203,341
8057,-0.645953270361,0.929241202634,073-ADW,0.141643966136,208,243,451
8058,-0.645953270361,0.929241202634,073-ADX,0.141643966136,118,149,267
8059,-0.645953270361,0.929241202634,073-ADY,0.141643966136,107,293,400
8060,-0.645953270361,0.929241202634,073-ADZ,0.141643966136,88,151,239
8061,-0.645953270361,0.929241202634,073-AEA,0.141643966136,50,152,202
8062,-0.645953270361,0.929241202634,073-AEC,0.141643966136,117,77,194
8063,-0.645953270361,0.929241202634,073-AED,0.141643966136,157,219,376
8064,-0.645953270361,0.929241202634,073-AEE,0.141643966136,163,165,328
8065,-0.645953270361,0.929241202634,073-AEF,0.141643966136,183,151,334
8066,-0.645953270361,0.929241202634,073-AEG,0.141643966136,137,159,296
8067,-0.645953270361,0.929241202634,073-AEH,0.141643966136,93,124,217
8068,-0.645953270361,0.929241202634,073-AEI,0.141643966136,185,172,357
8069,-0.645953270361,0.929241202634,073-AEP,0.141643966136,67,70,137
8070,-0.645953270361,0.929241202634,074-AAA,0.141643966136,211,217,428
8071,-0.645953270361,0.929241202634,074-AAC,0.141643966136,211,159,370
8072,-0.645953270361,0.929241202634,074-AAE,0.141643966136,146,147,293
8073,-0.645953270361,0.929241202634,074-AAF,0.141643966136,130,102,232
8074,-0.645953270361,0.929241202634,074-AAI,0.141643966136,211,152,363
8075,-0.645953270361,0.929241202634,074-AAL,0.141643966136,115,127,242
8076,-0.645953270361,0.929241202634,074-AAM,0.141643966136,60,90,150
8077,-0.645953270361,0.929241202634,074-AAN,0.141643966136,138,213,351
8078,-0.645953270361,0.929241202634,074-AAO,0.141643966136,149,250,399
8079,-0.645953270361,0.929241202634,074-AAR,0.141643966136,164,217,381
8080,-0.645953270361,0.929241202634,074-AAS,0.141643966136,85,107,192
8081,-0.645953270361,0.929241202634,074-AAT,0.141643966136,201,302,503
8082,-0.645953270361,0.929241202634,074-AAW,0.141643966136,124,143,267
8083,-0.645953270361,0.929241202634,074-AAX,0.141643966136,98,156,254
8084,-0.645953270361,0.929241202634,074-AAY,0.141643966136,127,179,306
8085,-0.645953270361,0.929241202634,074-AAZ,0.141643966136,102,162,264
8086,-0.645953270361,0.929241202634,074-ABB,0.141643966136,109,347,456
8087,-0.645953270361,0.929241202634,074-ABC,0.141643966136,204,506,710
8088,-0.645953270361,0.929241202634,074-ABE,0.141643966136,128,220,348
8089,-0.645953270361,0.929241202634,074-ABG,0.141643966136,85,176,261
8090,-0.645953270361,0.929241202634,074-ABI,0.141643966136,53,98,151
8091,-0.645953270361,0.929241202634,074-ABJ,0.141643966136,118,298,416
8092,-0.645953270361,0.929241202634,074-ABL,0.141643966136,29,68,97
8093,-0.645953270361,0.929241202634,074-ABM,0.141643966136,130,391,521
8094,-0.645953270361,0.929241202634,074-ABO,0.141643966136,89,186,275
8095,-0.645953270361,0.929241202634,074-ABP,0.141643966136,66,151,217
8096,-0.645953270361,0.929241202634,074-ABQ,0.141643966136,81,208,289
8097,-0.645953270361,0.929241202634,074-ABR,0.141643966136,74,187,261
8098,-0.645953270361,0.929241202634,074-ABS,0.141643966136,131,309,440
8099,-0.645953270361,0.929241202634,074-ABT,0.141643966136,97,259,356
8100,-0.645953270361,0.929241202634,074-ABU,0.141643966136,69,181,250
8101,-0.645953270361,0.929241202634,074-ABV,0.141643966136,144,371,515
8102,-0.645953270361,0.929241202634,074-ABX,0.141643966136,86,222,308
8103,-0.645953270361,0.929241202634,074-ABY,0.141643966136,107,264,371
8104,-0.645953270361,0.929241202634,074-ABZ,0.141643966136,99,251,350
8105,-0.645953270361,0.929241202634,074-ACA,0.141643966136,83,237,320
8106,-0.645953270361,0.929241202634,074-ACB,0.141643966136,185,301,486
8107,-0.645953270361,0.929241202634,074-ACD,0.141643966136,67,126,193
8108,-0.645953270361,0.929241202634,074-ACE,0.141643966136,76,215,291
8109,-0.645953270361,0.929241202634,074-ACF,0.141643966136,75,150,225
8110,-0.645953270361,0.929241202634,074-ACG,0.141643966136,181,291,472
8111,-0.645953270361,0.929241202634,074-ACH,0.141643966136,82,169,251
8112,-0.645953270361,0.929241202634,074-ACJ,0.141643966136,168,433,601
8113,-0.645953270361,0.929241202634,074-ACL,0.141643966136,75,205,280
8114,-0.645953270361,0.929241202634,074-ACM,0.141643966136,104,301,405
8115,-0.645953270361,0.929241202634,074-ACN,0.141643966136,40,109,149
8116,-0.645953270361,0.929241202634,074-ACP,0.141643966136,91,261,352
8117,-0.645953270361,0.929241202634,074-ACQ,0.141643966136,46,153,199
8118,-0.645953270361,0.929241202634,074-ACR,0.141643966136,161,295,456
8119,-0.645953270361,0.929241202634,074-ACT,0.141643966136,76,183,259
8120,-0.645953270361,0.929241202634,074-ACU,0.141643966136,51,224,275
8121,-0.645953270361,0.929241202634,075-AAA,0.141643966136,151,510,661
8122,-0.645953270361,0.929241202634,075-AAB,0.141643966136,132,322,454
8123,-0.645953270361,0.929241202634,075-AAF,0.141643966136,149,552,701
8124,-0.645953270361,0.929241202634,075-AAH,0.141643966136,105,265,370
8125,-0.645953270361,0.929241202634,075-AAJ,0.141643966136,132,380,512
8126,-0.645953270361,0.929241202634,075-AAL,0.141643966136,91,235,326
8127,-0.645953270361,0.929241202634,075-AAM,0.141643966136,146,361,507
8128,-0.645953270361,0.929241202634,075-AAN,0.141643966136,214,281,495
8129,-0.645953270361,0.929241202634,075-AAQ,0.141643966136,217,462,679
8130,-0.645953270361,0.929241202634,075-AAS,0.141643966136,76,190,266
8131,-0.645953270361,0.929241202634,075-AAT,0.141643966136,135,250,385
8132,-0.645953270361,0.929241202634,075-AAU,0.141643966136,133,315,448
8133,-0.645953270361,0.929241202634,075-AAY,0.141643966136,121,471,592
8134,-0.645953270361,0.929241202634,075-AAZ,0.141643966136,121,301,422
8135,-0.645953270361,0.929241202634,075-ABC,0.141643966136,52,284,336
8136,-0.645953270361,0.929241202634,075-ABD,0.141643966136,93,337,430
8137,-0.645953270361,0.929241202634,075-ABE,0.141643966136,103,363,466
8138,-0.645953270361,0.929241202634,075-ABF,0.141643966136,76,500,576
8139,-0.645953270361,0.929241202634,075-ABH,0.141643966136,65,357,422
8140,-0.645953270361,0.929241202634,075-ABK,0.141643966136,106,611,717
8141,-0.645953270361,0.929241202634,075-ABM,0.141643966136,50,290,340
8142,-0.645953270361,0.929241202634,075-ABO,0.141643966136,53,340,393
8143,-0.645953270361,0.929241202634,075-ABQ,0.141643966136,99,331,430
8144,-0.645953270361,0.929241202634,075-ABS,0.141643966136,67,360,427
8145,-0.645953270361,0.929241202634,075-ABU,0.141643966136,81,483,564
8146,-0.645953270361,0.929241202634,075-ABV,0.141643966136,119,536,655
8147,-0.645953270361,0.929241202634,075-ABX,0.141643966136,138,491,629
8148,-0.645953270361,0.929241202634,075-ABZ,0.141643966136,105,488,593
8149,-0.645953270361,0.929241202634,075-ACB,0.141643966136,74,280,354
8150,-0.645953270361,0.929241202634,075-ACD,0.141643966136,101,347,448
8151,-0.645953270361,0.929241202634,075-ACF,0.141643966136,88,393,481
8152,-0.645953270361,0.929241202634,075-ACG,0.141643966136,121,483,604
8153,-0.645953270361,0.929241202634,075-ACJ,0.141643966136,40,364,404
8154,-0.645953270361,0.929241202634,075-ACL,0.141643966136,86,435,521
8155,-0.645953270361,0.929241202634,075-ACN,0.141643966136,112,502,614
8156,-0.645953270361,0.929241202634,076-AAA,0.141643966136,119,84,203
8157,-0.645953270361,0.929241202634,076-AAB,0.141643966136,106,103,209
8158,-0.645953270361,0.929241202634,076-AAC,0.141643966136,132,128,260
8159,-0.645953270361,0.929241202634,076-AAD,0.141643966136,176,37,213
8160,-0.645953270361,0.929241202634,076-AAE,0.141643966136,89,103,192
8161,-0.645953270361,0.929241202634,076-AAF,0.141643966136,85,62,147
8162,-0.645953270361,0.929241202634,076-AAG,0.141643966136,117,57,174
8163,-0.645953270361,0.929241202634,076-AAH,0.141643966136,159,39,198
8164,-0.645953270361,0.929241202634,076-AAI,0.141643966136,106,137,243
8165,-0.645953270361,0.929241202634,076-AAJ,0.141643966136,141,182,323
8166,-0.645953270361,0.929241202634,076-AAK,0.141643966136,122,108,230
8167,-0.645953270361,0.929241202634,076-AAL,0.141643966136,62,94,156
8168,-0.645953270361,0.929241202634,076-AAM,0.141643966136,177,207,384
8169,-0.645953270361,0.929241202634,076-AAN,0.141643966136,170,346,516
8170,-0.645953270361,0.929241202634,076-AAO,0.141643966136,122,181,303
8171,-0.645953270361,0.929241202634,076-AAP,0.141643966136,172,302,474
8172,-0.645953270361,0.929241202634,076-AAQ,0.141643966136,135,226,361
8173,-0.645953270361,0.929241202634,076-AAR,0.141643966136,109,187,296
8174,-0.645953270361,0.929241202634,076-AAS,0.141643966136,117,173,290
8175,-0.645953270361,0.929241202634,076-AAT,0.141643966136,51,18,69
8176,-0.645953270361,0.929241202634,076-AAU,0.141643966136,109,115,224
8177,-0.645953270361,0.929241202634,076-AAV,0.141643966136,106,68,174
8178,-0.645953270361,0.929241202634,076-AAW,0.141643966136,99,55,154
8179,-0.645953270361,0.929241202634,076-AAX,0.141643966136,99,94,193
8180,-0.645953270361,0.929241202634,076-AAY,0.141643966136,137,69,206
8181,-0.645953270361,0.929241202634,076-AAZ,0.141643966136,159,84,243
8182,-0.645953270361,0.929241202634,076-ABA,0.141643966136,120,38,158
8183,-0.645953270361,0.929241202634,076-ABB,0.141643966136,145,61,206
8184,-0.645953270361,0.929241202634,076-ABC,0.141643966136,106,65,171
8185,-0.645953270361,0.929241202634,076-ABD,0.141643966136,170,22,192
8186,-0.645953270361,0.929241202634,076-ABE,0.141643966136,222,58,280
8187,-0.645953270361,0.929241202634,076-ABF,0.141643966136,166,19,185
8188,-0.645953270361,0.929241202634,076-ABG,0.141643966136,131,173,304
8189,-0.645953270361,0.929241202634,076-ABH,0.141643966136,80,80,160
8190,-0.645953270361,0.929241202634,076-ABI,0.141643966136,167,151,318
8191,-0.645953270361,0.929241202634,076-ABJ,0.141643966136,95,43,138
8192,-0.645953270361,0.929241202634,076-ABK,0.141643966136,70,73,143
8193,-0.645953270361,0.929241202634,076-ABL,0.141643966136,117,99,216
8194,-0.645953270361,0.929241202634,076-ABM,0.141643966136,99,72,171
8195,-0.645953270361,0.929241202634,076-ABN,0.141643966136,179,153,332
8196,-0.645953270361,0.929241202634,076-ABO,0.141643966136,153,126,279
8197,-0.645953270361,0.929241202634,076-ABP,0.141643966136,232,32,264
8198,-0.645953270361,0.929241202634,076-ABQ,0.141643966136,189,16,205
8199,-0.645953270361,0.929241202634,076-ABR,0.141643966136,426,34,460
8200,-0.645953270361,0.929241202634,076-ABS,0.141643966136,235,13,248
8201,-0.645953270361,0.929241202634,076-ABT,0.141643966136,144,15,159
8202,-0.645953270361,0.929241202634,076-ABU,0.141643966136,231,38,269
8203,-0.645953270361,0.929241202634,076-ABV,0.141643966136,130,43,173
8204,-0.645953270361,0.929241202634,076-ABW,0.141643966136,144,94,238
8205,-0.645953270361,0.929241202634,076-ABX,0.141643966136,109,92,201
8206,-0.645953270361,0.929241202634,076-ABY,0.141643966136,113,67,180
8207,-0.645953270361,0.929241202634,076-ABZ,0.141643966136,129,97,226
8208,-0.645953270361,0.929241202634,076-ACA,0.141643966136,92,53,145
8209,-0.645953270361,0.929241202634,076-ACB,0.141643966136,104,67,171
8210,-0.645953270361,0.929241202634,076-ACC,0.141643966136,112,55,167
8211,-0.645953270361,0.929241202634,076-ACD,0.141643966136,238,40,278
8212,-0.645953270361,0.929241202634,076-ACE,0.141643966136,146,68,214
8213,-0.645953270361,0.929241202634,076-ACF,0.141643966136,162,29,191
8214,-0.645953270361,0.929241202634,076-ACG,0.141643966136,164,43,207
8215,-0.645953270361,0.929241202634,076-ACH,0.141643966136,156,77,233
8216,-0.645953270361,0.929241202634,076-ACI,0.141643966136,143,53,196
8217,-0.645953270361,0.929241202634,076-ACJ,0.141643966136,143,27,170
8218,-0.645953270361,0.929241202634,076-ACK,0.141643966136,154,113,267
8219,-0.645953270361,0.929241202634,076-ACL,0.141643966136,85,103,188
8220,-0.645953270361,0.929241202634,076-ACM,0.141643966136,186,120,306
8221,-0.645953270361,0.929241202634,076-ACN,0.141643966136,83,65,148
8222,-0.645953270361,0.929241202634,076-ACO,0.141643966136,124,145,269
8223,-0.645953270361,0.929241202634,076-ACP,0.141643966136,115,188,303
8224,-0.645953270361,0.929241202634,076-ACQ,0.141643966136,191,244,435
8225,-0.645953270361,0.929241202634,076-ACR,0.141643966136,115,111,226
8226,-0.645953270361,0.929241202634,076-ACS,0.141643966136,136,98,234
8227,-0.645953270361,0.929241202634,076-ACT,0.141643966136,114,108,222
8228,-0.645953270361,0.929241202634,076-ACU,0.141643966136,185,139,324
8229,-0.645953270361,0.929241202634,076-ACV,0.141643966136,109,185,294
8230,-0.645953270361,0.929241202634,076-ACW,0.141643966136,149,99,248
8231,-0.645953270361,0.929241202634,076-ACX,0.141643966136,143,136,279
8232,-0.645953270361,0.929241202634,076-ACY,0.141643966136,270,336,606
8233,-0.645953270361,0.929241202634,076-ACZ,0.141643966136,150,159,309
8234,-0.645953270361,0.929241202634,076-ADA,0.141643966136,120,85,205
8235,-0.645953270361,0.929241202634,076-ADB,0.141643966136,267,316,583
8236,-0.645953270361,0.929241202634,076-ADC,0.141643966136,85,119,204
8237,-0.645953270361,0.929241202634,076-ADD,0.141643966136,158,243,401
8238,-0.645953270361,0.929241202634,076-ADE,0.141643966136,208,47,255
8239,-0.645953270361,0.929241202634,076-ADF,0.141643966136,199,129,328
8240,-0.645953270361,0.929241202634,076-ADG,0.141643966136,207,90,297
8241,-0.645953270361,0.929241202634,076-ADH,0.141643966136,145,128,273
8242,-0.645953270361,0.929241202634,076-ADI,0.141643966136,149,51,200
8243,-0.645953270361,0.929241202634,076-ADJ,0.141643966136,176,105,281
8244,-0.645953270361,0.929241202634,076-ADK,0.141643966136,183,89,272
8245,-0.645953270361,0.929241202634,076-ADL,0.141643966136,172,238,410
8246,-0.645953270361,0.929241202634,076-ADM,0.141643966136,146,291,437
8247,-0.645953270361,0.929241202634,076-ADN,0.141643966136,117,143,260
8248,-0.645953270361,0.929241202634,076-ADO,0.141643966136,94,103,197
8249,-0.645953270361,0.929241202634,076-ADP,0.141643966136,205,314,519
8250,-0.645953270361,0.929241202634,076-ADQ,0.141643966136,176,328,504
8251,-0.645953270361,0.929241202634,076-ADR,0.141643966136,116,200,316
8252,-0.645953270361,0.929241202634,076-ADS,0.141643966136,146,200,346
8253,-0.645953270361,0.929241202634,076-ADT,0.141643966136,168,272,440
8254,-0.645953270361,0.929241202634,076-ADU,0.141643966136,102,132,234
8255,-0.645953270361,0.929241202634,076-ADV,0.141643966136,123,167,290
8256,-0.645953270361,0.929241202634,076-ADW,0.141643966136,144,197,341
8257,-0.645953270361,0.929241202634,076-ADX,0.141643966136,177,244,421
8258,-0.645953270361,0.929241202634,076-ADY,0.141643966136,154,185,339
8259,-0.645953270361,0.929241202634,076-ADZ,0.141643966136,137,188,325
8260,-0.645953270361,0.929241202634,076-AEA,0.141643966136,123,130,253
8261,-0.645953270361,0.929241202634,076-AEB,0.141643966136,141,142,283
8262,-0.645953270361,0.929241202634,076-AEC,0.141643966136,128,105,233
8263,-0.645953270361,0.929241202634,076-AED,0.141643966136,175,190,365
8264,-0.645953270361,0.929241202634,076-AEE,0.141643966136,182,147,329
8265,-0.645953270361,0.929241202634,076-AEF,0.141643966136,135,126,261
8266,-0.645953270361,0.929241202634,076-AEG,0.141643966136,191,343,534
8267,-0.645953270361,0.929241202634,076-AEH,0.141643966136,167,71,238
8268,-0.645953270361,0.929241202634,076-AEI,0.141643966136,238,55,293
8269,-0.645953270361,0.929241202634,076-AEJ,0.141643966136,244,54,298
8270,-0.645953270361,0.929241202634,076-AEK,0.141643966136,113,116,229
8271,-0.645953270361,0.929241202634,076-AEL,0.141643966136,118,128,246
8272,-0.645953270361,0.929241202634,076-AEM,0.141643966136,106,114,220
8273,-0.645953270361,0.929241202634,076-AEN,0.141643966136,110,91,201
8274,-0.645953270361,0.929241202634,076-AEO,0.141643966136,183,301,484
8275,-0.645953270361,0.929241202634,076-AEP,0.141643966136,171,217,388
8276,-0.645953270361,0.929241202634,076-AEQ,0.141643966136,237,176,413
8277,-0.645953270361,0.929241202634,076-AER,0.141643966136,198,247,445
8278,-0.645953270361,0.929241202634,076-AET,0.141643966136,118,224,342
8279,-0.645953270361,0.929241202634,076-AEU,0.141643966136,96,211,307
8280,-0.645953270361,0.929241202634,076-AEV,0.141643966136,116,230,346
8281,-0.645953270361,0.929241202634,076-AEW,0.141643966136,126,199,325
8282,-0.645953270361,0.929241202634,076-AEX,0.141643966136,91,187,278
8283,-0.645953270361,0.929241202634,076-AEY,0.141643966136,124,193,317
8284,-0.645953270361,0.929241202634,076-AEZ,0.141643966136,168,385,553
8285,-0.645953270361,0.929241202634,076-AFA,0.141643966136,132,251,383
8286,-0.645953270361,0.929241202634,076-AFB,0.141643966136,149,272,421
8287,-0.645953270361,0.929241202634,076-AFC,0.141643966136,129,190,319
8288,-0.645953270361,0.929241202634,076-AFD,0.141643966136,204,410,614
8289,-0.645953270361,0.929241202634,076-AFE,0.141643966136,137,239,376
8290,-0.645953270361,0.929241202634,076-AFF,0.141643966136,217,498,715
8291,-0.645953270361,0.929241202634,076-AFG,0.141643966136,92,190,282
8292,-0.645953270361,0.929241202634,076-AFH,0.141643966136,113,236,349
8293,-0.645953270361,0.929241202634,076-AFI,0.141643966136,174,341,515
8294,-0.645953270361,0.929241202634,076-AFJ,0.141643966136,85,152,237
8295,-0.645953270361,0.929241202634,076-AFK,0.141643966136,171,296,467
8296,-0.645953270361,0.929241202634,076-AFL,0.141643966136,70,103,173
8297,-0.645953270361,0.929241202634,076-AFM,0.141643966136,151,323,474
8298,-0.645953270361,0.929241202634,076-AFN,0.141643966136,156,311,467
8299,-0.645953270361,0.929241202634,076-AFO,0.141643966136,87,162,249
8300,-0.645953270361,0.929241202634,076-AFQ,0.141643966136,100,144,244
8301,-0.645953270361,0.929241202634,076-AFR,0.141643966136,143,214,357
8302,-0.645953270361,0.929241202634,076-AFS,0.141643966136,153,107,260
8303,-0.645953270361,0.929241202634,076-AFT,0.141643966136,144,185,329
8304,-0.645953270361,0.929241202634,076-AFU,0.141643966136,107,179,286
8305,-0.645953270361,0.929241202634,076-AFV,0.141643966136,192,139,331
8306,-0.645953270361,0.929241202634,076-AFW,0.141643966136,147,164,311
8307,-0.645953270361,0.929241202634,076-AFX,0.141643966136,180,186,366
8308,-0.645953270361,0.929241202634,076-AFY,0.141643966136,165,132,297
8309,-0.645953270361,0.929241202634,076-AFZ,0.141643966136,133,130,263
8310,-0.645953270361,0.929241202634,076-AGA,0.141643966136,204,240,444
8311,-0.645953270361,0.929241202634,076-AGB,0.141643966136,165,89,254
8312,-0.645953270361,0.929241202634,076-AGC,0.141643966136,116,165,281
8313,-0.645953270361,0.929241202634,076-AGD,0.141643966136,117,107,224
8314,-0.645953270361,0.929241202634,076-AGE,0.141643966136,152,201,353
8315,-0.645953270361,0.929241202634,076-AGF,0.141643966136,128,197,325
8316,-0.645953270361,0.929241202634,076-AGG,0.141643966136,90,222,312
8317,-0.645953270361,0.929241202634,076-AGH,0.141643966136,134,220,354
8318,-0.645953270361,0.929241202634,076-AGI,0.141643966136,146,238,384
8319,-0.645953270361,0.929241202634,076-AGJ,0.141643966136,87,129,216
8320,-0.645953270361,0.929241202634,076-AGK,0.141643966136,117,201,318
8321,-0.645953270361,0.929241202634,076-AGL,0.141643966136,85,169,254
8322,-0.645953270361,0.929241202634,076-AGM,0.141643966136,108,144,252
8323,-0.645953270361,0.929241202634,076-AGN,0.141643966136,176,368,544
8324,-0.645953270361,0.929241202634,076-AGO,0.141643966136,70,235,305
8325,-0.645953270361,0.929241202634,076-AGP,0.141643966136,119,273,392
8326,-0.645953270361,0.929241202634,076-AGQ,0.141643966136,90,281,371
8327,-0.645953270361,0.929241202634,076-AGR,0.141643966136,121,339,460
8328,-0.645953270361,0.929241202634,076-AGS,0.141643966136,107,340,447
8329,-0.645953270361,0.929241202634,076-AGT,0.141643966136,89,227,316
8330,-0.645953270361,0.929241202634,076-AGU,0.141643966136,136,264,400
8331,-0.645953270361,0.929241202634,076-AGV,0.141643966136,172,293,465
8332,-0.645953270361,0.929241202634,076-AGW,0.141643966136,183,495,678
8333,-0.645953270361,0.929241202634,076-AGX,0.141643966136,246,458,704
8334,-0.645953270361,0.929241202634,076-AGY,0.141643966136,179,554,733
8335,-0.645953270361,0.929241202634,076-AGZ,0.141643966136,79,220,299
8336,-0.645953270361,0.929241202634,076-AHA,0.141643966136,110,224,334
8337,-0.645953270361,0.929241202634,076-AHB,0.141643966136,70,230,300
8338,-0.645953270361,0.929241202634,076-AHC,0.141643966136,153,219,372
8339,-0.645953270361,0.929241202634,076-AHD,0.141643966136,179,272,451
8340,-0.645953270361,0.929241202634,076-AHE,0.141643966136,128,308,436
8341,-0.645953270361,0.929241202634,076-AHF,0.141643966136,107,230,337
8342,-0.645953270361,0.929241202634,076-AHG,0.141643966136,130,255,385
8343,-0.645953270361,0.929241202634,076-AHH,0.141643966136,166,267,433
8344,-0.645953270361,0.929241202634,076-AHI,0.141643966136,129,232,361
8345,-0.645953270361,0.929241202634,076-AHJ,0.141643966136,102,396,498
8346,-0.645953270361,0.929241202634,076-AHK,0.141643966136,197,489,686
8347,-0.645953270361,0.929241202634,076-AHL,0.141643966136,126,238,364
8348,-0.645953270361,0.929241202634,076-AHM,0.141643966136,159,415,574
8349,-0.645953270361,0.929241202634,076-AHN,0.141643966136,131,222,353
8350,-0.645953270361,0.929241202634,076-AHO,0.141643966136,137,208,345
8351,-0.645953270361,0.929241202634,076-AHP,0.141643966136,107,190,297
8352,-0.645953270361,0.929241202634,076-AHQ,0.141643966136,171,231,402
8353,-0.645953270361,0.929241202634,076-AHR,0.141643966136,33,109,142
8354,-0.645953270361,0.929241202634,076-AHS,0.141643966136,99,291,390
8355,-0.645953270361,0.929241202634,076-AHT,0.141643966136,96,174,270
8356,-0.645953270361,0.929241202634,076-AHU,0.141643966136,103,190,293
8357,-0.645953270361,0.929241202634,076-AHV,0.141643966136,137,201,338
8358,-0.645953270361,0.929241202634,076-AHW,0.141643966136,117,209,326
8359,-0.645953270361,0.929241202634,076-AHX,0.141643966136,108,338,446
8360,-0.645953270361,0.929241202634,076-AHY,0.141643966136,134,323,457
8361,-0.645953270361,0.929241202634,076-AHZ,0.141643966136,43,247,290
8362,-0.645953270361,0.929241202634,076-AIA,0.141643966136,139,321,460
8363,-0.645953270361,0.929241202634,076-AIB,0.141643966136,119,271,390
8364,-0.645953270361,0.929241202634,076-AIC,0.141643966136,173,427,600
8365,-0.645953270361,0.929241202634,076-AID,0.141643966136,99,293,392
8366,-0.645953270361,0.929241202634,076-AIE,0.141643966136,182,450,632
8367,-0.645953270361,0.929241202634,076-AIF,0.141643966136,90,292,382
8368,-0.645953270361,0.929241202634,076-AIG,0.141643966136,182,346,528
8369,-0.645953270361,0.929241202634,076-AIH,0.141643966136,148,360,508
8370,-0.645953270361,0.929241202634,076-AII,0.141643966136,147,409,556
8371,-0.645953270361,0.929241202634,076-AIJ,0.141643966136,81,228,309
8372,-0.645953270361,0.929241202634,076-AIK,0.141643966136,131,322,453
8373,-0.645953270361,0.929241202634,076-AIL,0.141643966136,114,298,412
8374,-0.645953270361,0.929241202634,076-AIM,0.141643966136,75,188,263
8375,-0.645953270361,0.929241202634,076-AIN,0.141643966136,66,238,304
8376,-0.645953270361,0.929241202634,076-AIO,0.141643966136,115,243,358
8377,-0.645953270361,0.929241202634,076-AIP,0.141643966136,98,209,307
8378,-0.645953270361,0.929241202634,076-AIQ,0.141643966136,129,224,353
8379,-0.645953270361,0.929241202634,076-AIR,0.141643966136,91,185,276
8380,-0.645953270361,0.929241202634,076-AIS,0.141643966136,125,286,411
8381,-0.645953270361,0.929241202634,076-AIT,0.141643966136,145,326,471
8382,-0.645953270361,0.929241202634,076-AIU,0.141643966136,148,264,412
8383,-0.645953270361,0.929241202634,076-AIV,0.141643966136,111,215,326
8384,-0.645953270361,0.929241202634,076-AIX,0.141643966136,120,217,337
8385,-0.645953270361,0.929241202634,076-AIY,0.141643966136,149,203,352
8386,-0.645953270361,0.929241202634,076-AIZ,0.141643966136,135,226,361
8387,-0.645953270361,0.929241202634,076-AJA,0.141643966136,210,343,553
8388,-0.645953270361,0.929241202634,076-AJB,0.141643966136,120,227,347
8389,-0.645953270361,0.929241202634,076-AJC,0.141643966136,122,281,403
8390,-0.645953270361,0.929241202634,076-AJD,0.141643966136,125,250,375
8391,-0.645953270361,0.929241202634,076-AJE,0.141643966136,140,171,311
8392,-0.645953270361,0.929241202634,076-AJF,0.141643966136,76,107,183
8393,-0.645953270361,0.929241202634,076-AJJ,0.141643966136,125,306,431
8394,-0.645953270361,0.929241202634,076-AJK,0.141643966136,174,405,579
8395,-0.645953270361,0.929241202634,076-AJL,0.141643966136,132,340,472
8396,-0.645953270361,0.929241202634,076-AJM,0.141643966136,57,228,285
8397,-0.645953270361,0.929241202634,076-AJO,0.141643966136,161,202,363
8398,-0.645953270361,0.929241202634,076-AJP,0.141643966136,96,272,368
8399,-0.645953270361,0.929241202634,076-AJQ,0.141643966136,193,383,576
8400,-0.645953270361,0.929241202634,076-AJR,0.141643966136,125,225,350
8401,-0.645953270361,0.929241202634,076-AJS,0.141643966136,121,299,420
8402,-0.645953270361,0.929241202634,076-AJT,0.141643966136,125,204,329
8403,-0.645953270361,0.929241202634,076-AJU,0.141643966136,185,315,500
8404,-0.645953270361,0.929241202634,076-AJV,0.141643966136,110,209,319
8405,-0.645953270361,0.929241202634,076-AJW,0.141643966136,201,245,446
8406,-0.645953270361,0.929241202634,076-AJX,0.141643966136,110,186,296
8407,-0.645953270361,0.929241202634,076-AJY,0.141643966136,100,179,279
8408,-0.645953270361,0.929241202634,076-AJZ,0.141643966136,137,227,364
8409,-0.645953270361,0.929241202634,076-AKA,0.141643966136,77,116,193
8410,-0.645953270361,0.929241202634,076-AKB,0.141643966136,84,175,259
8411,-0.645953270361,0.929241202634,076-AKD,0.141643966136,88,156,244
8412,-0.645953270361,0.929241202634,076-AKE,0.141643966136,95,115,210
8413,-0.645953270361,0.929241202634,076-AKF,0.141643966136,111,197,308
8414,-0.645953270361,0.929241202634,076-AKG,0.141643966136,145,334,479
8415,-0.645953270361,0.929241202634,076-AKH,0.141643966136,164,318,482
8416,-0.645953270361,0.929241202634,076-AKK,0.141643966136,78,144,222
8417,-0.645953270361,0.929241202634,076-AKL,0.141643966136,117,248,365
8418,-0.645953270361,0.929241202634,076-AKO,0.141643966136,142,142,284
8419,-0.645953270361,0.929241202634,076-AKP,0.141643966136,150,157,307
8420,-0.645953270361,0.929241202634,076-AKQ,0.141643966136,112,171,283
8421,-0.645953270361,0.929241202634,076-AKR,0.141643966136,131,160,291
8422,-0.645953270361,0.929241202634,076-AKS,0.141643966136,124,141,265
8423,-0.645953270361,0.929241202634,076-AKT,0.141643966136,129,215,344
8424,-0.645953270361,0.929241202634,076-AKU,0.141643966136,168,207,375
8425,-0.645953270361,0.929241202634,076-AKV,0.141643966136,140,163,303
8426,-0.645953270361,0.929241202634,076-AKW,0.141643966136,115,185,300
8427,-0.645953270361,0.929241202634,076-AKX,0.141643966136,138,185,323
8428,-0.645953270361,0.929241202634,076-AKY,0.141643966136,144,130,274
8429,-0.645953270361,0.929241202634,076-AKZ,0.141643966136,142,178,320
8430,-0.645953270361,0.929241202634,076-ALA,0.141643966136,122,167,289
8431,-0.645953270361,0.929241202634,076-ALB,0.141643966136,177,229,406
8432,-0.645953270361,0.929241202634,076-ALC,0.141643966136,136,146,282
8433,-0.645953270361,0.929241202634,076-ALD,0.141643966136,131,198,329
8434,-0.645953270361,0.929241202634,076-ALE,0.141643966136,123,101,224
8435,-0.645953270361,0.929241202634,076-ALF,0.141643966136,218,227,445
8436,-0.645953270361,0.929241202634,076-ALG,0.141643966136,103,218,321
8437,-0.645953270361,0.929241202634,076-ALH,0.141643966136,162,227,389
8438,-0.645953270361,0.929241202634,076-ALI,0.141643966136,146,189,335
8439,-0.645953270361,0.929241202634,076-ALJ,0.141643966136,108,117,225
8440,-0.645953270361,0.929241202634,076-ALK,0.141643966136,125,172,297
8441,-0.645953270361,0.929241202634,076-ALL,0.141643966136,102,124,226
8442,-0.645953270361,0.929241202634,076-ALM,0.141643966136,153,159,312
8443,-0.645953270361,0.929241202634,076-ALN,0.141643966136,140,216,356
8444,-0.645953270361,0.929241202634,076-ALO,0.141643966136,122,155,277
8445,-0.645953270361,0.929241202634,076-ALP,0.141643966136,132,181,313
8446,-0.645953270361,0.929241202634,076-ALQ,0.141643966136,104,120,224
8447,-0.645953270361,0.929241202634,076-ALR,0.141643966136,77,124,201
8448,-0.645953270361,0.929241202634,076-ALS,0.141643966136,112,162,274
8449,-0.645953270361,0.929241202634,076-ALT,0.141643966136,93,87,180
8450,-0.645953270361,0.929241202634,076-ALU,0.141643966136,109,170,279
8451,-0.645953270361,0.929241202634,076-ALV,0.141643966136,76,137,213
8452,-0.645953270361,0.929241202634,076-ALW,0.141643966136,69,144,213
8453,-0.645953270361,0.929241202634,076-ALX,0.141643966136,92,121,213
8454,-0.645953270361,0.929241202634,076-ALY,0.141643966136,105,160,265
8455,-0.645953270361,0.929241202634,076-AMA,0.141643966136,118,122,240
8456,-0.645953270361,0.929241202634,076-AMB,0.141643966136,132,157,289
8457,-0.645953270361,0.929241202634,076-AMC,0.141643966136,172,316,488
8458,-0.645953270361,0.929241202634,076-AMD,0.141643966136,181,318,499
8459,-0.645953270361,0.929241202634,076-AME,0.141643966136,203,158,361
8460,-0.645953270361,0.929241202634,076-AMF,0.141643966136,148,288,436
8461,-0.645953270361,0.929241202634,076-AMG,0.141643966136,143,223,366
8462,-0.645953270361,0.929241202634,076-AMH,0.141643966136,111,107,218
8463,-0.645953270361,0.929241202634,076-AMI,0.141643966136,126,377,503
8464,-0.645953270361,0.929241202634,076-AMJ,0.141643966136,200,155,355
8465,-0.645953270361,0.929241202634,076-AMK,0.141643966136,80,100,180
8466,-0.645953270361,0.929241202634,076-AML,0.141643966136,72,91,163
8467,-0.645953270361,0.929241202634,076-AMM,0.141643966136,131,341,472
8468,-0.645953270361,0.929241202634,076-AMN,0.141643966136,126,292,418
8469,-0.645953270361,0.929241202634,076-AMO,0.141643966136,177,226,403
8470,-0.645953270361,0.929241202634,076-AMP,0.141643966136,214,365,579
8471,-0.645953270361,0.929241202634,076-AMQ,0.141643966136,139,189,328
8472,-0.645953270361,0.929241202634,076-AMR,0.141643966136,151,189,340
8473,-0.645953270361,0.929241202634,076-AMS,0.141643966136,93,187,280
8474,-0.645953270361,0.929241202634,076-AMT,0.141643966136,143,278,421
8475,-0.645953270361,0.929241202634,076-AMU,0.141643966136,168,320,488
8476,-0.645953270361,0.929241202634,076-AMV,0.141643966136,199,88,287
8477,-0.645953270361,0.929241202634,076-AMW,0.141643966136,119,122,241
8478,-0.645953270361,0.929241202634,076-AMX,0.141643966136,136,275,411
8479,-0.645953270361,0.929241202634,076-AMY,0.141643966136,217,323,540
8480,-0.645953270361,0.929241202634,076-AMZ,0.141643966136,143,220,363
8481,-0.645953270361,0.929241202634,076-ANA,0.141643966136,217,275,492
8482,-0.645953270361,0.929241202634,076-ANB,0.141643966136,154,307,461
8483,-0.645953270361,0.929241202634,076-ANC,0.141643966136,105,239,344
8484,-0.645953270361,0.929241202634,076-AND,0.141643966136,123,205,328
8485,-0.645953270361,0.929241202634,076-ANF,0.141643966136,115,297,412
8486,-0.645953270361,0.929241202634,076-ANG,0.141643966136,136,158,294
8487,-0.645953270361,0.929241202634,076-ANH,0.141643966136,119,142,261
8488,-0.645953270361,0.929241202634,076-ANI,0.141643966136,151,189,340
8489,-0.645953270361,0.929241202634,076-ANJ,0.141643966136,101,264,365
8490,-0.645953270361,0.929241202634,076-ANK,0.141643966136,235,531,766
8491,-0.645953270361,0.929241202634,076-ANL,0.141643966136,102,173,275
8492,-0.645953270361,0.929241202634,076-ANM,0.141643966136,102,152,254
8493,-0.645953270361,0.929241202634,076-ANN,0.141643966136,88,156,244
8494,-0.645953270361,0.929241202634,076-ANO,0.141643966136,141,127,268
8495,-0.645953270361,0.929241202634,076-ANP,0.141643966136,139,305,444
8496,-0.645953270361,0.929241202634,076-ANQ,0.141643966136,164,321,485
8497,-0.645953270361,0.929241202634,076-ANT,0.141643966136,97,181,278
8498,-0.645953270361,0.929241202634,076-ANU,0.141643966136,109,216,325
8499,-0.645953270361,0.929241202634,076-ANV,0.141643966136,151,223,374
8500,-0.645953270361,0.929241202634,076-ANW,0.141643966136,27,67,94
8501,-0.645953270361,0.929241202634,076-ANX,0.141643966136,114,296,410
8502,-0.645953270361,0.929241202634,076-ANY,0.141643966136,120,213,333
8503,-0.645953270361,0.929241202634,076-ANZ,0.141643966136,64,195,259
8504,-0.645953270361,0.929241202634,076-AOA,0.141643966136,109,202,311
8505,-0.645953270361,0.929241202634,076-AOB,0.141643966136,95,289,384
8506,-0.645953270361,0.929241202634,076-AOC,0.141643966136,118,280,398
8507,-0.645953270361,0.929241202634,076-AOG,0.141643966136,107,217,324
8508,-0.645953270361,0.929241202634,076-AOH,0.141643966136,152,438,590
8509,-0.645953270361,0.929241202634,076-AOI,0.141643966136,145,339,484
8510,-0.645953270361,0.929241202634,076-AOJ,0.141643966136,116,287,403
8511,-0.645953270361,0.929241202634,076-AOO,0.141643966136,170,426,596
8512,-0.645953270361,0.929241202634,076-AOP,0.141643966136,154,263,417
8513,-0.645953270361,0.929241202634,076-AOQ,0.141643966136,240,393,633
8514,-0.645953270361,0.929241202634,076-AOR,0.141643966136,108,302,410
8515,-0.645953270361,0.929241202634,076-AOS,0.141643966136,152,426,578
8516,-0.645953270361,0.929241202634,076-AOT,0.141643966136,164,222,386
8517,-0.645953270361,0.929241202634,076-AOU,0.141643966136,89,300,389
8518,-0.645953270361,0.929241202634,076-AOV,0.141643966136,114,373,487
8519,-0.645953270361,0.929241202634,076-AOW,0.141643966136,128,243,371
8520,-0.645953270361,0.929241202634,077-AAA,0.141643966136,178,74,252
8521,-0.645953270361,0.929241202634,077-AAC,0.141643966136,187,76,263
8522,-0.645953270361,0.929241202634,077-AAE,0.141643966136,206,99,305
8523,-0.645953270361,0.929241202634,077-AAF,0.141643966136,256,84,340
8524,-0.645953270361,0.929241202634,077-AAG,0.141643966136,206,211,417
8525,-0.645953270361,0.929241202634,077-AAH,0.141643966136,232,290,522
8526,-0.645953270361,0.929241202634,077-AAI,0.141643966136,158,114,272
8527,-0.645953270361,0.929241202634,077-AAJ,0.141643966136,262,162,424
8528,-0.645953270361,0.929241202634,077-AAK,0.141643966136,134,96,230
8529,-0.645953270361,0.929241202634,077-AAL,0.141643966136,212,202,414
8530,-0.645953270361,0.929241202634,077-AAM,0.141643966136,277,141,418
8531,-0.645953270361,0.929241202634,077-AAN,0.141643966136,206,102,308
8532,-0.645953270361,0.929241202634,077-AAO,0.141643966136,136,77,213
8533,-0.645953270361,0.929241202634,077-AAP,0.141643966136,249,121,370
8534,-0.645953270361,0.929241202634,077-AAQ,0.141643966136,298,277,575
8535,-0.645953270361,0.929241202634,077-AAR,0.141643966136,154,124,278
8536,-0.645953270361,0.929241202634,077-AAS,0.141643966136,163,90,253
8537,-0.645953270361,0.929241202634,077-ABC,0.141643966136,197,98,295
8538,-0.645953270361,0.929241202634,077-ABD,0.141643966136,145,103,248
8539,-0.645953270361,0.929241202634,077-ABE,0.141643966136,42,24,66
8540,-0.645953270361,0.929241202634,077-ABF,0.141643966136,58,29,87
8541,-0.645953270361,0.929241202634,077-ABG,0.141643966136,247,87,334
8542,-0.645953270361,0.929241202634,077-ABH,0.141643966136,95,63,158
8543,-0.645953270361,0.929241202634,077-ABI,0.141643966136,271,116,387
8544,-0.645953270361,0.929241202634,077-ABJ,0.141643966136,107,49,156
8545,-0.645953270361,0.929241202634,077-ABK,0.141643966136,221,141,362
8546,-0.645953270361,0.929241202634,077-ABL,0.141643966136,154,108,262
8547,-0.645953270361,0.929241202634,077-ABM,0.141643966136,131,63,194
8548,-0.645953270361,0.929241202634,077-ABN,0.141643966136,166,106,272
8549,-0.645953270361,0.929241202634,077-ABU,0.141643966136,382,13,395
8550,-0.645953270361,0.929241202634,077-ABV,0.141643966136,237,40,277
8551,-0.645953270361,0.929241202634,077-ABW,0.141643966136,254,12,266
8552,-0.645953270361,0.929241202634,077-ABX,0.141643966136,233,26,259
8553,-0.645953270361,0.929241202634,077-ABY,0.141643966136,279,45,324
8554,-0.645953270361,0.929241202634,077-ABZ,0.141643966136,330,31,361
8555,-0.645953270361,0.929241202634,077-ACA,0.141643966136,202,55,257
8556,-0.645953270361,0.929241202634,077-ACB,0.141643966136,268,22,290
8557,-0.645953270361,0.929241202634,077-ACC,0.141643966136,400,10,410
8558,-0.645953270361,0.929241202634,077-ACD,0.141643966136,311,8,319
8559,-0.645953270361,0.929241202634,077-ACE,0.141643966136,239,12,251
8560,-0.645953270361,0.929241202634,077-ACF,0.141643966136,361,12,373
8561,-0.645953270361,0.929241202634,077-ACG,0.141643966136,257,37,294
8562,-0.645953270361,0.929241202634,077-ACH,0.141643966136,293,24,317
8563,-0.645953270361,0.929241202634,077-ACN,0.141643966136,243,135,378
8564,-0.645953270361,0.929241202634,077-ACO,0.141643966136,310,10,320
8565,-0.645953270361,0.929241202634,077-ACP,0.141643966136,302,98,400
8566,-0.645953270361,0.929241202634,077-ACQ,0.141643966136,343,21,364
8567,-0.645953270361,0.929241202634,077-ACR,0.141643966136,374,44,418
8568,-0.645953270361,0.929241202634,077-ACS,0.141643966136,382,11,393
8569,-0.645953270361,0.929241202634,077-ACT,0.141643966136,311,12,323
8570,-0.645953270361,0.929241202634,077-ACU,0.141643966136,363,38,401
8571,-0.645953270361,0.929241202634,077-ACV,0.141643966136,378,38,416
8572,-0.645953270361,0.929241202634,077-ACW,0.141643966136,336,75,411
8573,-0.645953270361,0.929241202634,077-ACX,0.141643966136,232,50,282
8574,-0.645953270361,0.929241202634,077-ACY,0.141643966136,323,86,409
8575,-0.645953270361,0.929241202634,077-ACZ,0.141643966136,408,15,423
8576,-0.645953270361,0.929241202634,077-ADA,0.141643966136,217,141,358
8577,-0.645953270361,0.929241202634,077-ADB,0.141643966136,372,13,385
8578,-0.645953270361,0.929241202634,077-ADC,0.141643966136,365,6,371
8579,-0.645953270361,0.929241202634,077-ADD,0.141643966136,401,10,411
8580,-0.645953270361,0.929241202634,077-ADE,0.141643966136,192,67,259
8581,-0.645953270361,0.929241202634,077-ADN,0.141643966136,149,48,197
8582,-0.645953270361,0.929241202634,077-ADO,0.141643966136,367,39,406
8583,-0.645953270361,0.929241202634,077-ADP,0.141643966136,178,29,207
8584,-0.645953270361,0.929241202634,077-ADQ,0.141643966136,256,22,278
8585,-0.645953270361,0.929241202634,077-ADR,0.141643966136,220,21,241
8586,-0.645953270361,0.929241202634,077-ADS,0.141643966136,284,45,329
8587,-0.645953270361,0.929241202634,077-ADT,0.141643966136,180,40,220
8588,-0.645953270361,0.929241202634,077-ADU,0.141643966136,98,23,121
8589,-0.645953270361,0.929241202634,077-ADV,0.141643966136,277,17,294
8590,-0.645953270361,0.929241202634,077-ADW,0.141643966136,302,27,329
8591,-0.645953270361,0.929241202634,077-ADX,0.141643966136,194,30,224
8592,-0.645953270361,0.929241202634,077-ADY,0.141643966136,305,8,313
8593,-0.645953270361,0.929241202634,077-AEF,0.141643966136,147,159,306
8594,-0.645953270361,0.929241202634,077-AEG,0.141643966136,144,151,295
8595,-0.645953270361,0.929241202634,077-AEH,0.141643966136,135,146,281
8596,-0.645953270361,0.929241202634,077-AEI,0.141643966136,174,150,324
8597,-0.645953270361,0.929241202634,077-AEJ,0.141643966136,147,168,315
8598,-0.645953270361,0.929241202634,077-AEK,0.141643966136,165,192,357
8599,-0.645953270361,0.929241202634,077-AEL,0.141643966136,132,135,267
8600,-0.645953270361,0.929241202634,077-AEM,0.141643966136,162,169,331
8601,-0.645953270361,0.929241202634,077-AEN,0.141643966136,153,214,367
8602,-0.645953270361,0.929241202634,077-AEO,0.141643966136,181,187,368
8603,-0.645953270361,0.929241202634,077-AEP,0.141643966136,148,171,319
8604,-0.645953270361,0.929241202634,077-AEQ,0.141643966136,153,165,318
8605,-0.645953270361,0.929241202634,077-AER,0.141643966136,144,159,303
8606,-0.645953270361,0.929241202634,077-AES,0.141643966136,140,190,330
8607,-0.645953270361,0.929241202634,077-AET,0.141643966136,141,167,308
8608,-0.645953270361,0.929241202634,077-AEU,0.141643966136,157,208,365
8609,-0.645953270361,0.929241202634,077-AEV,0.141643966136,188,181,369
8610,-0.645953270361,0.929241202634,077-AFE,0.141643966136,158,81,239
8611,-0.645953270361,0.929241202634,077-AFF,0.141643966136,189,118,307
8612,-0.645953270361,0.929241202634,077-AFG,0.141643966136,202,168,370
8613,-0.645953270361,0.929241202634,077-AFH,0.141643966136,187,125,312
8614,-0.645953270361,0.929241202634,077-AFI,0.141643966136,189,178,367
8615,-0.645953270361,0.929241202634,077-AFJ,0.141643966136,172,111,283
8616,-0.645953270361,0.929241202634,077-AFK,0.141643966136,167,143,310
8617,-0.645953270361,0.929241202634,077-AFL,0.141643966136,205,77,282
8618,-0.645953270361,0.929241202634,077-AFM,0.141643966136,248,53,301
8619,-0.645953270361,0.929241202634,077-AFN,0.141643966136,202,93,295
8620,-0.645953270361,0.929241202634,077-AFO,0.141643966136,148,158,306
8621,-0.645953270361,0.929241202634,077-AFP,0.141643966136,193,119,312
8622,-0.645953270361,0.929241202634,077-AFQ,0.141643966136,176,98,274
8623,-0.645953270361,0.929241202634,077-AFR,0.141643966136,206,213,419
8624,-0.645953270361,0.929241202634,077-AFS,0.141643966136,174,176,350
8625,-0.645953270361,0.929241202634,077-AFT,0.141643966136,224,89,313
8626,-0.645953270361,0.929241202634,077-AGD,0.141643966136,237,143,380
8627,-0.645953270361,0.929241202634,077-AGF,0.141643966136,217,258,475
8628,-0.645953270361,0.929241202634,077-AGH,0.141643966136,195,228,423
8629,-0.645953270361,0.929241202634,077-AGJ,0.141643966136,257,150,407
8630,-0.645953270361,0.929241202634,077-AGL,0.141643966136,199,236,435
8631,-0.645953270361,0.929241202634,077-AGN,0.141643966136,188,219,407
8632,-0.645953270361,0.929241202634,077-AGP,0.141643966136,291,162,453
8633,-0.645953270361,0.929241202634,077-AGQ,0.141643966136,225,129,354
8634,-0.645953270361,0.929241202634,077-AGR,0.141643966136,248,185,433
8635,-0.645953270361,0.929241202634,077-AGS,0.141643966136,256,325,581
8636,-0.645953270361,0.929241202634,077-AGT,0.141643966136,335,153,488
8637,-0.645953270361,0.929241202634,077-AGU,0.141643966136,200,249,449
8638,-0.645953270361,0.929241202634,077-AGV,0.141643966136,214,116,330
8639,-0.645953270361,0.929241202634,077-AGW,0.141643966136,246,277,523
8640,-0.645953270361,0.929241202634,077-AGX,0.141643966136,203,323,526
8641,-0.645953270361,0.929241202634,077-AGY,0.141643966136,223,142,365
8642,-0.645953270361,0.929241202634,077-AGZ,0.141643966136,218,172,390
8643,-0.645953270361,0.929241202634,077-AHA,0.141643966136,234,250,484
8644,-0.645953270361,0.929241202634,077-AHB,0.141643966136,230,222,452
8645,-0.645953270361,0.929241202634,077-AHC,0.141643966136,193,294,487
8646,-0.645953270361,0.929241202634,077-AHD,0.141643966136,279,103,382
8647,-0.645953270361,0.929241202634,077-AHJ,0.141643966136,184,154,338
8648,-0.645953270361,0.929241202634,077-AHK,0.141643966136,248,96,344
8649,-0.645953270361,0.929241202634,077-AHL,0.141643966136,182,102,284
8650,-0.645953270361,0.929241202634,077-AHM,0.141643966136,153,109,262
8651,-0.645953270361,0.929241202634,077-AHN,0.141643966136,154,137,291
8652,-0.645953270361,0.929241202634,077-AHO,0.141643966136,184,147,331
8653,-0.645953270361,0.929241202634,077-AHP,0.141643966136,142,105,247
8654,-0.645953270361,0.929241202634,077-AHQ,0.141643966136,161,170,331
8655,-0.645953270361,0.929241202634,077-AHR,0.141643966136,145,144,289
8656,-0.645953270361,0.929241202634,077-AHS,0.141643966136,127,108,235
8657,-0.645953270361,0.929241202634,077-AHT,0.141643966136,125,131,256
8658,-0.645953270361,0.929241202634,077-AHU,0.141643966136,163,161,324
8659,-0.645953270361,0.929241202634,077-AHV,0.141643966136,222,106,328
8660,-0.645953270361,0.929241202634,077-AIF,0.141643966136,135,124,259
8661,-0.645953270361,0.929241202634,077-AIG,0.141643966136,155,136,291
8662,-0.645953270361,0.929241202634,077-AIH,0.141643966136,198,51,249
8663,-0.645953270361,0.929241202634,077-AII,0.141643966136,123,75,198
8664,-0.645953270361,0.929241202634,077-AIJ,0.141643966136,155,63,218
8665,-0.645953270361,0.929241202634,077-AIK,0.141643966136,144,57,201
8666,-0.645953270361,0.929241202634,077-AIL,0.141643966136,171,99,270
8667,-0.645953270361,0.929241202634,077-AIM,0.141643966136,154,121,275
8668,-0.645953270361,0.929241202634,077-AIN,0.141643966136,208,80,288
8669,-0.645953270361,0.929241202634,077-AIO,0.141643966136,154,117,271
8670,-0.645953270361,0.929241202634,077-AIP,0.141643966136,246,88,334
8671,-0.645953270361,0.929241202634,077-AIQ,0.141643966136,148,128,276
8672,-0.645953270361,0.929241202634,077-AIR,0.141643966136,216,84,300
8673,-0.645953270361,0.929241202634,077-AJA,0.141643966136,117,92,209
8674,-0.645953270361,0.929241202634,077-AJB,0.141643966136,121,107,228
8675,-0.645953270361,0.929241202634,077-AJC,0.141643966136,113,107,220
8676,-0.645953270361,0.929241202634,077-AJD,0.141643966136,105,120,225
8677,-0.645953270361,0.929241202634,077-AJF,0.141643966136,144,170,314
8678,-0.645953270361,0.929241202634,077-AJG,0.141643966136,167,143,310
8679,-0.645953270361,0.929241202634,077-AJH,0.141643966136,159,181,340
8680,-0.645953270361,0.929241202634,077-AJI,0.141643966136,133,154,287
8681,-0.645953270361,0.929241202634,077-AJL,0.141643966136,176,104,280
8682,-0.645953270361,0.929241202634,077-AJM,0.141643966136,178,180,358
8683,-0.645953270361,0.929241202634,077-AJN,0.141643966136,228,68,296
8684,-0.645953270361,0.929241202634,077-AJO,0.141643966136,263,322,585
8685,-0.645953270361,0.929241202634,077-AJR,0.141643966136,112,88,200
8686,-0.645953270361,0.929241202634,077-AJS,0.141643966136,132,118,250
8687,-0.645953270361,0.929241202634,077-AJT,0.141643966136,117,114,231
8688,-0.645953270361,0.929241202634,077-AJV,0.141643966136,114,103,217
8689,-0.645953270361,0.929241202634,077-AJW,0.141643966136,118,103,221
8690,-0.645953270361,0.929241202634,077-AJX,0.141643966136,106,103,209
8691,-0.645953270361,0.929241202634,077-AJY,0.141643966136,136,103,239
8692,-0.645953270361,0.929241202634,077-AKA,0.141643966136,163,185,348
8693,-0.645953270361,0.929241202634,077-AKB,0.141643966136,160,138,298
8694,-0.645953270361,0.929241202634,077-AKC,0.141643966136,127,90,217
8695,-0.645953270361,0.929241202634,077-AKD,0.141643966136,107,93,200
8696,-0.645953270361,0.929241202634,077-AKF,0.141643966136,143,181,324
8697,-0.645953270361,0.929241202634,077-AKG,0.141643966136,144,118,262
8698,-0.645953270361,0.929241202634,077-AKH,0.141643966136,125,136,261
8699,-0.645953270361,0.929241202634,077-AKI,0.141643966136,128,122,250
8700,-0.645953270361,0.929241202634,077-AKJ,0.141643966136,158,116,274
8701,-0.645953270361,0.929241202634,077-AKN,0.141643966136,157,116,273
8702,-0.645953270361,0.929241202634,077-AKO,0.141643966136,120,122,242
8703,-0.645953270361,0.929241202634,077-AKP,0.141643966136,132,188,320
8704,-0.645953270361,0.929241202634,077-AKQ,0.141643966136,144,124,268
8705,-0.645953270361,0.929241202634,077-AKR,0.141643966136,135,177,312
8706,-0.645953270361,0.929241202634,077-AKS,0.141643966136,148,160,308
8707,-0.645953270361,0.929241202634,077-AKV,0.141643966136,118,199,317
8708,-0.645953270361,0.929241202634,077-AKW,0.141643966136,147,196,343
8709,-0.645953270361,0.929241202634,077-AKX,0.141643966136,114,164,278
8710,-0.645953270361,0.929241202634,077-AKY,0.141643966136,136,182,318
8711,-0.645953270361,0.929241202634,077-AKZ,0.141643966136,135,151,286
8712,-0.645953270361,0.929241202634,077-ALA,0.141643966136,174,187,361
8713,-0.645953270361,0.929241202634,077-ALB,0.141643966136,133,188,321
8714,-0.645953270361,0.929241202634,077-ALE,0.141643966136,109,134,243
8715,-0.645953270361,0.929241202634,077-ALF,0.141643966136,137,159,296
8716,-0.645953270361,0.929241202634,077-ALG,0.141643966136,162,174,336
8717,-0.645953270361,0.929241202634,077-ALH,0.141643966136,166,153,319
8718,-0.645953270361,0.929241202634,077-ALI,0.141643966136,142,178,320
8719,-0.645953270361,0.929241202634,077-ALJ,0.141643966136,134,99,233
8720,-0.645953270361,0.929241202634,077-ALM,0.141643966136,162,163,325
8721,-0.645953270361,0.929241202634,077-ALN,0.141643966136,150,133,283
8722,-0.645953270361,0.929241202634,077-ALO,0.141643966136,254,321,575
8723,-0.645953270361,0.929241202634,077-ALP,0.141643966136,193,226,419
8724,-0.645953270361,0.929241202634,077-ALQ,0.141643966136,157,129,286
8725,-0.645953270361,0.929241202634,077-ALR,0.141643966136,124,200,324
8726,-0.645953270361,0.929241202634,077-ALU,0.141643966136,164,145,309
8727,-0.645953270361,0.929241202634,077-ALV,0.141643966136,132,192,324
8728,-0.645953270361,0.929241202634,077-ALW,0.141643966136,128,167,295
8729,-0.645953270361,0.929241202634,077-ALX,0.141643966136,161,152,313
8730,-0.645953270361,0.929241202634,077-ALY,0.141643966136,122,138,260
8731,-0.645953270361,0.929241202634,077-ALZ,0.141643966136,151,159,310
8732,-0.645953270361,0.929241202634,077-AMC,0.141643966136,133,133,266
8733,-0.645953270361,0.929241202634,077-AMD,0.141643966136,110,139,249
8734,-0.645953270361,0.929241202634,077-AME,0.141643966136,96,99,195
8735,-0.645953270361,0.929241202634,077-AMF,0.141643966136,129,169,298
8736,-0.645953270361,0.929241202634,077-AMG,0.141643966136,132,211,343
8737,-0.645953270361,0.929241202634,077-AMH,0.141643966136,132,130,262
8738,-0.645953270361,0.929241202634,077-AMJ,0.141643966136,207,187,394
8739,-0.645953270361,0.929241202634,077-AMK,0.141643966136,136,206,342
8740,-0.645953270361,0.929241202634,077-AML,0.141643966136,156,286,442
8741,-0.645953270361,0.929241202634,077-AMM,0.141643966136,154,309,463
8742,-0.645953270361,0.929241202634,077-AMN,0.141643966136,168,251,419
8743,-0.645953270361,0.929241202634,077-AMO,0.141643966136,197,395,592
8744,-0.645953270361,0.929241202634,077-AMS,0.141643966136,193,372,565
8745,-0.645953270361,0.929241202634,077-AMU,0.141643966136,275,360,635
8746,-0.645953270361,0.929241202634,077-AMW,0.141643966136,211,245,456
8747,-0.645953270361,0.929241202634,077-AMY,0.141643966136,239,163,402
8748,-0.645953270361,0.929241202634,077-ANA,0.141643966136,210,260,470
8749,-0.645953270361,0.929241202634,077-ANC,0.141643966136,249,238,487
8750,-0.645953270361,0.929241202634,077-ANE,0.141643966136,346,403,749
8751,-0.645953270361,0.929241202634,077-ANF,0.141643966136,241,250,491
8752,-0.645953270361,0.929241202634,077-ANG,0.141643966136,161,187,348
8753,-0.645953270361,0.929241202634,077-ANH,0.141643966136,237,284,521
8754,-0.645953270361,0.929241202634,077-ANI,0.141643966136,193,249,442
8755,-0.645953270361,0.929241202634,077-ANJ,0.141643966136,222,304,526
8756,-0.645953270361,0.929241202634,077-ANK,0.141643966136,131,221,352
8757,-0.645953270361,0.929241202634,077-ANL,0.141643966136,120,237,357
8758,-0.645953270361,0.929241202634,077-ANM,0.141643966136,168,231,399
8759,-0.645953270361,0.929241202634,077-ANN,0.141643966136,145,237,382
8760,-0.645953270361,0.929241202634,077-ANO,0.141643966136,112,229,341
8761,-0.645953270361,0.929241202634,077-ANP,0.141643966136,144,212,356
8762,-0.645953270361,0.929241202634,077-ANQ,0.141643966136,117,205,322
8763,-0.645953270361,0.929241202634,077-ANS,0.141643966136,154,168,322
8764,-0.645953270361,0.929241202634,077-ANT,0.141643966136,154,242,396
8765,-0.645953270361,0.929241202634,077-ANU,0.141643966136,167,282,449
8766,-0.645953270361,0.929241202634,077-ANW,0.141643966136,146,234,380
8767,-0.645953270361,0.929241202634,077-ANX,0.141643966136,116,201,317
8768,-0.645953270361,0.929241202634,077-ANY,0.141643966136,125,191,316
8769,-0.645953270361,0.929241202634,077-AOA,0.141643966136,126,193,319
8770,-0.645953270361,0.929241202634,077-AOB,0.141643966136,131,179,310
8771,-0.645953270361,0.929241202634,077-AOC,0.141643966136,124,153,277
8772,-0.645953270361,0.929241202634,077-AOD,0.141643966136,146,225,371
8773,-0.645953270361,0.929241202634,077-AOE,0.141643966136,145,174,319
8774,-0.645953270361,0.929241202634,077-AOF,0.141643966136,152,255,407
8775,-0.645953270361,0.929241202634,077-AOG,0.141643966136,246,307,553
8776,-0.645953270361,0.929241202634,077-AOH,0.141643966136,149,212,361
8777,-0.645953270361,0.929241202634,077-AOI,0.141643966136,228,401,629
8778,-0.645953270361,0.929241202634,077-AOJ,0.141643966136,178,282,460
8779,-0.645953270361,0.929241202634,077-AOM,0.141643966136,165,303,468
8780,-0.645953270361,0.929241202634,077-AON,0.141643966136,137,254,391
8781,-0.645953270361,0.929241202634,077-AOO,0.141643966136,151,249,400
8782,-0.645953270361,0.929241202634,077-AOP,0.141643966136,194,352,546
8783,-0.645953270361,0.929241202634,077-AOQ,0.141643966136,143,346,489
8784,-0.645953270361,0.929241202634,077-AOR,0.141643966136,170,263,433
8785,-0.645953270361,0.929241202634,077-AOS,0.141643966136,145,232,377
8786,-0.645953270361,0.929241202634,077-AOT,0.141643966136,134,198,332
8787,-0.645953270361,0.929241202634,077-AOX,0.141643966136,113,219,332
8788,-0.645953270361,0.929241202634,077-AOY,0.141643966136,182,267,449
8789,-0.645953270361,0.929241202634,077-AOZ,0.141643966136,138,228,366
8790,-0.645953270361,0.929241202634,077-APA,0.141643966136,127,142,269
8791,-0.645953270361,0.929241202634,077-APB,0.141643966136,153,156,309
8792,-0.645953270361,0.929241202634,077-APC,0.141643966136,118,117,235
8793,-0.645953270361,0.929241202634,077-APD,0.141643966136,140,170,310
8794,-0.645953270361,0.929241202634,077-APG,0.141643966136,151,238,389
8795,-0.645953270361,0.929241202634,077-APH,0.141643966136,165,267,432
8796,-0.645953270361,0.929241202634,077-API,0.141643966136,119,286,405
8797,-0.645953270361,0.929241202634,077-APJ,0.141643966136,127,180,307
8798,-0.645953270361,0.929241202634,077-APK,0.141643966136,161,233,394
8799,-0.645953270361,0.929241202634,077-APL,0.141643966136,194,263,457
8800,-0.645953270361,0.929241202634,077-APM,0.141643966136,157,152,309
8801,-0.645953270361,0.929241202634,077-APN,0.141643966136,169,255,424
8802,-0.645953270361,0.929241202634,077-APQ,0.141643966136,328,388,716
8803,-0.645953270361,0.929241202634,077-APR,0.141643966136,134,172,306
8804,-0.645953270361,0.929241202634,077-APS,0.141643966136,140,137,277
8805,-0.645953270361,0.929241202634,077-APT,0.141643966136,182,190,372
8806,-0.645953270361,0.929241202634,077-APV,0.141643966136,121,183,304
8807,-0.645953270361,0.929241202634,077-APW,0.141643966136,146,223,369
8808,-0.645953270361,0.929241202634,077-APX,0.141643966136,150,271,421
8809,-0.645953270361,0.929241202634,077-APY,0.141643966136,155,268,423
8810,-0.645953270361,0.929241202634,077-APZ,0.141643966136,139,199,338
8811,-0.645953270361,0.929241202634,077-AQB,0.141643966136,120,183,303
8812,-0.645953270361,0.929241202634,077-AQC,0.141643966136,134,187,321
8813,-0.645953270361,0.929241202634,077-AQD,0.141643966136,158,196,354
8814,-0.645953270361,0.929241202634,077-AQE,0.141643966136,121,189,310
8815,-0.645953270361,0.929241202634,077-AQF,0.141643966136,141,250,391
8816,-0.645953270361,0.929241202634,077-AQG,0.141643966136,151,216,367
8817,-0.645953270361,0.929241202634,077-AQH,0.141643966136,133,164,297
8818,-0.645953270361,0.929241202634,077-AQI,0.141643966136,149,208,357
8819,-0.645953270361,0.929241202634,077-AQJ,0.141643966136,178,256,434
8820,-0.645953270361,0.929241202634,077-AQL,0.141643966136,212,210,422
8821,-0.645953270361,0.929241202634,077-AQM,0.141643966136,172,225,397
8822,-0.645953270361,0.929241202634,077-AQN,0.141643966136,159,191,350
8823,-0.645953270361,0.929241202634,077-AQO,0.141643966136,196,231,427
8824,-0.645953270361,0.929241202634,077-AQP,0.141643966136,170,204,374
8825,-0.645953270361,0.929241202634,077-AQQ,0.141643966136,258,259,517
8826,-0.645953270361,0.929241202634,077-AQR,0.141643966136,122,193,315
8827,-0.645953270361,0.929241202634,077-AQS,0.141643966136,195,244,439
8828,-0.645953270361,0.929241202634,077-AQT,0.141643966136,219,225,444
8829,-0.645953270361,0.929241202634,077-AQU,0.141643966136,207,291,498
8830,-0.645953270361,0.929241202634,077-AQV,0.141643966136,191,285,476
8831,-0.645953270361,0.929241202634,077-AQW,0.141643966136,210,204,414
8832,-0.645953270361,0.929241202634,077-AQX,0.141643966136,205,258,463
8833,-0.645953270361,0.929241202634,077-AQY,0.141643966136,261,204,465
8834,-0.645953270361,0.929241202634,077-AQZ,0.141643966136,140,178,318
8835,-0.645953270361,0.929241202634,077-ARA,0.141643966136,176,298,474
8836,-0.645953270361,0.929241202634,077-ARB,0.141643966136,168,345,513
8837,-0.645953270361,0.929241202634,077-ARC,0.141643966136,141,308,449
8838,-0.645953270361,0.929241202634,077-ARD,0.141643966136,105,337,442
8839,-0.645953270361,0.929241202634,077-ARE,0.141643966136,189,462,651
8840,-0.645953270361,0.929241202634,077-ARF,0.141643966136,147,290,437
8841,-0.645953270361,0.929241202634,077-ARG,0.141643966136,140,247,387
8842,-0.645953270361,0.929241202634,077-ARH,0.141643966136,146,185,331
8843,-0.645953270361,0.929241202634,077-ARI,0.141643966136,142,325,467
8844,-0.645953270361,0.929241202634,077-ARJ,0.141643966136,132,308,440
8845,-0.645953270361,0.929241202634,077-ARK,0.141643966136,186,216,402
8846,-0.645953270361,0.929241202634,077-ARO,0.141643966136,119,146,265
8847,-0.645953270361,0.929241202634,077-ARP,0.141643966136,143,154,297
8848,-0.645953270361,0.929241202634,077-ARR,0.141643966136,183,384,567
8849,-0.645953270361,0.929241202634,077-ARS,0.141643966136,108,302,410
8850,-0.645953270361,0.929241202634,077-ARU,0.141643966136,147,240,387
8851,-0.645953270361,0.929241202634,077-ARV,0.141643966136,145,189,334
8852,-0.645953270361,0.929241202634,077-ARW,0.141643966136,212,300,512
8853,-0.645953270361,0.929241202634,077-ARX,0.141643966136,162,110,272
8854,-0.645953270361,0.929241202634,077-ARY,0.141643966136,153,95,248
8855,-0.645953270361,0.929241202634,077-ARZ,0.141643966136,243,391,634
8856,-0.645953270361,0.929241202634,077-ASA,0.141643966136,170,133,303
8857,-0.645953270361,0.929241202634,077-ASB,0.141643966136,179,150,329
8858,-0.645953270361,0.929241202634,077-ASC,0.141643966136,138,181,319
8859,-0.645953270361,0.929241202634,077-ASD,0.141643966136,117,220,337
8860,-0.645953270361,0.929241202634,077-ASE,0.141643966136,155,254,409
8861,-0.645953270361,0.929241202634,077-ASF,0.141643966136,218,314,532
8862,-0.645953270361,0.929241202634,077-ASG,0.141643966136,227,351,578
8863,-0.645953270361,0.929241202634,077-ASH,0.141643966136,127,169,296
8864,-0.645953270361,0.929241202634,077-ASI,0.141643966136,167,218,385
8865,-0.645953270361,0.929241202634,077-ASJ,0.141643966136,135,195,330
8866,-0.645953270361,0.929241202634,077-ASK,0.141643966136,170,201,371
8867,-0.645953270361,0.929241202634,077-ASL,0.141643966136,113,128,241
8868,-0.645953270361,0.929241202634,077-ASM,0.141643966136,127,136,263
8869,-0.645953270361,0.929241202634,077-ASN,0.141643966136,125,137,262
8870,-0.645953270361,0.929241202634,077-ASO,0.141643966136,153,184,337
8871,-0.645953270361,0.929241202634,077-ASP,0.141643966136,150,207,357
8872,-0.645953270361,0.929241202634,077-ASQ,0.141643966136,104,191,295
8873,-0.645953270361,0.929241202634,077-ASR,0.141643966136,164,134,298
8874,-0.645953270361,0.929241202634,077-ASV,0.141643966136,171,204,375
8875,-0.645953270361,0.929241202634,077-ASW,0.141643966136,166,207,373
8876,-0.645953270361,0.929241202634,077-ASX,0.141643966136,195,249,444
8877,-0.645953270361,0.929241202634,077-ASY,0.141643966136,150,205,355
8878,-0.645953270361,0.929241202634,077-ASZ,0.141643966136,139,179,318
8879,-0.645953270361,0.929241202634,077-ATA,0.141643966136,133,172,305
8880,-0.645953270361,0.929241202634,077-ATB,0.141643966136,127,199,326
8881,-0.645953270361,0.929241202634,077-ATC,0.141643966136,139,253,392
8882,-0.645953270361,0.929241202634,077-ATD,0.141643966136,137,217,354
8883,-0.645953270361,0.929241202634,077-ATE,0.141643966136,103,216,319
8884,-0.645953270361,0.929241202634,077-ATF,0.141643966136,109,195,304
8885,-0.645953270361,0.929241202634,077-ATG,0.141643966136,154,235,389
8886,-0.645953270361,0.929241202634,077-ATK,0.141643966136,108,135,243
8887,-0.645953270361,0.929241202634,077-ATL,0.141643966136,210,273,483
8888,-0.645953270361,0.929241202634,077-ATN,0.141643966136,127,184,311
8889,-0.645953270361,0.929241202634,077-ATO,0.141643966136,130,170,300
8890,-0.645953270361,0.929241202634,077-ATP,0.141643966136,135,183,318
8891,-0.645953270361,0.929241202634,077-ATR,0.141643966136,103,182,285
8892,-0.645953270361,0.929241202634,077-ATS,0.141643966136,149,198,347
8893,-0.645953270361,0.929241202634,077-ATT,0.141643966136,153,146,299
8894,-0.645953270361,0.929241202634,077-ATU,0.141643966136,133,164,297
8895,-0.645953270361,0.929241202634,077-ATV,0.141643966136,166,199,365
8896,-0.645953270361,0.929241202634,077-ATW,0.141643966136,154,253,407
8897,-0.645953270361,0.929241202634,077-ATY,0.141643966136,116,142,258
8898,-0.645953270361,0.929241202634,077-ATZ,0.141643966136,107,151,258
8899,-0.645953270361,0.929241202634,077-AUA,0.141643966136,98,110,208
8900,-0.645953270361,0.929241202634,077-AUB,0.141643966136,131,135,266
8901,-0.645953270361,0.929241202634,077-AUC,0.141643966136,169,237,406
8902,-0.645953270361,0.929241202634,077-AUD,0.141643966136,149,202,351
8903,-0.645953270361,0.929241202634,077-AUE,0.141643966136,364,434,798
8904,-0.645953270361,0.929241202634,077-AUF,0.141643966136,173,241,414
8905,-0.645953270361,0.929241202634,077-AUG,0.141643966136,154,202,356
8906,-0.645953270361,0.929241202634,077-AUI,0.141643966136,290,328,618
8907,-0.645953270361,0.929241202634,077-AUJ,0.141643966136,155,277,432
8908,-0.645953270361,0.929241202634,077-AUL,0.141643966136,223,506,729
8909,-0.645953270361,0.929241202634,077-AUM,0.141643966136,176,322,498
8910,-0.645953270361,0.929241202634,077-AUN,0.141643966136,160,416,576
8911,-0.645953270361,0.929241202634,077-AUO,0.141643966136,129,245,374
8912,-0.645953270361,0.929241202634,077-AUP,0.141643966136,132,187,319
8913,-0.645953270361,0.929241202634,077-AUQ,0.141643966136,110,226,336
8914,-0.645953270361,0.929241202634,077-AUS,0.141643966136,164,364,528
8915,-0.645953270361,0.929241202634,077-AUT,0.141643966136,131,284,415
8916,-0.645953270361,0.929241202634,077-AUU,0.141643966136,143,281,424
8917,-0.645953270361,0.929241202634,077-AUV,0.141643966136,136,259,395
8918,-0.645953270361,0.929241202634,077-AUW,0.141643966136,169,270,439
8919,-0.645953270361,0.929241202634,077-AUX,0.141643966136,177,313,490
8920,-0.645953270361,0.929241202634,077-AUY,0.141643966136,305,358,663
8921,-0.645953270361,0.929241202634,077-AUZ,0.141643966136,7,1,8
8922,-0.645953270361,0.929241202634,077-AVA,0.141643966136,169,171,340
8923,-0.645953270361,0.929241202634,077-AVB,0.141643966136,191,303,494
8924,-0.645953270361,0.929241202634,077-AVC,0.141643966136,143,294,437
8925,-0.645953270361,0.929241202634,077-AVD,0.141643966136,109,177,286
8926,-0.645953270361,0.929241202634,077-AVE,0.141643966136,107,211,318
8927,-0.645953270361,0.929241202634,077-AVF,0.141643966136,103,219,322
8928,-0.645953270361,0.929241202634,077-AVG,0.141643966136,119,204,323
8929,-0.645953270361,0.929241202634,077-AVH,0.141643966136,87,157,244
8930,-0.645953270361,0.929241202634,077-AVI,0.141643966136,123,138,261
8931,-0.645953270361,0.929241202634,077-AVJ,0.141643966136,85,200,285
8932,-0.645953270361,0.929241202634,077-AVK,0.141643966136,135,201,336
8933,-0.645953270361,0.929241202634,077-AVL,0.141643966136,120,179,299
8934,-0.645953270361,0.929241202634,077-AVM,0.141643966136,108,133,241
8935,-0.645953270361,0.929241202634,077-AVN,0.141643966136,121,235,356
8936,-0.645953270361,0.929241202634,077-AVO,0.141643966136,120,215,335
8937,-0.645953270361,0.929241202634,077-AVP,0.141643966136,121,143,264
8938,-0.645953270361,0.929241202634,077-AVQ,0.141643966136,148,219,367
8939,-0.645953270361,0.929241202634,077-AVR,0.141643966136,95,136,231
8940,-0.645953270361,0.929241202634,077-AVS,0.141643966136,117,117,234
8941,-0.645953270361,0.929241202634,077-AVT,0.141643966136,164,266,430
8942,-0.645953270361,0.929241202634,077-AVU,0.141643966136,130,187,317
8943,-0.645953270361,0.929241202634,077-AVX,0.141643966136,266,420,686
8944,-0.645953270361,0.929241202634,077-AVY,0.141643966136,336,47,383
8945,-0.645953270361,0.929241202634,077-AVZ,0.141643966136,225,474,699
8946,-0.645953270361,0.929241202634,077-AWA,0.141643966136,174,320,494
8947,-0.645953270361,0.929241202634,077-AWB,0.141643966136,145,177,322
8948,-0.645953270361,0.929241202634,077-AWC,0.141643966136,137,221,358
8949,-0.645953270361,0.929241202634,077-AWD,0.141643966136,211,361,572
8950,-0.645953270361,0.929241202634,077-AWF,0.141643966136,152,195,347
8951,-0.645953270361,0.929241202634,077-AWG,0.141643966136,113,155,268
8952,-0.645953270361,0.929241202634,077-AWH,0.141643966136,144,323,467
8953,-0.645953270361,0.929241202634,077-AWI,0.141643966136,137,259,396
8954,-0.645953270361,0.929241202634,077-AWJ,0.141643966136,80,124,204
8955,-0.645953270361,0.929241202634,077-AWK,0.141643966136,159,216,375
8956,-0.645953270361,0.929241202634,077-AWM,0.141643966136,108,223,331
8957,-0.645953270361,0.929241202634,077-AWN,0.141643966136,170,312,482
8958,-0.645953270361,0.929241202634,077-AWO,0.141643966136,136,260,396
8959,-0.645953270361,0.929241202634,077-AWP,0.141643966136,205,318,523
8960,-0.645953270361,0.929241202634,077-AWQ,0.141643966136,166,227,393
8961,-0.645953270361,0.929241202634,077-AWR,0.141643966136,181,235,416
8962,-0.645953270361,0.929241202634,077-AWT,0.141643966136,152,236,388
8963,-0.645953270361,0.929241202634,077-AWU,0.141643966136,138,180,318
8964,-0.645953270361,0.929241202634,077-AWV,0.141643966136,133,255,388
8965,-0.645953270361,0.929241202634,077-AWW,0.141643966136,186,261,447
8966,-0.645953270361,0.929241202634,077-AWX,0.141643966136,142,202,344
8967,-0.645953270361,0.929241202634,077-AWY,0.141643966136,162,255,417
8968,-0.645953270361,0.929241202634,077-AXA,0.141643966136,117,301,418
8969,-0.645953270361,0.929241202634,077-AXB,0.141643966136,135,333,468
8970,-0.645953270361,0.929241202634,077-AXC,0.141643966136,163,264,427
8971,-0.645953270361,0.929241202634,077-AXD,0.141643966136,151,312,463
8972,-0.645953270361,0.929241202634,077-AXE,0.141643966136,202,258,460
8973,-0.645953270361,0.929241202634,077-AXG,0.141643966136,136,329,465
8974,-0.645953270361,0.929241202634,077-AXH,0.141643966136,110,317,427
8975,-0.645953270361,0.929241202634,077-AXI,0.141643966136,125,389,514
8976,-0.645953270361,0.929241202634,077-AXJ,0.141643966136,159,431,590
8977,-0.645953270361,0.929241202634,077-AXK,0.141643966136,164,328,492
8978,-0.645953270361,0.929241202634,077-AXO,0.141643966136,109,289,398
8979,-0.645953270361,0.929241202634,077-AXP,0.141643966136,96,307,403
8980,-0.645953270361,0.929241202634,077-AXQ,0.141643966136,146,260,406
8981,-0.645953270361,0.929241202634,077-AXR,0.141643966136,145,271,416
8982,-0.645953270361,0.929241202634,077-AXS,0.141643966136,93,364,457
8983,-0.645953270361,0.929241202634,077-AXT,0.141643966136,108,271,379
8984,-0.645953270361,0.929241202634,077-AXV,0.141643966136,97,393,490
8985,-0.645953270361,0.929241202634,077-AXW,0.141643966136,114,323,437
8986,-0.645953270361,0.929241202634,077-AXX,0.141643966136,99,347,446
8987,-0.645953270361,0.929241202634,077-AXY,0.141643966136,110,321,431
8988,-0.645953270361,0.929241202634,077-AXZ,0.141643966136,136,293,429
8989,-0.645953270361,0.929241202634,077-AYA,0.141643966136,130,326,456
8990,-0.645953270361,0.929241202634,077-AYD,0.141643966136,142,206,348
8991,-0.645953270361,0.929241202634,077-AYE,0.141643966136,112,218,330
8992,-0.645953270361,0.929241202634,077-AYG,0.141643966136,83,98,181
8993,-0.645953270361,0.929241202634,077-AYH,0.141643966136,197,295,492
8994,-0.645953270361,0.929241202634,077-AYI,0.141643966136,150,323,473
8995,-0.645953270361,0.929241202634,078-AAA,0.141643966136,433,254,687
8996,-0.645953270361,0.929241202634,078-AAB,0.141643966136,128,86,214
8997,-0.645953270361,0.929241202634,078-AAE,0.141643966136,165,102,267
8998,-0.645953270361,0.929241202634,078-AAF,0.141643966136,179,62,241
8999,-0.645953270361,0.929241202634,078-AAG,0.141643966136,134,62,196
9000,-0.645953270361,0.929241202634,078-AAH,0.141643966136,135,69,204
9001,-0.645953270361,0.929241202634,078-AAI,0.141643966136,103,30,133
9002,-0.645953270361,0.929241202634,078-AAJ,0.141643966136,143,95,238
9003,-0.645953270361,0.929241202634,078-AAK,0.141643966136,123,93,216
9004,-0.645953270361,0.929241202634,078-AAL,0.141643966136,121,62,183
9005,-0.645953270361,0.929241202634,078-AAM,0.141643966136,143,77,220
9006,-0.645953270361,0.929241202634,078-AAN,0.141643966136,146,35,181
9007,-0.645953270361,0.929241202634,078-AAO,0.141643966136,134,47,181
9008,-0.645953270361,0.929241202634,078-AAQ,0.141643966136,181,158,339
9009,-0.645953270361,0.929241202634,078-AAR,0.141643966136,174,127,301
9010,-0.645953270361,0.929241202634,078-AAT,0.141643966136,142,148,290
9011,-0.645953270361,0.929241202634,078-AAU,0.141643966136,267,235,502
9012,-0.645953270361,0.929241202634,078-AAV,0.141643966136,126,89,215
9013,-0.645953270361,0.929241202634,078-AAW,0.141643966136,180,99,279
9014,-0.645953270361,0.929241202634,078-AAX,0.141643966136,177,101,278
9015,-0.645953270361,0.929241202634,078-AAZ,0.141643966136,114,82,196
9016,-0.645953270361,0.929241202634,078-ABA,0.141643966136,182,79,261
9017,-0.645953270361,0.929241202634,078-ABB,0.141643966136,132,68,200
9018,-0.645953270361,0.929241202634,078-ABD,0.141643966136,288,158,446
9019,-0.645953270361,0.929241202634,078-ABF,0.141643966136,201,79,280
9020,-0.645953270361,0.929241202634,078-ABG,0.141643966136,160,99,259
9021,-0.645953270361,0.929241202634,078-ABH,0.141643966136,124,88,212
9022,-0.645953270361,0.929241202634,078-ABJ,0.141643966136,180,102,282
9023,-0.645953270361,0.929241202634,078-ABK,0.141643966136,171,141,312
9024,-0.645953270361,0.929241202634,078-ABL,0.141643966136,199,107,306
9025,-0.645953270361,0.929241202634,078-ABM,0.141643966136,126,57,183
9026,-0.645953270361,0.929241202634,078-ABN,0.141643966136,138,50,188
9027,-0.645953270361,0.929241202634,078-ABP,0.141643966136,146,37,183
9028,-0.645953270361,0.929241202634,078-ABQ,0.141643966136,93,38,131
9029,-0.645953270361,0.929241202634,078-ABR,0.141643966136,148,57,205
9030,-0.645953270361,0.929241202634,078-ABS,0.141643966136,138,81,219
9031,-0.645953270361,0.929241202634,078-ABT,0.141643966136,158,74,232
9032,-0.645953270361,0.929241202634,078-ABU,0.141643966136,143,87,230
9033,-0.645953270361,0.929241202634,078-ABV,0.141643966136,177,108,285
9034,-0.645953270361,0.929241202634,078-ABX,0.141643966136,87,83,170
9035,-0.645953270361,0.929241202634,078-ABY,0.141643966136,110,97,207
9036,-0.645953270361,0.929241202634,078-ABZ,0.141643966136,95,32,127
9037,-0.645953270361,0.929241202634,078-ACA,0.141643966136,98,39,137
9038,-0.645953270361,0.929241202634,078-ACB,0.141643966136,87,49,136
9039,-0.645953270361,0.929241202634,078-ACC,0.141643966136,158,93,251
9040,-0.645953270361,0.929241202634,078-ACD,0.141643966136,80,39,119
9041,-0.645953270361,0.929241202634,078-ACF,0.141643966136,157,105,262
9042,-0.645953270361,0.929241202634,078-ACG,0.141643966136,87,51,138
9043,-0.645953270361,0.929241202634,078-ACI,0.141643966136,108,54,162
9044,-0.645953270361,0.929241202634,078-ACJ,0.141643966136,116,32,148
9045,-0.645953270361,0.929241202634,078-ACL,0.141643966136,137,57,194
9046,-0.645953270361,0.929241202634,078-ACM,0.141643966136,84,45,129
9047,-0.645953270361,0.929241202634,078-ACN,0.141643966136,229,154,383
9048,-0.645953270361,0.929241202634,078-ACO,0.141643966136,171,86,257
9049,-0.645953270361,0.929241202634,078-ACP,0.141643966136,151,50,201
9050,-0.645953270361,0.929241202634,078-ACQ,0.141643966136,76,35,111
9051,-0.645953270361,0.929241202634,078-ACR,0.141643966136,87,42,129
9052,-0.645953270361,0.929241202634,078-ACS,0.141643966136,142,89,231
9053,-0.645953270361,0.929241202634,078-ACU,0.141643966136,89,34,123
9054,-0.645953270361,0.929241202634,078-ACV,0.141643966136,119,50,169
9055,-0.645953270361,0.929241202634,078-ACW,0.141643966136,228,60,288
9056,-0.645953270361,0.929241202634,078-ACX,0.141643966136,155,117,272
9057,-0.645953270361,0.929241202634,078-ACZ,0.141643966136,132,96,228
9058,-0.645953270361,0.929241202634,078-ADA,0.141643966136,122,99,221
9059,-0.645953270361,0.929241202634,078-ADB,0.141643966136,110,90,200
9060,-0.645953270361,0.929241202634,078-ADC,0.141643966136,104,119,223
9061,-0.645953270361,0.929241202634,078-ADD,0.141643966136,144,65,209
9062,-0.645953270361,0.929241202634,078-ADE,0.141643966136,104,94,198
9063,-0.645953270361,0.929241202634,078-ADF,0.141643966136,144,108,252
9064,-0.645953270361,0.929241202634,078-ADG,0.141643966136,144,118,262
9065,-0.645953270361,0.929241202634,078-ADH,0.141643966136,143,99,242
9066,-0.645953270361,0.929241202634,078-ADI,0.141643966136,101,49,150
9067,-0.645953270361,0.929241202634,078-ADJ,0.141643966136,70,48,118
9068,-0.645953270361,0.929241202634,078-ADK,0.141643966136,71,41,112
9069,-0.645953270361,0.929241202634,078-ADL,0.141643966136,65,43,108
9070,-0.645953270361,0.929241202634,078-ADM,0.141643966136,90,59,149
9071,-0.645953270361,0.929241202634,078-ADN,0.141643966136,111,5,116
9072,-0.645953270361,0.929241202634,078-ADO,0.141643966136,52,23,75
9073,-0.645953270361,0.929241202634,078-ADP,0.141643966136,142,14,156
9074,-0.645953270361,0.929241202634,078-ADQ,0.141643966136,117,51,168
9075,-0.645953270361,0.929241202634,078-ADS,0.141643966136,66,55,121
9076,-0.645953270361,0.929241202634,078-ADT,0.141643966136,144,116,260
9077,-0.645953270361,0.929241202634,078-ADU,0.141643966136,128,55,183
9078,-0.645953270361,0.929241202634,078-ADV,0.141643966136,129,98,227
9079,-0.645953270361,0.929241202634,078-ADW,0.141643966136,104,33,137
9080,-0.645953270361,0.929241202634,078-ADX,0.141643966136,202,30,232
9081,-0.645953270361,0.929241202634,078-ADZ,0.141643966136,225,200,425
9082,-0.645953270361,0.929241202634,078-AEA,0.141643966136,69,44,113
9083,-0.645953270361,0.929241202634,078-AEB,0.141643966136,137,17,154
9084,-0.645953270361,0.929241202634,078-AEC,0.141643966136,232,5,237
9085,-0.645953270361,0.929241202634,078-AED,0.141643966136,141,5,146
9086,-0.645953270361,0.929241202634,078-AEE,0.141643966136,196,12,208
9087,-0.645953270361,0.929241202634,078-AEF,0.141643966136,160,27,187
9088,-0.645953270361,0.929241202634,078-AEH,0.141643966136,149,12,161
9089,-0.645953270361,0.929241202634,078-AEI,0.141643966136,136,16,152
9090,-0.645953270361,0.929241202634,078-AEJ,0.141643966136,187,74,261
9091,-0.645953270361,0.929241202634,078-AEK,0.141643966136,164,67,231
9092,-0.645953270361,0.929241202634,078-AEL,0.141643966136,125,45,170
9093,-0.645953270361,0.929241202634,078-AEM,0.141643966136,233,43,276
9094,-0.645953270361,0.929241202634,078-AEN,0.141643966136,77,40,117
9095,-0.645953270361,0.929241202634,078-AER,0.141643966136,345,352,697
9096,-0.645953270361,0.929241202634,078-AES,0.141643966136,105,86,191
9097,-0.645953270361,0.929241202634,078-AET,0.141643966136,144,275,419
9098,-0.645953270361,0.929241202634,078-AEV,0.141643966136,202,291,493
9099,-0.645953270361,0.929241202634,078-AEW,0.141643966136,301,331,632
9100,-0.645953270361,0.929241202634,078-AEX,0.141643966136,82,213,295
9101,-0.645953270361,0.929241202634,078-AEY,0.141643966136,166,193,359
9102,-0.645953270361,0.929241202634,078-AEZ,0.141643966136,125,127,252
9103,-0.645953270361,0.929241202634,078-AFA,0.141643966136,134,114,248
9104,-0.645953270361,0.929241202634,078-AFB,0.141643966136,123,165,288
9105,-0.645953270361,0.929241202634,078-AFC,0.141643966136,153,204,357
9106,-0.645953270361,0.929241202634,078-AFD,0.141643966136,121,213,334
9107,-0.645953270361,0.929241202634,078-AFE,0.141643966136,197,170,367
9108,-0.645953270361,0.929241202634,078-AFG,0.141643966136,227,77,304
9109,-0.645953270361,0.929241202634,078-AFH,0.141643966136,257,142,399
9110,-0.645953270361,0.929241202634,078-AFK,0.141643966136,235,170,405
9111,-0.645953270361,0.929241202634,078-AFL,0.141643966136,185,153,338
9112,-0.645953270361,0.929241202634,078-AFM,0.141643966136,146,103,249
9113,-0.645953270361,0.929241202634,078-AFN,0.141643966136,163,105,268
9114,-0.645953270361,0.929241202634,078-AFP,0.141643966136,185,159,344
9115,-0.645953270361,0.929241202634,078-AFQ,0.141643966136,106,93,199
9116,-0.645953270361,0.929241202634,078-AFR,0.141643966136,165,156,321
9117,-0.645953270361,0.929241202634,078-AFS,0.141643966136,112,127,239
9118,-0.645953270361,0.929241202634,078-AFT,0.141643966136,198,219,417
9119,-0.645953270361,0.929241202634,078-AFV,0.141643966136,229,253,482
9120,-0.645953270361,0.929241202634,078-AFW,0.141643966136,150,120,270
9121,-0.645953270361,0.929241202634,078-AFX,0.141643966136,247,319,566
9122,-0.645953270361,0.929241202634,078-AFY,0.141643966136,98,135,233
9123,-0.645953270361,0.929241202634,078-AGA,0.141643966136,149,187,336
9124,-0.645953270361,0.929241202634,078-AGB,0.141643966136,127,155,282
9125,-0.645953270361,0.929241202634,078-AGC,0.141643966136,139,290,429
9126,-0.645953270361,0.929241202634,078-AGD,0.141643966136,42,69,111
9127,-0.645953270361,0.929241202634,078-AGE,0.141643966136,183,279,462
9128,-0.645953270361,0.929241202634,078-AGG,0.141643966136,248,265,513
9129,-0.645953270361,0.929241202634,078-AGH,0.141643966136,104,170,274
9130,-0.645953270361,0.929241202634,078-AGI,0.141643966136,155,191,346
9131,-0.645953270361,0.929241202634,078-AGK,0.141643966136,239,274,513
9132,-0.645953270361,0.929241202634,078-AGL,0.141643966136,150,188,338
9133,-0.645953270361,0.929241202634,078-AGN,0.141643966136,209,157,366
9134,-0.645953270361,0.929241202634,078-AGO,0.141643966136,178,129,307
9135,-0.645953270361,0.929241202634,078-AGP,0.141643966136,88,144,232
9136,-0.645953270361,0.929241202634,078-AGR,0.141643966136,139,115,254
9137,-0.645953270361,0.929241202634,078-AGT,0.141643966136,113,123,236
9138,-0.645953270361,0.929241202634,078-AGU,0.141643966136,161,327,488
9139,-0.645953270361,0.929241202634,078-AGV,0.141643966136,173,260,433
9140,-0.645953270361,0.929241202634,078-AGW,0.141643966136,171,121,292
9141,-0.645953270361,0.929241202634,078-AGX,0.141643966136,104,86,190
9142,-0.645953270361,0.929241202634,078-AGY,0.141643966136,322,469,791
9143,-0.645953270361,0.929241202634,078-AHA,0.141643966136,141,115,256
9144,-0.645953270361,0.929241202634,078-AHB,0.141643966136,182,164,346
9145,-0.645953270361,0.929241202634,078-AHC,0.141643966136,165,163,328
9146,-0.645953270361,0.929241202634,078-AHD,0.141643966136,103,85,188
9147,-0.645953270361,0.929241202634,078-AHE,0.141643966136,165,254,419
9148,-0.645953270361,0.929241202634,078-AHF,0.141643966136,117,118,235
9149,-0.645953270361,0.929241202634,078-AHG,0.141643966136,153,205,358
9150,-0.645953270361,0.929241202634,078-AHH,0.141643966136,148,201,349
9151,-0.645953270361,0.929241202634,078-AHI,0.141643966136,193,209,402
9152,-0.645953270361,0.929241202634,078-AHJ,0.141643966136,189,134,323
9153,-0.645953270361,0.929241202634,078-AHK,0.141643966136,262,203,465
9154,-0.645953270361,0.929241202634,078-AHM,0.141643966136,259,264,523
9155,-0.645953270361,0.929241202634,078-AHO,0.141643966136,262,191,453
9156,-0.645953270361,0.929241202634,078-AHQ,0.141643966136,119,127,246
9157,-0.645953270361,0.929241202634,078-AHR,0.141643966136,162,184,346
9158,-0.645953270361,0.929241202634,078-AHS,0.141643966136,114,199,313
9159,-0.645953270361,0.929241202634,078-AHT,0.141643966136,154,232,386
9160,-0.645953270361,0.929241202634,078-AHV,0.141643966136,74,175,249
9161,-0.645953270361,0.929241202634,078-AHW,0.141643966136,142,123,265
9162,-0.645953270361,0.929241202634,078-AHX,0.141643966136,313,170,483
9163,-0.645953270361,0.929241202634,078-AHY,0.141643966136,195,168,363
9164,-0.645953270361,0.929241202634,078-AHZ,0.141643966136,178,89,267
9165,-0.645953270361,0.929241202634,078-AIA,0.141643966136,286,197,483
9166,-0.645953270361,0.929241202634,078-AIC,0.141643966136,296,75,371
9167,-0.645953270361,0.929241202634,078-AIE,0.141643966136,189,212,401
9168,-0.645953270361,0.929241202634,078-AIG,0.141643966136,193,137,330
9169,-0.645953270361,0.929241202634,078-AIH,0.141643966136,149,51,200
9170,-0.645953270361,0.929241202634,078-AII,0.141643966136,307,158,465
9171,-0.645953270361,0.929241202634,078-AIJ,0.141643966136,286,166,452
9172,-0.645953270361,0.929241202634,078-AIL,0.141643966136,150,43,193
9173,-0.645953270361,0.929241202634,078-AIN,0.141643966136,184,183,367
9174,-0.645953270361,0.929241202634,078-AIP,0.141643966136,183,172,355
9175,-0.645953270361,0.929241202634,078-AIQ,0.141643966136,220,168,388
9176,-0.645953270361,0.929241202634,078-AIR,0.141643966136,191,186,377
9177,-0.645953270361,0.929241202634,078-AIS,0.141643966136,115,115,230
9178,-0.645953270361,0.929241202634,078-AIT,0.141643966136,146,190,336
9179,-0.645953270361,0.929241202634,078-AIU,0.141643966136,130,161,291
9180,-0.645953270361,0.929241202634,078-AIV,0.141643966136,109,145,254
9181,-0.645953270361,0.929241202634,078-AIW,0.141643966136,39,104,143
9182,-0.645953270361,0.929241202634,078-AIX,0.141643966136,34,120,154
9183,-0.645953270361,0.929241202634,078-AIY,0.141643966136,251,243,494
9184,-0.645953270361,0.929241202634,078-AIZ,0.141643966136,142,169,311
9185,-0.645953270361,0.929241202634,078-AJB,0.141643966136,186,173,359
9186,-0.645953270361,0.929241202634,078-AJC,0.141643966136,121,143,264
9187,-0.645953270361,0.929241202634,078-AJD,0.141643966136,183,162,345
9188,-0.645953270361,0.929241202634,078-AJF,0.141643966136,136,121,257
9189,-0.645953270361,0.929241202634,078-AJG,0.141643966136,179,155,334
9190,-0.645953270361,0.929241202634,078-AJH,0.141643966136,154,173,327
9191,-0.645953270361,0.929241202634,078-AJJ,0.141643966136,210,254,464
9192,-0.645953270361,0.929241202634,078-AJK,0.141643966136,245,295,540
9193,-0.645953270361,0.929241202634,078-AJL,0.141643966136,197,224,421
9194,-0.645953270361,0.929241202634,078-AJM,0.141643966136,104,148,252
9195,-0.645953270361,0.929241202634,078-AJN,0.141643966136,73,127,200
9196,-0.645953270361,0.929241202634,078-AJO,0.141643966136,182,230,412
9197,-0.645953270361,0.929241202634,078-AJP,0.141643966136,175,217,392
9198,-0.645953270361,0.929241202634,078-AJQ,0.141643966136,141,167,308
9199,-0.645953270361,0.929241202634,078-AJR,0.141643966136,108,124,232
9200,-0.645953270361,0.929241202634,078-AJS,0.141643966136,110,125,235
9201,-0.645953270361,0.929241202634,078-AJU,0.141643966136,144,144,288
9202,-0.645953270361,0.929241202634,078-AJW,0.141643966136,318,116,434
9203,-0.645953270361,0.929241202634,078-AJX,0.141643966136,125,81,206
9204,-0.645953270361,0.929241202634,078-AJY,0.141643966136,155,103,258
9205,-0.645953270361,0.929241202634,078-AJZ,0.141643966136,159,150,309
9206,-0.645953270361,0.929241202634,078-AKA,0.141643966136,97,66,163
9207,-0.645953270361,0.929241202634,078-AKB,0.141643966136,166,171,337
9208,-0.645953270361,0.929241202634,078-AKC,0.141643966136,121,78,199
9209,-0.645953270361,0.929241202634,078-AKD,0.141643966136,130,116,246
9210,-0.645953270361,0.929241202634,078-AKE,0.141643966136,143,113,256
9211,-0.645953270361,0.929241202634,078-AKF,0.141643966136,183,140,323
9212,-0.645953270361,0.929241202634,078-AKG,0.141643966136,228,152,380
9213,-0.645953270361,0.929241202634,078-AKH,0.141643966136,73,56,129
9214,-0.645953270361,0.929241202634,078-AKI,0.141643966136,217,168,385
9215,-0.645953270361,0.929241202634,078-AKJ,0.141643966136,115,110,225
9216,-0.645953270361,0.929241202634,078-AKM,0.141643966136,258,162,420
9217,-0.645953270361,0.929241202634,078-AKN,0.141643966136,127,77,204
9218,-0.645953270361,0.929241202634,078-AKO,0.141643966136,381,198,579
9219,-0.645953270361,0.929241202634,078-AKQ,0.141643966136,146,217,363
9220,-0.645953270361,0.929241202634,078-AKR,0.141643966136,126,189,315
9221,-0.645953270361,0.929241202634,078-AKS,0.141643966136,161,205,366
9222,-0.645953270361,0.929241202634,078-AKT,0.141643966136,163,168,331
9223,-0.645953270361,0.929241202634,078-AKU,0.141643966136,164,144,308
9224,-0.645953270361,0.929241202634,078-AKV,0.141643966136,154,203,357
9225,-0.645953270361,0.929241202634,078-AKW,0.141643966136,129,222,351
9226,-0.645953270361,0.929241202634,078-AKX,0.141643966136,190,263,453
9227,-0.645953270361,0.929241202634,078-AKY,0.141643966136,103,121,224
9228,-0.645953270361,0.929241202634,078-AKZ,0.141643966136,154,236,390
9229,-0.645953270361,0.929241202634,078-ALA,0.141643966136,150,74,224
9230,-0.645953270361,0.929241202634,078-ALB,0.141643966136,107,181,288
9231,-0.645953270361,0.929241202634,078-ALC,0.141643966136,139,78,217
9232,-0.645953270361,0.929241202634,078-ALD,0.141643966136,129,63,192
9233,-0.645953270361,0.929241202634,079-AAA,0.141643966136,126,165,291
9234,-0.645953270361,0.929241202634,079-AAB,0.141643966136,158,211,369
9235,-0.645953270361,0.929241202634,079-AAC,0.141643966136,176,281,457
9236,-0.645953270361,0.929241202634,079-AAE,0.141643966136,149,246,395
9237,-0.645953270361,0.929241202634,079-AAF,0.141643966136,154,345,499
9238,-0.645953270361,0.929241202634,079-AAG,0.141643966136,177,326,503
9239,-0.645953270361,0.929241202634,079-AAI,0.141643966136,116,167,283
9240,-0.645953270361,0.929241202634,079-AAJ,0.141643966136,122,136,258
9241,-0.645953270361,0.929241202634,079-AAK,0.141643966136,155,217,372
9242,-0.645953270361,0.929241202634,079-AAM,0.141643966136,93,75,168
9243,-0.645953270361,0.929241202634,079-AAN,0.141643966136,130,96,226
9244,-0.645953270361,0.929241202634,079-AAO,0.141643966136,172,205,377
9245,-0.645953270361,0.929241202634,079-AAQ,0.141643966136,114,124,238
9246,-0.645953270361,0.929241202634,079-AAR,0.141643966136,129,146,275
9247,-0.645953270361,0.929241202634,079-AAS,0.141643966136,164,212,376
9248,-0.645953270361,0.929241202634,079-AAT,0.141643966136,129,118,247
9249,-0.645953270361,0.929241202634,079-AAX,0.141643966136,166,213,379
9250,-0.645953270361,0.929241202634,079-AAY,0.141643966136,144,273,417
9251,-0.645953270361,0.929241202634,079-AAZ,0.141643966136,146,275,421
9252,-0.645953270361,0.929241202634,079-ABA,0.141643966136,139,141,280
9253,-0.645953270361,0.929241202634,079-ABE,0.141643966136,122,80,202
9254,-0.645953270361,0.929241202634,079-ABF,0.141643966136,119,103,222
9255,-0.645953270361,0.929241202634,079-ABG,0.141643966136,55,80,135
9256,-0.645953270361,0.929241202634,079-ABH,0.141643966136,150,108,258
9257,-0.645953270361,0.929241202634,079-ABK,0.141643966136,165,233,398
9258,-0.645953270361,0.929241202634,079-ABL,0.141643966136,179,230,409
9259,-0.645953270361,0.929241202634,079-ABM,0.141643966136,190,310,500
9260,-0.645953270361,0.929241202634,079-ABO,0.141643966136,169,135,304
9261,-0.645953270361,0.929241202634,079-ABQ,0.141643966136,136,103,239
9262,-0.645953270361,0.929241202634,079-ABS,0.141643966136,151,109,260
9263,-0.645953270361,0.929241202634,079-ABU,0.141643966136,199,122,321
9264,-0.645953270361,0.929241202634,079-ABW,0.141643966136,64,182,246
9265,-0.645953270361,0.929241202634,079-ABX,0.141643966136,45,130,175
9266,-0.645953270361,0.929241202634,079-ABY,0.141643966136,63,211,274
9267,-0.645953270361,0.929241202634,079-ABZ,0.141643966136,104,115,219
9268,-0.645953270361,0.929241202634,079-ACA,0.141643966136,179,215,394
9269,-0.645953270361,0.929241202634,079-ACD,0.141643966136,146,318,464
9270,-0.645953270361,0.929241202634,079-ACE,0.141643966136,144,276,420
9271,-0.645953270361,0.929241202634,079-ACF,0.141643966136,151,353,504
9272,-0.645953270361,0.929241202634,079-ACG,0.141643966136,127,205,332
9273,-0.645953270361,0.929241202634,079-ACI,0.141643966136,166,324,490
9274,-0.645953270361,0.929241202634,079-ACK,0.141643966136,176,434,610
9275,-0.645953270361,0.929241202634,079-ACM,0.141643966136,163,285,448
9276,-0.645953270361,0.929241202634,079-ACN,0.141643966136,160,237,397
9277,-0.645953270361,0.929241202634,079-ACP,0.141643966136,81,69,150
9278,-0.645953270361,0.929241202634,079-ACR,0.141643966136,161,207,368
9279,-0.645953270361,0.929241202634,079-ACS,0.141643966136,149,229,378
9280,-0.645953270361,0.929241202634,079-ACT,0.141643966136,176,167,343
9281,-0.645953270361,0.929241202634,079-ACU,0.141643966136,144,232,376
9282,-0.645953270361,0.929241202634,079-ACX,0.141643966136,106,263,369
9283,-0.645953270361,0.929241202634,079-ACZ,0.141643966136,118,220,338
9284,-0.645953270361,0.929241202634,079-ADA,0.141643966136,155,514,669
9285,-0.645953270361,0.929241202634,079-ADB,0.141643966136,107,214,321
9286,-0.645953270361,0.929241202634,079-ADC,0.141643966136,139,307,446
9287,-0.645953270361,0.929241202634,079-ADE,0.141643966136,124,220,344
9288,-0.645953270361,0.929241202634,079-ADG,0.141643966136,293,251,544
9289,-0.645953270361,0.929241202634,079-ADI,0.141643966136,169,146,315
9290,-0.645953270361,0.929241202634,079-ADJ,0.141643966136,195,104,299
9291,-0.645953270361,0.929241202634,079-ADM,0.141643966136,103,259,362
9292,-0.645953270361,0.929241202634,079-ADN,0.141643966136,169,227,396
9293,-0.645953270361,0.929241202634,079-ADO,0.141643966136,141,125,266
9294,-0.645953270361,0.929241202634,079-ADP,0.141643966136,126,122,248
9295,-0.645953270361,0.929241202634,079-ADS,0.141643966136,60,83,143
9296,-0.645953270361,0.929241202634,079-ADT,0.141643966136,96,144,240
9297,-0.645953270361,0.929241202634,079-ADV,0.141643966136,121,226,347
9298,-0.645953270361,0.929241202634,079-ADW,0.141643966136,44,79,123
9299,-0.645953270361,0.929241202634,079-ADY,0.141643966136,65,70,135
9300,-0.645953270361,0.929241202634,079-ADZ,0.141643966136,124,180,304
9301,-0.645953270361,0.929241202634,079-AEA,0.141643966136,122,183,305
9302,-0.645953270361,0.929241202634,079-AEC,0.141643966136,69,279,348
9303,-0.645953270361,0.929241202634,079-AED,0.141643966136,115,364,479
9304,-0.645953270361,0.929241202634,079-AEE,0.141643966136,62,212,274
9305,-0.645953270361,0.929241202634,079-AEG,0.141643966136,201,241,442
9306,-0.645953270361,0.929241202634,079-AEI,0.141643966136,141,255,396
9307,-0.645953270361,0.929241202634,079-AEJ,0.141643966136,129,144,273
9308,-0.645953270361,0.929241202634,079-AEK,0.141643966136,153,106,259
9309,-0.645953270361,0.929241202634,079-AEM,0.141643966136,141,161,302
9310,-0.645953270361,0.929241202634,079-AEN,0.141643966136,79,116,195
9311,-0.645953270361,0.929241202634,079-AEO,0.141643966136,105,376,481
9312,-0.645953270361,0.929241202634,079-AEP,0.141643966136,174,318,492
9313,-0.645953270361,0.929241202634,079-AEU,0.141643966136,107,214,321
9314,-0.645953270361,0.929241202634,080-AAA,0.141643966136,122,327,449
9315,-0.645953270361,0.929241202634,080-AAB,0.141643966136,154,385,539
9316,-0.645953270361,0.929241202634,080-AAC,0.141643966136,102,197,299
9317,-0.645953270361,0.929241202634,080-AAD,0.141643966136,94,257,351
9318,-0.645953270361,0.929241202634,080-AAE,0.141643966136,86,215,301
9319,-0.645953270361,0.929241202634,080-AAF,0.141643966136,44,103,147
9320,-0.645953270361,0.929241202634,080-AAG,0.141643966136,97,333,430
9321,-0.645953270361,0.929241202634,080-AAH,0.141643966136,78,245,323
9322,-0.645953270361,0.929241202634,080-AAI,0.141643966136,147,499,646
9323,-0.645953270361,0.929241202634,080-AAJ,0.141643966136,115,256,371
9324,-0.645953270361,0.929241202634,080-AAK,0.141643966136,95,235,330
9325,-0.645953270361,0.929241202634,080-AAL,0.141643966136,75,254,329
9326,-0.645953270361,0.929241202634,080-AAM,0.141643966136,70,383,453
9327,-0.645953270361,0.929241202634,080-AAN,0.141643966136,52,277,329
9328,-0.645953270361,0.929241202634,080-AAP,0.141643966136,91,357,448
9329,-0.645953270361,0.929241202634,080-AAQ,0.141643966136,78,176,254
9330,-0.645953270361,0.929241202634,080-AAS,0.141643966136,67,190,257
9331,-0.645953270361,0.929241202634,080-AAV,0.141643966136,106,333,439
9332,-0.645953270361,0.929241202634,080-AAW,0.141643966136,87,403,490
9333,-0.645953270361,0.929241202634,080-AAX,0.141643966136,73,244,317
9334,-0.645953270361,0.929241202634,080-AAY,0.141643966136,119,352,471
9335,-0.645953270361,0.929241202634,080-AAZ,0.141643966136,65,220,285
9336,-0.645953270361,0.929241202634,080-ABA,0.141643966136,126,547,673
9337,-0.645953270361,0.929241202634,080-ABB,0.141643966136,71,167,238
9338,-0.645953270361,0.929241202634,080-ABC,0.141643966136,62,176,238
9339,-0.645953270361,0.929241202634,080-ABD,0.141643966136,70,300,370
9340,-0.645953270361,0.929241202634,080-ABE,0.141643966136,48,195,243
9341,-0.645953270361,0.929241202634,080-ABF,0.141643966136,52,310,362
9342,-0.645953270361,0.929241202634,080-ABH,0.141643966136,109,377,486
9343,-0.645953270361,0.929241202634,080-ABI,0.141643966136,59,253,312
9344,-0.645953270361,0.929241202634,080-ABJ,0.141643966136,61,328,389
9345,-0.645953270361,0.929241202634,080-ABK,0.141643966136,119,453,572
9346,-0.645953270361,0.929241202634,080-ABL,0.141643966136,87,338,425
9347,-0.645953270361,0.929241202634,080-ABM,0.141643966136,49,183,232
9348,-0.645953270361,0.929241202634,080-ABO,0.141643966136,63,235,298
9349,-0.645953270361,0.929241202634,080-ABP,0.141643966136,63,235,298
9350,-0.645953270361,0.929241202634,080-ABQ,0.141643966136,61,182,243
9351,-0.645953270361,0.929241202634,080-ABS,0.141643966136,85,358,443
9352,-0.645953270361,0.929241202634,080-ABT,0.141643966136,58,197,255
9353,-0.645953270361,0.929241202634,080-ABU,0.141643966136,85,332,417
9354,-0.645953270361,0.929241202634,080-ABV,0.141643966136,159,479,638
9355,-0.645953270361,0.929241202634,080-ABW,0.141643966136,87,464,551
9356,-0.645953270361,0.929241202634,080-ABX,0.141643966136,47,228,275
9357,-0.645953270361,0.929241202634,080-ABY,0.141643966136,153,291,444
9358,-0.645953270361,0.929241202634,081-AAA,0.141643966136,49,104,153
9359,-0.645953270361,0.929241202634,081-AAB,0.141643966136,77,137,214
9360,-0.645953270361,0.929241202634,081-AAC,0.141643966136,53,125,178
9361,-0.645953270361,0.929241202634,081-AAD,0.141643966136,72,128,200
9362,-0.645953270361,0.929241202634,081-AAE,0.141643966136,53,204,257
9363,-0.645953270361,0.929241202634,081-AAF,0.141643966136,63,89,152
9364,-0.645953270361,0.929241202634,081-AAG,0.141643966136,33,106,139
9365,-0.645953270361,0.929241202634,081-AAH,0.141643966136,39,94,133
9366,-0.645953270361,0.929241202634,081-AAI,0.141643966136,26,100,126
9367,-0.645953270361,0.929241202634,081-AAJ,0.141643966136,55,141,196
9368,-0.645953270361,0.929241202634,081-AAK,0.141643966136,41,117,158
9369,-0.645953270361,0.929241202634,081-AAL,0.141643966136,63,163,226
9370,-0.645953270361,0.929241202634,081-AAM,0.141643966136,33,99,132
9371,-0.645953270361,0.929241202634,081-AAN,0.141643966136,43,146,189
9372,-0.645953270361,0.929241202634,081-AAO,0.141643966136,76,248,324
9373,-0.645953270361,0.929241202634,081-AAP,0.141643966136,79,178,257
9374,-0.645953270361,0.929241202634,081-AAQ,0.141643966136,48,95,143
9375,-0.645953270361,0.929241202634,081-AAR,0.141643966136,66,162,228
9376,-0.645953270361,0.929241202634,081-AAS,0.141643966136,67,199,266
9377,-0.645953270361,0.929241202634,081-AAT,0.141643966136,52,241,293
9378,-0.645953270361,0.929241202634,081-AAU,0.141643966136,96,326,422
9379,-0.645953270361,0.929241202634,081-AAV,0.141643966136,49,166,215
9380,-0.645953270361,0.929241202634,081-AAW,0.141643966136,24,141,165
9381,-0.645953270361,0.929241202634,081-AAX,0.141643966136,29,208,237
9382,-0.645953270361,0.929241202634,081-AAY,0.141643966136,69,266,335
9383,-0.645953270361,0.929241202634,081-AAZ,0.141643966136,47,141,188
9384,-0.645953270361,0.929241202634,081-ABA,0.141643966136,42,185,227
9385,-0.645953270361,0.929241202634,081-ABB,0.141643966136,59,217,276
9386,-0.645953270361,0.929241202634,081-ABC,0.141643966136,73,183,256
9387,-0.645953270361,0.929241202634,081-ABD,0.141643966136,105,376,481
9388,-0.645953270361,0.929241202634,081-ABF,0.141643966136,82,290,372
9389,-0.645953270361,0.929241202634,081-ABG,0.141643966136,93,179,272
9390,-0.645953270361,0.929241202634,081-ABI,0.141643966136,65,240,305
9391,-0.645953270361,0.929241202634,081-ABJ,0.141643966136,78,305,383
9392,-0.645953270361,0.929241202634,081-ABK,0.141643966136,44,224,268
9393,-0.645953270361,0.929241202634,081-ABL,0.141643966136,59,102,161
9394,-0.645953270361,0.929241202634,081-ABM,0.141643966136,88,220,308
9395,-0.645953270361,0.929241202634,081-ABN,0.141643966136,63,167,230
9396,-0.645953270361,0.929241202634,081-ABO,0.141643966136,51,269,320
9397,-0.645953270361,0.929241202634,082-AAA,0.141643966136,30,64,94
9398,-0.645953270361,0.929241202634,082-AAB,0.141643966136,116,164,280
9399,-0.645953270361,0.929241202634,082-AAD,0.141643966136,62,81,143
9400,-0.645953270361,0.929241202634,082-AAE,0.141643966136,44,51,95
9401,-0.645953270361,0.929241202634,082-AAF,0.141643966136,72,77,149
9402,-0.645953270361,0.929241202634,082-AAG,0.141643966136,150,249,399
9403,-0.645953270361,0.929241202634,082-AAH,0.141643966136,87,119,206
9404,-0.645953270361,0.929241202634,082-AAI,0.141643966136,83,156,239
9405,-0.645953270361,0.929241202634,082-AAJ,0.141643966136,46,74,120
9406,-0.645953270361,0.929241202634,082-AAK,0.141643966136,134,197,331
9407,-0.645953270361,0.929241202634,082-AAL,0.141643966136,96,140,236
9408,-0.645953270361,0.929241202634,082-AAM,0.141643966136,107,96,203
9409,-0.645953270361,0.929241202634,082-AAN,0.141643966136,66,62,128
9410,-0.645953270361,0.929241202634,082-AAO,0.141643966136,61,43,104
9411,-0.645953270361,0.929241202634,082-AAP,0.141643966136,129,155,284
9412,-0.645953270361,0.929241202634,082-AAQ,0.141643966136,116,112,228
9413,-0.645953270361,0.929241202634,082-AAR,0.141643966136,95,185,280
9414,-0.645953270361,0.929241202634,082-AAS,0.141643966136,105,76,181
9415,-0.645953270361,0.929241202634,082-AAU,0.141643966136,101,136,237
9416,-0.645953270361,0.929241202634,082-AAW,0.141643966136,17,33,50
9417,-0.645953270361,0.929241202634,083-AAA,0.141643966136,89,163,252
9418,-0.645953270361,0.929241202634,083-AAB,0.141643966136,86,289,375
9419,-0.645953270361,0.929241202634,083-AAC,0.141643966136,61,177,238
9420,-0.645953270361,0.929241202634,083-AAD,0.141643966136,97,223,320
9421,-0.645953270361,0.929241202634,083-AAE,0.141643966136,72,177,249
9422,-0.645953270361,0.929241202634,083-AAF,0.141643966136,114,336,450
9423,-0.645953270361,0.929241202634,083-AAG,0.141643966136,125,388,513
9424,-0.645953270361,0.929241202634,083-AAH,0.141643966136,102,319,421
9425,-0.645953270361,0.929241202634,083-AAI,0.141643966136,74,169,243
9426,-0.645953270361,0.929241202634,083-AAJ,0.141643966136,77,239,316
9427,-0.645953270361,0.929241202634,083-AAK,0.141643966136,39,267,306
9428,-0.645953270361,0.929241202634,083-AAL,0.141643966136,85,241,326
9429,-0.645953270361,0.929241202634,083-AAM,0.141643966136,64,314,378
9430,-0.645953270361,0.929241202634,083-AAN,0.141643966136,95,375,470
9431,-0.645953270361,0.929241202634,083-AAO,0.141643966136,98,318,416
9432,-0.645953270361,0.929241202634,083-AAP,0.141643966136,121,475,596
9433,-0.645953270361,0.929241202634,083-AAQ,0.141643966136,97,334,431
9434,-0.645953270361,0.929241202634,083-AAR,0.141643966136,76,255,331
9435,-0.645953270361,0.929241202634,083-AAS,0.141643966136,96,376,472
9436,-0.645953270361,0.929241202634,083-AAT,0.141643966136,127,535,662
9437,-0.645953270361,0.929241202634,083-AAU,0.141643966136,73,263,336
9438,-0.645953270361,0.929241202634,083-AAV,0.141643966136,95,271,366
9439,-0.645953270361,0.929241202634,083-AAW,0.141643966136,64,287,351
9440,-0.645953270361,0.929241202634,083-AAX,0.141643966136,46,182,228
9441,-0.645953270361,0.929241202634,083-AAY,0.141643966136,180,552,732
9442,-0.645953270361,0.929241202634,083-AAZ,0.141643966136,79,327,406
9443,-0.645953270361,0.929241202634,083-ABA,0.141643966136,112,419,531
9444,-0.645953270361,0.929241202634,083-ABB,0.141643966136,93,385,478
9445,-0.645953270361,0.929241202634,083-ABC,0.141643966136,53,212,265
9446,-0.645953270361,0.929241202634,083-ABD,0.141643966136,209,546,755
9447,-0.645953270361,0.929241202634,083-ABE,0.141643966136,82,320,402
9448,-0.645953270361,0.929241202634,083-ABF,0.141643966136,61,252,313
9449,-0.645953270361,0.929241202634,083-ABG,0.141643966136,90,385,475
9450,-0.645953270361,0.929241202634,083-ABH,0.141643966136,125,354,479
9451,-0.645953270361,0.929241202634,083-ABI,0.141643966136,136,385,521
9452,-0.645953270361,0.929241202634,083-ABJ,0.141643966136,181,697,878
9453,-0.645953270361,0.929241202634,083-ABK,0.141643966136,103,504,607
9454,-0.645953270361,0.929241202634,083-ABL,0.141643966136,76,409,485
9455,-0.645953270361,0.929241202634,083-ABM,0.141643966136,88,401,489
9456,-0.645953270361,0.929241202634,083-ABN,0.141643966136,65,414,479
9457,-0.645953270361,0.929241202634,083-ABO,0.141643966136,81,443,524
9458,-0.645953270361,0.929241202634,083-ABP,0.141643966136,53,338,391
9459,-0.645953270361,0.929241202634,083-ABQ,0.141643966136,139,511,650
9460,-0.645953270361,0.929241202634,083-ABR,0.141643966136,73,204,277
9461,-0.645953270361,0.929241202634,083-ABS,0.141643966136,73,347,420
9462,-0.645953270361,0.929241202634,083-ABT,0.141643966136,94,332,426
9463,-0.645953270361,0.929241202634,083-ABU,0.141643966136,102,370,472
9464,-0.645953270361,0.929241202634,083-ABV,0.141643966136,92,269,361
9465,-0.645953270361,0.929241202634,083-ABW,0.141643966136,95,307,402
9466,-0.645953270361,0.929241202634,083-ABX,0.141643966136,113,341,454
9467,-0.645953270361,0.929241202634,083-ABY,0.141643966136,93,254,347
9468,-0.645953270361,0.929241202634,083-ABZ,0.141643966136,99,328,427
9469,-0.645953270361,0.929241202634,083-ACA,0.141643966136,52,246,298
9470,-0.645953270361,0.929241202634,083-ACB,0.141643966136,73,183,256
9471,-0.645953270361,0.929241202634,083-ACC,0.141643966136,63,200,263
9472,-0.645953270361,0.929241202634,083-ACD,0.141643966136,115,355,470
9473,-0.645953270361,0.929241202634,083-ACE,0.141643966136,110,367,477
9474,-0.645953270361,0.929241202634,083-ACF,0.141643966136,106,386,492
9475,-0.645953270361,0.929241202634,083-ACG,0.141643966136,104,402,506
9476,-0.645953270361,0.929241202634,083-ACH,0.141643966136,132,424,556
9477,-0.645953270361,0.929241202634,083-ACI,0.141643966136,75,294,369
9478,-0.645953270361,0.929241202634,083-ACJ,0.141643966136,208,418,626
9479,-0.645953270361,0.929241202634,083-ACK,0.141643966136,98,407,505
9480,-0.645953270361,0.929241202634,083-ACL,0.141643966136,56,197,253
9481,-0.645953270361,0.929241202634,083-ACM,0.141643966136,90,228,318
9482,-0.645953270361,0.929241202634,083-ACN,0.141643966136,68,134,202
9483,-0.645953270361,0.929241202634,083-ACO,0.141643966136,52,170,222
9484,-0.645953270361,0.929241202634,083-ACP,0.141643966136,91,295,386
9485,-0.645953270361,0.929241202634,083-ACQ,0.141643966136,69,167,236
9486,-0.645953270361,0.929241202634,083-ACR,0.141643966136,62,163,225
9487,-0.645953270361,0.929241202634,083-ACS,0.141643966136,140,476,616
9488,-0.645953270361,0.929241202634,083-ACT,0.141643966136,67,197,264
9489,-0.645953270361,0.929241202634,083-ACU,0.141643966136,121,313,434
9490,-0.645953270361,0.929241202634,083-ACV,0.141643966136,98,181,279
9491,-0.645953270361,0.929241202634,083-ACW,0.141643966136,144,351,495
9492,-0.645953270361,0.929241202634,083-ACX,0.141643966136,59,200,259
9493,-0.645953270361,0.929241202634,083-ACY,0.141643966136,78,145,223
9494,-0.645953270361,0.929241202634,083-ACZ,0.141643966136,94,289,383
9495,-0.645953270361,0.929241202634,083-ADA,0.141643966136,59,146,205
9496,-0.645953270361,0.929241202634,083-ADB,0.141643966136,67,244,311
9497,-0.645953270361,0.929241202634,083-ADC,0.141643966136,121,419,540
9498,-0.645953270361,0.929241202634,083-ADD,0.141643966136,102,507,609
9499,-0.645953270361,0.929241202634,083-ADE,0.141643966136,79,318,397
9500,-0.645953270361,0.929241202634,083-ADF,0.141643966136,139,616,755
9501,-0.645953270361,0.929241202634,083-ADG,0.141643966136,153,701,854
9502,-0.645953270361,0.929241202634,083-ADH,0.141643966136,89,612,701
9503,-0.645953270361,0.929241202634,083-ADI,0.141643966136,110,575,685
9504,-0.645953270361,0.929241202634,083-ADJ,0.141643966136,170,588,758
9505,-0.645953270361,0.929241202634,083-ADK,0.141643966136,107,474,581
9506,-0.645953270361,0.929241202634,083-ADL,0.141643966136,77,389,466
9507,-0.645953270361,0.929241202634,083-ADM,0.141643966136,60,322,382
9508,-0.645953270361,0.929241202634,083-ADN,0.141643966136,69,306,375
9509,-0.645953270361,0.929241202634,083-ADO,0.141643966136,79,344,423
9510,-0.645953270361,0.929241202634,083-ADQ,0.141643966136,79,347,426
9511,-0.645953270361,0.929241202634,083-ADR,0.141643966136,80,262,342
9512,-0.645953270361,0.929241202634,083-ADS,0.141643966136,119,518,637
9513,-0.645953270361,0.929241202634,083-ADT,0.141643966136,116,433,549
9514,-0.645953270361,0.929241202634,083-ADU,0.141643966136,101,242,343
9515,-0.645953270361,0.929241202634,083-ADW,0.141643966136,79,468,547
9516,-0.645953270361,0.929241202634,083-ADX,0.141643966136,56,347,403
9517,-0.645953270361,0.929241202634,083-ADY,0.141643966136,47,366,413
9518,-0.645953270361,0.929241202634,083-ADZ,0.141643966136,59,358,417
9519,-0.645953270361,0.929241202634,083-AEA,0.141643966136,114,517,631
9520,-0.645953270361,0.929241202634,083-AEB,0.141643966136,62,483,545
9521,-0.645953270361,0.929241202634,083-AEC,0.141643966136,113,376,489
9522,-0.645953270361,0.929241202634,083-AED,0.141643966136,43,250,293
9523,-0.645953270361,0.929241202634,083-AEE,0.141643966136,110,276,386
9524,-0.645953270361,0.929241202634,083-AEF,0.141643966136,82,402,484
9525,-0.645953270361,0.929241202634,083-AEG,0.141643966136,47,124,171
9526,-0.645953270361,0.929241202634,083-AEH,0.141643966136,63,215,278
9527,-0.645953270361,0.929241202634,083-AEI,0.141643966136,122,521,643
9528,-0.645953270361,0.929241202634,083-AEJ,0.141643966136,88,368,456
9529,-0.645953270361,0.929241202634,083-AEK,0.141643966136,77,543,620
9530,-0.645953270361,0.929241202634,083-AEL,0.141643966136,101,396,497
9531,-0.645953270361,0.929241202634,083-AEM,0.141643966136,77,493,570
9532,-0.645953270361,0.929241202634,083-AEN,0.141643966136,90,454,544
9533,-0.645953270361,0.929241202634,083-AEO,0.141643966136,80,360,440
9534,-0.645953270361,0.929241202634,083-AEP,0.141643966136,123,517,640
9535,-0.645953270361,0.929241202634,083-AEQ,0.141643966136,108,365,473
9536,-0.645953270361,0.929241202634,083-AER,0.141643966136,103,406,509
9537,-0.645953270361,0.929241202634,083-AES,0.141643966136,82,271,353
9538,-0.645953270361,0.929241202634,083-AET,0.141643966136,99,459,558
9539,-0.645953270361,0.929241202634,083-AEU,0.141643966136,111,238,349
9540,-0.645953270361,0.929241202634,083-AEV,0.141643966136,92,432,524
9541,-0.645953270361,0.929241202634,083-AEW,0.141643966136,72,199,271
9542,-0.645953270361,0.929241202634,083-AEX,0.141643966136,136,484,620
9543,-0.645953270361,0.929241202634,083-AEY,0.141643966136,60,228,288
9544,-0.645953270361,0.929241202634,083-AEZ,0.141643966136,74,207,281
9545,-0.645953270361,0.929241202634,083-AFA,0.141643966136,87,290,377
9546,-0.645953270361,0.929241202634,083-AFB,0.141643966136,131,447,578
9547,-0.645953270361,0.929241202634,083-AFC,0.141643966136,83,229,312
9548,-0.645953270361,0.929241202634,083-AFD,0.141643966136,71,205,276
9549,-0.645953270361,0.929241202634,083-AFE,0.141643966136,107,290,397
9550,-0.645953270361,0.929241202634,083-AFF,0.141643966136,83,364,447
9551,-0.645953270361,0.929241202634,083-AFG,0.141643966136,106,391,497
9552,-0.645953270361,0.929241202634,083-AFH,0.141643966136,74,168,242
9553,-0.645953270361,0.929241202634,083-AFI,0.141643966136,62,259,321
9554,-0.645953270361,0.929241202634,083-AFJ,0.141643966136,88,388,476
9555,-0.645953270361,0.929241202634,083-AFK,0.141643966136,98,549,647
9556,-0.645953270361,0.929241202634,083-AFL,0.141643966136,140,516,656
9557,-0.645953270361,0.929241202634,083-AFM,0.141643966136,76,189,265
9558,-0.645953270361,0.929241202634,083-AFN,0.141643966136,126,474,600
9559,-0.645953270361,0.929241202634,083-AFO,0.141643966136,90,225,315
9560,-0.645953270361,0.929241202634,083-AFP,0.141643966136,113,463,576
9561,-0.645953270361,0.929241202634,083-AFQ,0.141643966136,199,612,811
9562,-0.645953270361,0.929241202634,083-AFR,0.141643966136,112,458,570
9563,-0.645953270361,0.929241202634,083-AFS,0.141643966136,152,482,634
9564,-0.645953270361,0.929241202634,083-AFT,0.141643966136,157,391,548
9565,-0.645953270361,0.929241202634,083-AFU,0.141643966136,147,425,572
9566,-0.645953270361,0.929241202634,083-AFV,0.141643966136,104,455,559
9567,-0.645953270361,0.929241202634,083-AFW,0.141643966136,46,265,311
9568,-0.645953270361,0.929241202634,083-AFX,0.141643966136,126,457,583
9569,-0.645953270361,0.929241202634,083-AFY,0.141643966136,109,478,587
9570,-0.645953270361,0.929241202634,083-AFZ,0.141643966136,65,311,376
9571,-0.645953270361,0.929241202634,083-AGA,0.141643966136,148,544,692
9572,-0.645953270361,0.929241202634,083-AGB,0.141643966136,95,349,444
9573,-0.645953270361,0.929241202634,083-AGC,0.141643966136,98,342,440
9574,-0.645953270361,0.929241202634,083-AGD,0.141643966136,128,357,485
9575,-0.645953270361,0.929241202634,083-AGE,0.141643966136,142,414,556
9576,-0.645953270361,0.929241202634,083-AGF,0.141643966136,131,621,752
9577,-0.645953270361,0.929241202634,083-AGG,0.141643966136,121,434,555
9578,-0.645953270361,0.929241202634,083-AGH,0.141643966136,142,492,634
9579,-0.645953270361,0.929241202634,083-AGI,0.141643966136,87,467,554
9580,-0.645953270361,0.929241202634,083-AGJ,0.141643966136,124,489,613
9581,-0.645953270361,0.929241202634,083-AGK,0.141643966136,121,493,614
9582,-0.645953270361,0.929241202634,083-AGL,0.141643966136,65,405,470
9583,-0.645953270361,0.929241202634,083-AGM,0.141643966136,52,366,418
9584,-0.645953270361,0.929241202634,083-AGN,0.141643966136,52,203,255
9585,-0.645953270361,0.929241202634,083-AGO,0.141643966136,147,442,589
9586,-0.645953270361,0.929241202634,083-AGP,0.141643966136,66,343,409
9587,-0.645953270361,0.929241202634,084-AAA,0.141643966136,124,259,383
9588,-0.645953270361,0.929241202634,084-AAC,0.141643966136,154,241,395
9589,-0.645953270361,0.929241202634,084-AAE,0.141643966136,195,383,578
9590,-0.645953270361,0.929241202634,084-AAG,0.141643966136,74,201,275
9591,-0.645953270361,0.929241202634,084-AAH,0.141643966136,87,219,306
9592,-0.645953270361,0.929241202634,084-AAI,0.141643966136,168,154,322
9593,-0.645953270361,0.929241202634,084-AAJ,0.141643966136,241,306,547
9594,-0.645953270361,0.929241202634,084-AAN,0.141643966136,206,266,472
9595,-0.645953270361,0.929241202634,084-AAO,0.141643966136,204,227,431
9596,-0.645953270361,0.929241202634,084-AAS,0.141643966136,195,283,478
9597,-0.645953270361,0.929241202634,084-AAT,0.141643966136,186,174,360
9598,-0.645953270361,0.929241202634,084-AAU,0.141643966136,134,135,269
9599,-0.645953270361,0.929241202634,084-AAY,0.141643966136,178,143,321
9600,-0.645953270361,0.929241202634,084-AAZ,0.141643966136,213,322,535
9601,-0.645953270361,0.929241202634,084-ABA,0.141643966136,92,109,201
9602,-0.645953270361,0.929241202634,084-ABE,0.141643966136,144,257,401
9603,-0.645953270361,0.929241202634,084-ABF,0.141643966136,81,113,194
9604,-0.645953270361,0.929241202634,084-ABG,0.141643966136,36,53,89
9605,-0.645953270361,0.929241202634,084-ABI,0.141643966136,120,254,374
9606,-0.645953270361,0.929241202634,084-ABJ,0.141643966136,87,209,296
9607,-0.645953270361,0.929241202634,084-ABK,0.141643966136,109,290,399
9608,-0.645953270361,0.929241202634,084-ABL,0.141643966136,80,186,266
9609,-0.645953270361,0.929241202634,084-ABM,0.141643966136,131,302,433
9610,-0.645953270361,0.929241202634,084-ABN,0.141643966136,145,293,438
9611,-0.645953270361,0.929241202634,084-ABP,0.141643966136,144,303,447
9612,-0.645953270361,0.929241202634,084-ABQ,0.141643966136,135,267,402
9613,-0.645953270361,0.929241202634,084-ABR,0.141643966136,111,236,347
9614,-0.645953270361,0.929241202634,084-ABS,0.141643966136,121,213,334
9615,-0.645953270361,0.929241202634,084-ABT,0.141643966136,145,136,281
9616,-0.645953270361,0.929241202634,084-ABU,0.141643966136,108,103,211
9617,-0.645953270361,0.929241202634,084-ABV,0.141643966136,33,51,84
9618,-0.645953270361,0.929241202634,084-ABW,0.141643966136,86,196,282
9619,-0.645953270361,0.929241202634,084-ABX,0.141643966136,76,86,162
9620,-0.645953270361,0.929241202634,084-ABY,0.141643966136,51,83,134
9621,-0.645953270361,0.929241202634,084-ABZ,0.141643966136,128,182,310
9622,-0.645953270361,0.929241202634,084-ACA,0.141643966136,121,229,350
9623,-0.645953270361,0.929241202634,084-ACB,0.141643966136,130,204,334
9624,-0.645953270361,0.929241202634,084-ACC,0.141643966136,178,329,507
9625,-0.645953270361,0.929241202634,084-ACD,0.141643966136,13,7,20
9626,-0.645953270361,0.929241202634,084-ACE,0.141643966136,202,347,549
9627,-0.645953270361,0.929241202634,084-ACF,0.141643966136,157,266,423
9628,-0.645953270361,0.929241202634,084-ACG,0.141643966136,162,304,466
9629,-0.645953270361,0.929241202634,084-ACJ,0.141643966136,139,155,294
9630,-0.645953270361,0.929241202634,084-ACL,0.141643966136,115,205,320
9631,-0.645953270361,0.929241202634,084-ACM,0.141643966136,87,125,212
9632,-0.645953270361,0.929241202634,084-ACN,0.141643966136,141,211,352
9633,-0.645953270361,0.929241202634,084-ACO,0.141643966136,153,264,417
9634,-0.645953270361,0.929241202634,084-ACP,0.141643966136,182,296,478
9635,-0.645953270361,0.929241202634,084-ACR,0.141643966136,196,341,537
9636,-0.645953270361,0.929241202634,084-ACS,0.141643966136,76,167,243
9637,-0.645953270361,0.929241202634,084-ACU,0.141643966136,137,266,403
9638,-0.645953270361,0.929241202634,084-ACW,0.141643966136,226,318,544
9639,-0.645953270361,0.929241202634,084-ACY,0.141643966136,133,133,266
9640,-0.645953270361,0.929241202634,084-ACZ,0.141643966136,165,475,640
9641,-0.645953270361,0.929241202634,084-ADC,0.141643966136,186,373,559
9642,-0.645953270361,0.929241202634,084-ADE,0.141643966136,151,262,413
9643,-0.645953270361,0.929241202634,085-AAA,0.141643966136,77,101,178
9644,-0.645953270361,0.929241202634,085-AAB,0.141643966136,87,228,315
9645,-0.645953270361,0.929241202634,085-AAC,0.141643966136,129,240,369
9646,-0.645953270361,0.929241202634,085-AAE,0.141643966136,114,244,358
9647,-0.645953270361,0.929241202634,085-AAF,0.141643966136,64,226,290
9648,-0.645953270361,0.929241202634,085-AAG,0.141643966136,79,306,385
9649,-0.645953270361,0.929241202634,085-AAH,0.141643966136,122,244,366
9650,-0.645953270361,0.929241202634,085-AAJ,0.141643966136,100,158,258
9651,-0.645953270361,0.929241202634,085-AAK,0.141643966136,131,207,338
9652,-0.645953270361,0.929241202634,085-AAL,0.141643966136,53,146,199
9653,-0.645953270361,0.929241202634,085-AAM,0.141643966136,133,298,431
9654,-0.645953270361,0.929241202634,085-AAN,0.141643966136,123,173,296
9655,-0.645953270361,0.929241202634,085-AAO,0.141643966136,91,95,186
9656,-0.645953270361,0.929241202634,085-AAP,0.141643966136,107,178,285
9657,-0.645953270361,0.929241202634,085-AAQ,0.141643966136,94,104,198
9658,-0.645953270361,0.929241202634,085-AAR,0.141643966136,76,72,148
9659,-0.645953270361,0.929241202634,085-AAS,0.141643966136,99,103,202
9660,-0.645953270361,0.929241202634,085-AAU,0.141643966136,237,455,692
9661,-0.645953270361,0.929241202634,085-AAV,0.141643966136,155,92,247
9662,-0.645953270361,0.929241202634,085-AAW,0.141643966136,161,194,355
9663,-0.645953270361,0.929241202634,085-AAX,0.141643966136,161,153,314
9664,-0.645953270361,0.929241202634,085-AAZ,0.141643966136,201,370,571
9665,-0.645953270361,0.929241202634,085-ABA,0.141643966136,167,295,462
9666,-0.645953270361,0.929241202634,085-ABB,0.141643966136,245,492,737
9667,-0.645953270361,0.929241202634,085-ABC,0.141643966136,138,229,367
9668,-0.645953270361,0.929241202634,085-ABD,0.141643966136,221,342,563
9669,-0.645953270361,0.929241202634,085-ABH,0.141643966136,114,209,323
9670,-0.645953270361,0.929241202634,085-ABI,0.141643966136,198,172,370
9671,-0.645953270361,0.929241202634,085-ABJ,0.141643966136,205,373,578
9672,-0.645953270361,0.929241202634,085-ABM,0.141643966136,252,384,636
9673,-0.645953270361,0.929241202634,085-ABN,0.141643966136,308,503,811
9674,-0.645953270361,0.929241202634,085-ABP,0.141643966136,129,397,526
9675,-0.645953270361,0.929241202634,085-ABQ,0.141643966136,146,401,547
9676,-0.645953270361,0.929241202634,085-ABS,0.141643966136,64,245,309
9677,-0.645953270361,0.929241202634,085-ABT,0.141643966136,92,276,368
9678,-0.645953270361,0.929241202634,085-ABU,0.141643966136,58,147,205
9679,-0.645953270361,0.929241202634,085-ABV,0.141643966136,96,257,353
9680,-0.645953270361,0.929241202634,085-ABW,0.141643966136,62,127,189
9681,-0.645953270361,0.929241202634,085-ABX,0.141643966136,91,307,398
9682,-0.645953270361,0.929241202634,085-ABY,0.141643966136,64,203,267
9683,-0.645953270361,0.929241202634,085-ABZ,0.141643966136,62,276,338
9684,-0.645953270361,0.929241202634,085-ACA,0.141643966136,163,305,468
9685,-0.645953270361,0.929241202634,085-ACB,0.141643966136,170,313,483
9686,-0.645953270361,0.929241202634,085-ACC,0.141643966136,142,243,385
9687,-0.645953270361,0.929241202634,085-ACD,0.141643966136,99,139,238
9688,-0.645953270361,0.929241202634,085-ACE,0.141643966136,140,240,380
9689,-0.645953270361,0.929241202634,085-ACF,0.141643966136,220,425,645
9690,-0.645953270361,0.929241202634,085-ACH,0.141643966136,232,377,609
9691,-0.645953270361,0.929241202634,085-ACI,0.141643966136,151,384,535
9692,-0.645953270361,0.929241202634,085-ACJ,0.141643966136,81,224,305
9693,-0.645953270361,0.929241202634,085-ACK,0.141643966136,54,210,264
9694,-0.645953270361,0.929241202634,085-ACM,0.141643966136,117,255,372
9695,-0.645953270361,0.929241202634,085-ACN,0.141643966136,111,195,306
9696,-0.645953270361,0.929241202634,085-ACO,0.141643966136,131,420,551
9697,-0.645953270361,0.929241202634,085-ACP,0.141643966136,75,288,363
9698,-0.645953270361,0.929241202634,085-ACQ,0.141643966136,132,419,551
9699,-0.645953270361,0.929241202634,085-ACR,0.141643966136,57,204,261
9700,-0.645953270361,0.929241202634,085-ACS,0.141643966136,159,406,565
9701,-0.645953270361,0.929241202634,085-ACT,0.141643966136,120,324,444
9702,-0.645953270361,0.929241202634,085-ACU,0.141643966136,125,497,622
9703,-0.645953270361,0.929241202634,085-ACV,0.141643966136,140,453,593
9704,-0.645953270361,0.929241202634,085-ACW,0.141643966136,89,279,368
9705,-0.645953270361,0.929241202634,085-ACX,0.141643966136,82,268,350
9706,-0.645953270361,0.929241202634,085-ACY,0.141643966136,93,409,502
9707,-0.645953270361,0.929241202634,085-ACZ,0.141643966136,91,397,488
9708,-0.645953270361,0.929241202634,085-ADB,0.141643966136,52,314,366
9709,-0.645953270361,0.929241202634,085-ADC,0.141643966136,57,354,411
9710,-0.645953270361,0.929241202634,085-ADD,0.141643966136,86,191,277
9711,-0.645953270361,0.929241202634,085-ADE,0.141643966136,55,379,434
9712,-0.645953270361,0.929241202634,085-ADF,0.141643966136,122,425,547
9713,-0.645953270361,0.929241202634,085-ADG,0.141643966136,132,400,532
9714,-0.645953270361,0.929241202634,085-ADH,0.141643966136,101,359,460
9715,-0.645953270361,0.929241202634,085-ADI,0.141643966136,75,471,546
9716,-0.645953270361,0.929241202634,085-ADJ,0.141643966136,99,362,461
9717,-0.645953270361,0.929241202634,085-ADK,0.141643966136,86,474,560
9718,-0.645953270361,0.929241202634,085-ADM,0.141643966136,190,518,708
9719,-0.645953270361,0.929241202634,085-ADN,0.141643966136,98,243,341
9720,-0.645953270361,0.929241202634,085-ADO,0.141643966136,74,253,327
9721,-0.645953270361,0.929241202634,085-ADP,0.141643966136,132,267,399
9722,-0.645953270361,0.929241202634,085-ADQ,0.141643966136,102,392,494
9723,-0.645953270361,0.929241202634,085-ADR,0.141643966136,88,184,272
9724,-0.645953270361,0.929241202634,085-ADS,0.141643966136,62,112,174
9725,-0.645953270361,0.929241202634,085-ADT,0.141643966136,166,507,673
9726,-0.645953270361,0.929241202634,085-ADU,0.141643966136,63,189,252
9727,-0.645953270361,0.929241202634,085-ADV,0.141643966136,77,241,318
9728,-0.645953270361,0.929241202634,086-AAA,0.141643966136,155,239,394
9729,-0.645953270361,0.929241202634,086-AAC,0.141643966136,141,280,421
9730,-0.645953270361,0.929241202634,086-AAF,0.141643966136,89,187,276
9731,-0.645953270361,0.929241202634,086-AAG,0.141643966136,199,483,682
9732,-0.645953270361,0.929241202634,086-AAI,0.141643966136,143,240,383
9733,-0.645953270361,0.929241202634,086-AAJ,0.141643966136,80,160,240
9734,-0.645953270361,0.929241202634,086-AAK,0.141643966136,70,260,330
9735,-0.645953270361,0.929241202634,086-AAL,0.141643966136,129,328,457
9736,-0.645953270361,0.929241202634,086-AAN,0.141643966136,142,344,486
9737,-0.645953270361,0.929241202634,086-AAP,0.141643966136,181,479,660
9738,-0.645953270361,0.929241202634,086-AAR,0.141643966136,153,276,429
9739,-0.645953270361,0.929241202634,086-AAU,0.141643966136,244,492,736
9740,-0.645953270361,0.929241202634,086-AAV,0.141643966136,158,550,708
9741,-0.645953270361,0.929241202634,086-AAX,0.141643966136,65,228,293
9742,-0.645953270361,0.929241202634,086-AAY,0.141643966136,106,308,414
9743,-0.645953270361,0.929241202634,086-ABA,0.141643966136,51,194,245
9744,-0.645953270361,0.929241202634,086-ABB,0.141643966136,130,242,372
9745,-0.645953270361,0.929241202634,086-ABC,0.141643966136,144,339,483
9746,-0.645953270361,0.929241202634,086-ABE,0.141643966136,64,214,278
9747,-0.645953270361,0.929241202634,086-ABF,0.141643966136,96,212,308
9748,-0.645953270361,0.929241202634,086-ABG,0.141643966136,176,362,538
9749,-0.645953270361,0.929241202634,086-ABI,0.141643966136,109,361,470
9750,-0.645953270361,0.929241202634,086-ABJ,0.141643966136,114,269,383
9751,-0.645953270361,0.929241202634,086-ABM,0.141643966136,133,377,510
9752,-0.645953270361,0.929241202634,086-ABN,0.141643966136,138,276,414
9753,-0.645953270361,0.929241202634,086-ABP,0.141643966136,200,382,582
9754,-0.645953270361,0.929241202634,086-ZZZ,0.141643966136,3410,8082,11492
9755,-0.645953270361,0.929241202634,087-AAA,0.141643966136,124,108,232
9756,-0.645953270361,0.929241202634,087-AAB,0.141643966136,163,98,261
9757,-0.645953270361,0.929241202634,087-AAC,0.141643966136,159,73,232
9758,-0.645953270361,0.929241202634,087-AAF,0.141643966136,195,111,306
9759,-0.645953270361,0.929241202634,087-AAG,0.141643966136,147,117,264
9760,-0.645953270361,0.929241202634,087-AAH,0.141643966136,192,136,328
9761,-0.645953270361,0.929241202634,087-AAI,0.141643966136,144,124,268
9762,-0.645953270361,0.929241202634,087-AAK,0.141643966136,271,285,556
9763,-0.645953270361,0.929241202634,087-AAL,0.141643966136,398,573,971
9764,-0.645953270361,0.929241202634,087-AAM,0.141643966136,284,226,510
9765,-0.645953270361,0.929241202634,087-AAN,0.141643966136,313,451,764
9766,-0.645953270361,0.929241202634,087-AAO,0.141643966136,257,199,456
9767,-0.645953270361,0.929241202634,087-AAP,0.141643966136,215,263,478
9768,-0.645953270361,0.929241202634,087-AAQ,0.141643966136,147,307,454
9769,-0.645953270361,0.929241202634,087-AAR,0.141643966136,288,363,651
9770,-0.645953270361,0.929241202634,087-AAS,0.141643966136,210,339,549
9771,-0.645953270361,0.929241202634,087-AAT,0.141643966136,130,137,267
9772,-0.645953270361,0.929241202634,087-AAU,0.141643966136,147,261,408
9773,-0.645953270361,0.929241202634,087-AAV,0.141643966136,144,210,354
9774,-0.645953270361,0.929241202634,087-AAW,0.141643966136,196,290,486
9775,-0.645953270361,0.929241202634,087-AAX,0.141643966136,212,318,530
9776,-0.645953270361,0.929241202634,087-AAY,0.141643966136,232,363,595
9777,-0.645953270361,0.929241202634,087-AAZ,0.141643966136,285,485,770
9778,-0.645953270361,0.929241202634,087-ABA,0.141643966136,145,421,566
9779,-0.645953270361,0.929241202634,087-ABB,0.141643966136,144,248,392
9780,-0.645953270361,0.929241202634,087-ABC,0.141643966136,154,273,427
9781,-0.645953270361,0.929241202634,087-ABD,0.141643966136,178,358,536
9782,-0.645953270361,0.929241202634,087-ABE,0.141643966136,114,199,313
9783,-0.645953270361,0.929241202634,087-ABF,0.141643966136,149,310,459
9784,-0.645953270361,0.929241202634,087-ABG,0.141643966136,122,354,476
9785,-0.645953270361,0.929241202634,087-ABH,0.141643966136,160,497,657
9786,-0.645953270361,0.929241202634,087-ABI,0.141643966136,317,215,532
9787,-0.645953270361,0.929241202634,087-ABJ,0.141643966136,273,341,614
9788,-0.645953270361,0.929241202634,087-ABK,0.141643966136,235,186,421
9789,-0.645953270361,0.929241202634,087-ABL,0.141643966136,281,253,534
9790,-0.645953270361,0.929241202634,087-ABM,0.141643966136,206,274,480
9791,-0.645953270361,0.929241202634,087-ABN,0.141643966136,101,254,355
9792,-0.645953270361,0.929241202634,087-ABO,0.141643966136,72,110,182
9793,-0.645953270361,0.929241202634,087-ABP,0.141643966136,62,93,155
9794,-0.645953270361,0.929241202634,087-ABQ,0.141643966136,40,85,125
9795,-0.645953270361,0.929241202634,087-ABR,0.141643966136,131,373,504
9796,-0.645953270361,0.929241202634,087-ABS,0.141643966136,116,437,553
9797,-0.645953270361,0.929241202634,087-ABT,0.141643966136,171,299,470
9798,-0.645953270361,0.929241202634,087-ABU,0.141643966136,119,176,295
9799,-0.645953270361,0.929241202634,087-ABV,0.141643966136,105,165,270
9800,-0.645953270361,0.929241202634,087-ABW,0.141643966136,58,172,230
9801,-0.645953270361,0.929241202634,087-ABX,0.141643966136,123,258,381
9802,-0.645953270361,0.929241202634,087-ABY,0.141643966136,195,340,535
9803,-0.645953270361,0.929241202634,087-ABZ,0.141643966136,70,166,236
9804,-0.645953270361,0.929241202634,087-ACA,0.141643966136,219,303,522
9805,-0.645953270361,0.929241202634,087-ACB,0.141643966136,293,410,703
9806,-0.645953270361,0.929241202634,087-ACC,0.141643966136,195,205,400
9807,-0.645953270361,0.929241202634,087-ACE,0.141643966136,159,184,343
9808,-0.645953270361,0.929241202634,087-ACG,0.141643966136,286,302,588
9809,-0.645953270361,0.929241202634,087-ACJ,0.141643966136,266,250,516
9810,-0.645953270361,0.929241202634,087-ACK,0.141643966136,230,229,459
9811,-0.645953270361,0.929241202634,087-ACL,0.141643966136,187,335,522
9812,-0.645953270361,0.929241202634,087-ACN,0.141643966136,89,197,286
9813,-0.645953270361,0.929241202634,087-ACO,0.141643966136,150,264,414
9814,-0.645953270361,0.929241202634,087-ACP,0.141643966136,178,529,707
9815,-0.645953270361,0.929241202634,087-ACQ,0.141643966136,100,233,333
9816,-0.645953270361,0.929241202634,087-ACR,0.141643966136,72,99,171
9817,-0.645953270361,0.929241202634,087-ACS,0.141643966136,66,93,159
9818,-0.645953270361,0.929241202634,087-ACT,0.141643966136,110,153,263
9819,-0.645953270361,0.929241202634,087-ACU,0.141643966136,221,371,592
9820,-0.645953270361,0.929241202634,087-ACW,0.141643966136,77,78,155
9821,-0.645953270361,0.929241202634,087-ACX,0.141643966136,82,160,242
9822,-0.645953270361,0.929241202634,087-ACY,0.141643966136,87,183,270
9823,-0.645953270361,0.929241202634,087-ACZ,0.141643966136,130,222,352
9824,-0.645953270361,0.929241202634,087-ADA,0.141643966136,152,338,490
9825,-0.645953270361,0.929241202634,087-ADB,0.141643966136,95,90,185
9826,-0.645953270361,0.929241202634,087-ADC,0.141643966136,168,385,553
9827,-0.645953270361,0.929241202634,087-ADD,0.141643966136,119,233,352
9828,-0.645953270361,0.929241202634,087-ADE,0.141643966136,267,392,659
9829,-0.645953270361,0.929241202634,087-ADF,0.141643966136,108,307,415
9830,-0.645953270361,0.929241202634,087-ADG,0.141643966136,285,519,804
9831,-0.645953270361,0.929241202634,087-ADI,0.141643966136,181,335,516
9832,-0.645953270361,0.929241202634,087-ADJ,0.141643966136,130,117,247
9833,-0.645953270361,0.929241202634,087-ADL,0.141643966136,210,442,652
9834,-0.645953270361,0.929241202634,087-ADM,0.141643966136,112,307,419
9835,-0.645953270361,0.929241202634,087-ADN,0.141643966136,54,85,139
9836,-0.645953270361,0.929241202634,087-ADO,0.141643966136,103,221,324
9837,-0.645953270361,0.929241202634,087-ADP,0.141643966136,172,261,433
9838,-0.645953270361,0.929241202634,087-ADQ,0.141643966136,229,381,610
9839,-0.645953270361,0.929241202634,087-ADR,0.141643966136,38,76,114
9840,-0.645953270361,0.929241202634,087-ADS,0.141643966136,204,432,636
9841,-0.645953270361,0.929241202634,087-ADT,0.141643966136,132,398,530
9842,-0.645953270361,0.929241202634,087-ADU,0.141643966136,162,211,373
9843,-0.645953270361,0.929241202634,087-ADV,0.141643966136,84,155,239
9844,-0.645953270361,0.929241202634,087-ADW,0.141643966136,234,264,498
9845,-0.645953270361,0.929241202634,087-ADX,0.141643966136,266,318,584
9846,-0.645953270361,0.929241202634,087-ADZ,0.141643966136,244,230,474
9847,-0.645953270361,0.929241202634,087-AEB,0.141643966136,184,88,272
9848,-0.645953270361,0.929241202634,087-AEC,0.141643966136,86,44,130
9849,-0.645953270361,0.929241202634,087-AED,0.141643966136,186,79,265
9850,-0.645953270361,0.929241202634,087-AEE,0.141643966136,122,272,394
9851,-0.645953270361,0.929241202634,087-AEF,0.141643966136,103,437,540
9852,-0.645953270361,0.929241202634,088-AAA,0.141643966136,87,277,364
9853,-0.645953270361,0.929241202634,088-AAB,0.141643966136,70,168,238
9854,-0.645953270361,0.929241202634,088-AAD,0.141643966136,83,183,266
9855,-0.645953270361,0.929241202634,088-AAF,0.141643966136,103,293,396
9856,-0.645953270361,0.929241202634,088-AAG,0.141643966136,84,210,294
9857,-0.645953270361,0.929241202634,088-AAJ,0.141643966136,90,220,310
9858,-0.645953270361,0.929241202634,088-AAK,0.141643966136,49,141,190
9859,-0.645953270361,0.929241202634,088-AAM,0.141643966136,56,213,269
9860,-0.645953270361,0.929241202634,088-AAO,0.141643966136,56,287,343
9861,-0.645953270361,0.929241202634,088-AAQ,0.141643966136,110,180,290
9862,-0.645953270361,0.929241202634,088-AAS,0.141643966136,140,206,346
9863,-0.645953270361,0.929241202634,088-AAT,0.141643966136,125,194,319
9864,-0.645953270361,0.929241202634,088-AAV,0.141643966136,97,255,352
9865,-0.645953270361,0.929241202634,088-AAX,0.141643966136,55,222,277
9866,-0.645953270361,0.929241202634,088-AAY,0.141643966136,42,154,196
9867,-0.645953270361,0.929241202634,088-ABA,0.141643966136,38,81,119
9868,-0.645953270361,0.929241202634,088-ABC,0.141643966136,47,184,231
9869,-0.645953270361,0.929241202634,088-ABE,0.141643966136,79,291,370
9870,-0.645953270361,0.929241202634,088-ABF,0.141643966136,47,258,305
9871,-0.645953270361,0.929241202634,088-ABH,0.141643966136,45,158,203
9872,-0.645953270361,0.929241202634,088-ABI,0.141643966136,79,219,298
9873,-0.645953270361,0.929241202634,088-ABJ,0.141643966136,103,169,272
9874,-0.645953270361,0.929241202634,088-ABL,0.141643966136,58,168,226
9875,-0.645953270361,0.929241202634,088-ABM,0.141643966136,93,253,346
