,cf_score_0,cf_score_1,geoid,midpoint,num_votes_0,num_votes_1,tot_votes
0,-1.350869376,0.68018326,001-AAW,-0.335343058,277,186,463
1,-1.350869376,0.68018326,001-AAX,-0.335343058,163,123,286
2,-1.350869376,0.68018326,001-AAA,-0.335343058,434,188,622
3,-1.350869376,0.68018326,001-AAB,-0.335343058,136,60,196
4,-1.350869376,0.68018326,001-ABE,-0.335343058,25,35,60
5,-1.350869376,0.68018326,001-AAG,-0.335343058,70,60,130
6,-1.350869376,0.68018326,001-AAE,-0.335343058,114,97,211
7,-1.350869376,0.68018326,001-AAN,-0.335343058,411,202,613
8,-1.350869376,0.68018326,001-ABI,-0.335343058,212,132,344
9,-1.350869376,0.68018326,001-AAI,-0.335343058,302,164,466
10,-1.350869376,0.68018326,001-AAD,-0.335343058,344,184,528
11,-1.350869376,0.68018326,001-AAC,-0.335343058,161,128,289
12,-1.350869376,0.68018326,001-AAK,-0.335343058,81,119,200
13,-1.350869376,0.68018326,001-AAL,-0.335343058,125,98,223
14,-1.350869376,0.68018326,001-AAM,-0.335343058,145,127,272
15,-1.350869376,0.68018326,001-AAJ,-0.335343058,19,18,37
16,-1.350869376,0.68018326,001-AAO,-0.335343058,161,56,217
17,-1.350869376,0.68018326,001-AAR,-0.335343058,152,137,289
18,-1.350869376,0.68018326,001-AAS,-0.335343058,267,141,408
19,-1.350869376,0.68018326,001-AAP,-0.335343058,209,111,320
20,-1.350869376,0.68018326,001-AAQ,-0.335343058,193,114,307
21,-1.350869376,0.68018326,001-AAF,-0.335343058,6,46,52
22,-1.350869376,0.68018326,001-AAT,-0.335343058,134,45,179
23,-1.350869376,0.68018326,001-AAU,-0.335343058,250,144,394
24,-1.350869376,0.68018326,001-AAY,-0.335343058,320,186,506
25,-1.350869376,0.68018326,001-AAZ,-0.335343058,301,207,508
26,-1.350869376,0.68018326,001-AAV,-0.335343058,243,85,328
27,-1.350869376,0.68018326,001-AAH,-0.335343058,118,80,198
28,-1.350869376,0.68018326,001-ABF,-0.335343058,362,156,518
29,-1.350869376,0.68018326,001-ABA,-0.335343058,161,128,289
30,-1.350869376,0.68018326,001-ABB,-0.335343058,107,123,230
31,-1.350869376,0.68018326,001-ABC,-0.335343058,131,121,252
32,-1.350869376,0.68018326,001-ABD,-0.335343058,135,101,236
33,-1.350869376,0.68018326,001-ABG,-0.335343058,286,120,406
34,-1.350869376,0.68018326,001-ABH,-0.335343058,359,148,507
35,-1.350869376,0.68018326,002-ACT,-0.335343058,546,209,755
36,-1.350869376,0.68018326,002-ACU,-0.335343058,323,91,414
37,-1.350869376,0.68018326,002-ACW,-0.335343058,225,138,363
38,-1.350869376,0.68018326,002-ACX,-0.335343058,133,127,260
39,-1.350869376,0.68018326,002-ACY,-0.335343058,154,117,271
40,-1.350869376,0.68018326,002-ACZ,-0.335343058,98,48,146
41,-1.350869376,0.68018326,002-ADA,-0.335343058,274,69,343
42,-1.350869376,0.68018326,002-ADB,-0.335343058,234,224,458
43,-1.350869376,0.68018326,002-ADC,-0.335343058,103,121,224
44,-1.350869376,0.68018326,002-ADD,-0.335343058,282,182,464
45,-1.350869376,0.68018326,002-ADE,-0.335343058,311,171,482
46,-1.350869376,0.68018326,002-ADF,-0.335343058,168,130,298
47,-1.350869376,0.68018326,002-ADG,-0.335343058,638,229,867
48,-1.350869376,0.68018326,002-ADI,-0.335343058,474,199,673
49,-1.350869376,0.68018326,002-ADJ,-0.335343058,352,146,498
50,-1.350869376,0.68018326,002-ADK,-0.335343058,128,127,255
51,-1.350869376,0.68018326,002-ADL,-0.335343058,267,83,350
52,-1.350869376,0.68018326,002-ADO,-0.335343058,224,99,323
53,-1.350869376,0.68018326,002-ADP,-0.335343058,198,131,329
54,-1.350869376,0.68018326,002-ADT,-0.335343058,375,142,517
55,-1.350869376,0.68018326,002-ADW,-0.335343058,487,221,708
56,-1.350869376,0.68018326,002-ADY,-0.335343058,254,116,370
57,-1.350869376,0.68018326,002-ADZ,-0.335343058,213,147,360
58,-1.350869376,0.68018326,002-AEA,-0.335343058,220,125,345
59,-1.350869376,0.68018326,002-AEB,-0.335343058,165,96,261
60,-1.350869376,0.68018326,002-AEC,-0.335343058,354,203,557
61,-1.350869376,0.68018326,002-AED,-0.335343058,317,116,433
62,-1.350869376,0.68018326,002-AEE,-0.335343058,315,143,458
63,-1.350869376,0.68018326,002-AEF,-0.335343058,273,80,353
64,-1.350869376,0.68018326,002-AEG,-0.335343058,333,111,444
65,-1.350869376,0.68018326,002-AEI,-0.335343058,327,150,477
66,-1.350869376,0.68018326,002-AEJ,-0.335343058,429,140,569
67,-1.350869376,0.68018326,002-AEK,-0.335343058,95,160,255
68,-1.350869376,0.68018326,002-AFE,-0.335343058,124,51,175
69,-1.350869376,0.68018326,002-AFI,-0.335343058,141,174,315
70,-1.350869376,0.68018326,002-AFJ,-0.335343058,153,136,289
71,-1.350869376,0.68018326,002-AFK,-0.335343058,296,142,438
72,-1.350869376,0.68018326,002-AFL,-0.335343058,218,106,324
73,-1.350869376,0.68018326,002-AFM,-0.335343058,299,201,500
74,-1.350869376,0.68018326,002-AEW,-0.335343058,164,107,271
75,-1.350869376,0.68018326,002-AAA,-0.335343058,360,250,610
76,-1.350869376,0.68018326,002-AAC,-0.335343058,333,135,468
77,-1.350869376,0.68018326,002-AAE,-0.335343058,293,178,471
78,-1.350869376,0.68018326,002-AAG,-0.335343058,148,98,246
79,-1.350869376,0.68018326,002-ADQ,-0.335343058,390,159,549
80,-1.350869376,0.68018326,002-ADR,-0.335343058,415,143,558
81,-1.350869376,0.68018326,002-AGB,-0.335343058,505,192,697
82,-1.350869376,0.68018326,002-AGC,-0.335343058,424,228,652
83,-1.350869376,0.68018326,002-AGD,-0.335343058,401,192,593
84,-1.350869376,0.68018326,002-ADU,-0.335343058,136,47,183
85,-1.350869376,0.68018326,002-AEN,-0.335343058,567,173,740
86,-1.350869376,0.68018326,002-AEQ,-0.335343058,536,166,702
87,-1.350869376,0.68018326,002-AEO,-0.335343058,140,46,186
88,-1.350869376,0.68018326,002-AAH,-0.335343058,165,236,401
89,-1.350869376,0.68018326,002-AAJ,-0.335343058,112,103,215
90,-1.350869376,0.68018326,002-AAK,-0.335343058,129,108,237
91,-1.350869376,0.68018326,002-AAL,-0.335343058,205,313,518
92,-1.350869376,0.68018326,002-AAN,-0.335343058,132,156,288
93,-1.350869376,0.68018326,002-AAO,-0.335343058,104,97,201
94,-1.350869376,0.68018326,002-AAP,-0.335343058,151,150,301
95,-1.350869376,0.68018326,002-AAQ,-0.335343058,121,222,343
96,-1.350869376,0.68018326,002-AAR,-0.335343058,125,86,211
97,-1.350869376,0.68018326,002-AAS,-0.335343058,142,125,267
98,-1.350869376,0.68018326,002-AAT,-0.335343058,247,175,422
99,-1.350869376,0.68018326,002-AAV,-0.335343058,208,135,343
100,-1.350869376,0.68018326,002-AAW,-0.335343058,221,322,543
101,-1.350869376,0.68018326,002-AAX,-0.335343058,249,300,549
102,-1.350869376,0.68018326,002-AAY,-0.335343058,104,226,330
103,-1.350869376,0.68018326,002-ABE,-0.335343058,337,208,545
104,-1.350869376,0.68018326,002-ABF,-0.335343058,211,184,395
105,-1.350869376,0.68018326,002-ABH,-0.335343058,157,112,269
106,-1.350869376,0.68018326,002-ABI,-0.335343058,149,120,269
107,-1.350869376,0.68018326,002-ABJ,-0.335343058,128,154,282
108,-1.350869376,0.68018326,002-ABK,-0.335343058,109,230,339
109,-1.350869376,0.68018326,002-ABM,-0.335343058,178,186,364
110,-1.350869376,0.68018326,002-ABP,-0.335343058,50,376,426
111,-1.350869376,0.68018326,002-ABQ,-0.335343058,22,207,229
112,-1.350869376,0.68018326,002-ABR,-0.335343058,126,276,402
113,-1.350869376,0.68018326,002-ABT,-0.335343058,101,337,438
114,-1.350869376,0.68018326,002-ABW,-0.335343058,17,231,248
115,-1.350869376,0.68018326,002-ABX,-0.335343058,19,294,313
116,-1.350869376,0.68018326,002-ABZ,-0.335343058,6,279,285
117,-1.350869376,0.68018326,002-ACA,-0.335343058,74,132,206
118,-1.350869376,0.68018326,002-ACB,-0.335343058,54,117,171
119,-1.350869376,0.68018326,002-ACC,-0.335343058,80,229,309
120,-1.350869376,0.68018326,002-ACD,-0.335343058,258,230,488
121,-1.350869376,0.68018326,002-ACE,-0.335343058,312,199,511
122,-1.350869376,0.68018326,002-ACG,-0.335343058,118,127,245
123,-1.350869376,0.68018326,002-ACH,-0.335343058,172,223,395
124,-1.350869376,0.68018326,002-ACI,-0.335343058,152,140,292
125,-1.350869376,0.68018326,002-ACM,-0.335343058,84,343,427
126,-1.350869376,0.68018326,002-ACN,-0.335343058,209,360,569
127,-1.350869376,0.68018326,002-ACO,-0.335343058,259,427,686
128,-1.350869376,0.68018326,002-AES,-0.335343058,603,194,797
129,-1.350869376,0.68018326,002-AET,-0.335343058,522,206,728
130,-1.350869376,0.68018326,002-AEX,-0.335343058,388,77,465
131,-1.350869376,0.68018326,002-AEY,-0.335343058,335,102,437
132,-1.350869376,0.68018326,002-AFB,-0.335343058,340,158,498
133,-1.350869376,0.68018326,002-AFC,-0.335343058,145,120,265
134,-1.350869376,0.68018326,002-AEZ,-0.335343058,299,117,416
135,-1.350869376,0.68018326,002-AFA,-0.335343058,273,166,439
136,-1.350869376,0.68018326,002-AFF,-0.335343058,408,152,560
137,-1.350869376,0.68018326,002-AFG,-0.335343058,416,149,565
138,-1.350869376,0.68018326,002-AFN,-0.335343058,223,146,369
139,-1.350869376,0.68018326,002-AFO,-0.335343058,173,108,281
140,-1.350869376,0.68018326,002-AFP,-0.335343058,162,99,261
141,-1.350869376,0.68018326,002-AFQ,-0.335343058,305,103,408
142,-1.350869376,0.68018326,002-AFR,-0.335343058,346,140,486
143,-1.350869376,0.68018326,002-AFS,-0.335343058,283,141,424
144,-1.350869376,0.68018326,002-AFT,-0.335343058,225,101,326
145,-1.350869376,0.68018326,002-AFU,-0.335343058,251,105,356
146,-1.350869376,0.68018326,002-AFV,-0.335343058,294,107,401
147,-1.350869376,0.68018326,002-AFW,-0.335343058,209,81,290
148,-1.350869376,0.68018326,002-AFX,-0.335343058,221,65,286
149,-1.350869376,0.68018326,002-AFY,-0.335343058,268,98,366
150,-1.350869376,0.68018326,002-AFZ,-0.335343058,281,120,401
151,-1.350869376,0.68018326,002-AGA,-0.335343058,375,139,514
152,-1.350869376,0.68018326,002-AGI,-0.335343058,342,115,457
153,-1.350869376,0.68018326,002-AGK,-0.335343058,318,119,437
154,-1.350869376,0.68018326,002-AGL,-0.335343058,282,141,423
155,-1.350869376,0.68018326,002-AGN,-0.335343058,524,163,687
156,-1.350869376,0.68018326,003-AAA,-0.335343058,449,231,680
157,-1.350869376,0.68018326,003-AAB,-0.335343058,234,157,391
158,-1.350869376,0.68018326,003-AAC,-0.335343058,318,122,440
159,-1.350869376,0.68018326,003-AAD,-0.335343058,211,172,383
160,-1.350869376,0.68018326,003-AAE,-0.335343058,316,119,435
161,-1.350869376,0.68018326,003-AAF,-0.335343058,361,122,483
162,-1.350869376,0.68018326,003-AAG,-0.335343058,160,129,289
163,-1.350869376,0.68018326,003-AAH,-0.335343058,114,94,208
164,-1.350869376,0.68018326,003-AAI,-0.335343058,222,150,372
165,-1.350869376,0.68018326,003-AAJ,-0.335343058,138,93,231
166,-1.350869376,0.68018326,003-AAK,-0.335343058,134,62,196
167,-1.350869376,0.68018326,003-AAL,-0.335343058,127,96,223
168,-1.350869376,0.68018326,003-AAM,-0.335343058,251,153,404
169,-1.350869376,0.68018326,003-AAN,-0.335343058,198,97,295
170,-1.350869376,0.68018326,003-AAQ,-0.335343058,108,112,220
171,-1.350869376,0.68018326,003-AAR,-0.335343058,179,127,306
172,-1.350869376,0.68018326,003-AAS,-0.335343058,193,126,319
173,-1.350869376,0.68018326,003-AAT,-0.335343058,108,101,209
174,-1.350869376,0.68018326,003-AAU,-0.335343058,408,215,623
175,-1.350869376,0.68018326,003-AAV,-0.335343058,177,185,362
176,-1.350869376,0.68018326,003-AAW,-0.335343058,118,77,195
177,-1.350869376,0.68018326,003-AAZ,-0.335343058,126,127,253
178,-1.350869376,0.68018326,003-ABA,-0.335343058,136,118,254
179,-1.350869376,0.68018326,003-ABB,-0.335343058,159,170,329
180,-1.350869376,0.68018326,003-ABC,-0.335343058,202,168,370
181,-1.350869376,0.68018326,003-ABD,-0.335343058,101,108,209
182,-1.350869376,0.68018326,003-ABF,-0.335343058,108,64,172
183,-1.350869376,0.68018326,003-ABG,-0.335343058,340,199,539
184,-1.350869376,0.68018326,003-ABI,-0.335343058,315,168,483
185,-1.350869376,0.68018326,003-ABJ,-0.335343058,270,188,458
186,-1.350869376,0.68018326,003-ABN,-0.335343058,286,206,492
187,-1.350869376,0.68018326,003-ACR,-0.335343058,140,78,218
188,-1.350869376,0.68018326,003-ABS,-0.335343058,398,326,724
189,-1.350869376,0.68018326,003-ABT,-0.335343058,433,269,702
190,-1.350869376,0.68018326,003-ACB,-0.335343058,140,91,231
191,-1.350869376,0.68018326,003-ABV,-0.335343058,218,126,344
192,-1.350869376,0.68018326,003-ABO,-0.335343058,258,235,493
193,-1.350869376,0.68018326,003-ABP,-0.335343058,209,153,362
194,-1.350869376,0.68018326,003-ABQ,-0.335343058,249,149,398
195,-1.350869376,0.68018326,003-ACV,-0.335343058,219,102,321
196,-1.350869376,0.68018326,003-ACW,-0.335343058,198,119,317
197,-1.350869376,0.68018326,003-ABY,-0.335343058,217,106,323
198,-1.350869376,0.68018326,003-ABZ,-0.335343058,343,148,491
199,-1.350869376,0.68018326,003-ACA,-0.335343058,284,117,401
200,-1.350869376,0.68018326,003-ACC,-0.335343058,238,129,367
201,-1.350869376,0.68018326,003-ACD,-0.335343058,276,124,400
202,-1.350869376,0.68018326,003-ACE,-0.335343058,337,127,464
203,-1.350869376,0.68018326,003-ACF,-0.335343058,171,95,266
204,-1.350869376,0.68018326,003-ACG,-0.335343058,262,114,376
205,-1.350869376,0.68018326,003-ACH,-0.335343058,325,103,428
206,-1.350869376,0.68018326,003-ACI,-0.335343058,281,135,416
207,-1.350869376,0.68018326,003-ACJ,-0.335343058,268,168,436
208,-1.350869376,0.68018326,003-ACK,-0.335343058,255,156,411
209,-1.350869376,0.68018326,003-ACL,-0.335343058,285,154,439
210,-1.350869376,0.68018326,003-ACM,-0.335343058,306,178,484
211,-1.350869376,0.68018326,003-ABK,-0.335343058,136,145,281
212,-1.350869376,0.68018326,003-ABU,-0.335343058,87,81,168
213,-1.350869376,0.68018326,003-ACN,-0.335343058,289,176,465
214,-1.350869376,0.68018326,003-ABH,-0.335343058,103,63,166
215,-1.350869376,0.68018326,003-ACO,-0.335343058,334,237,571
216,-1.350869376,0.68018326,003-ACP,-0.335343058,231,197,428
217,-1.350869376,0.68018326,003-ACQ,-0.335343058,311,270,581
218,-1.350869376,0.68018326,003-ACS,-0.335343058,251,122,373
219,-1.350869376,0.68018326,003-ACT,-0.335343058,254,126,380
220,-1.350869376,0.68018326,003-ACU,-0.335343058,285,125,410
221,-1.350869376,0.68018326,004-ABZ,-0.335343058,208,231,439
222,-1.350869376,0.68018326,004-ACA,-0.335343058,203,156,359
223,-1.350869376,0.68018326,004-ACB,-0.335343058,91,119,210
224,-1.350869376,0.68018326,004-ACC,-0.335343058,117,100,217
225,-1.350869376,0.68018326,004-AAA,-0.335343058,132,251,383
226,-1.350869376,0.68018326,004-AAB,-0.335343058,87,190,277
227,-1.350869376,0.68018326,004-AAC,-0.335343058,58,144,202
228,-1.350869376,0.68018326,004-AAD,-0.335343058,85,196,281
229,-1.350869376,0.68018326,004-AAE,-0.335343058,138,236,374
230,-1.350869376,0.68018326,004-AAF,-0.335343058,110,177,287
231,-1.350869376,0.68018326,004-AAG,-0.335343058,79,160,239
232,-1.350869376,0.68018326,004-AAH,-0.335343058,67,212,279
233,-1.350869376,0.68018326,004-AAI,-0.335343058,85,191,276
234,-1.350869376,0.68018326,004-AAJ,-0.335343058,76,231,307
235,-1.350869376,0.68018326,004-AAK,-0.335343058,69,171,240
236,-1.350869376,0.68018326,004-AAL,-0.335343058,89,179,268
237,-1.350869376,0.68018326,004-AAM,-0.335343058,63,198,261
238,-1.350869376,0.68018326,004-AAN,-0.335343058,35,122,157
239,-1.350869376,0.68018326,004-AAO,-0.335343058,65,214,279
240,-1.350869376,0.68018326,004-AAP,-0.335343058,54,191,245
241,-1.350869376,0.68018326,004-AAQ,-0.335343058,30,282,312
242,-1.350869376,0.68018326,004-AAR,-0.335343058,45,160,205
243,-1.350869376,0.68018326,004-AAS,-0.335343058,71,189,260
244,-1.350869376,0.68018326,004-AAT,-0.335343058,108,171,279
245,-1.350869376,0.68018326,004-AAU,-0.335343058,96,199,295
246,-1.350869376,0.68018326,004-AAV,-0.335343058,79,128,207
247,-1.350869376,0.68018326,004-AAW,-0.335343058,60,153,213
248,-1.350869376,0.68018326,004-AAX,-0.335343058,49,183,232
249,-1.350869376,0.68018326,004-AAY,-0.335343058,68,151,219
250,-1.350869376,0.68018326,004-AAZ,-0.335343058,119,177,296
251,-1.350869376,0.68018326,004-ABA,-0.335343058,67,212,279
252,-1.350869376,0.68018326,004-ACD,-0.335343058,143,246,389
253,-1.350869376,0.68018326,004-ACG,-0.335343058,174,177,351
254,-1.350869376,0.68018326,004-ACH,-0.335343058,96,226,322
255,-1.350869376,0.68018326,004-ACI,-0.335343058,90,190,280
256,-1.350869376,0.68018326,004-ACJ,-0.335343058,174,258,432
257,-1.350869376,0.68018326,004-ACK,-0.335343058,98,203,301
258,-1.350869376,0.68018326,004-ACL,-0.335343058,107,153,260
259,-1.350869376,0.68018326,004-ACM,-0.335343058,136,231,367
260,-1.350869376,0.68018326,004-ACO,-0.335343058,342,305,647
261,-1.350869376,0.68018326,004-ACP,-0.335343058,281,310,591
262,-1.350869376,0.68018326,004-ACQ,-0.335343058,194,165,359
263,-1.350869376,0.68018326,004-ACR,-0.335343058,202,180,382
264,-1.350869376,0.68018326,004-ABB,-0.335343058,109,177,286
265,-1.350869376,0.68018326,004-ABC,-0.335343058,115,167,282
266,-1.350869376,0.68018326,004-ABD,-0.335343058,92,186,278
267,-1.350869376,0.68018326,004-ABE,-0.335343058,97,132,229
268,-1.350869376,0.68018326,004-ABF,-0.335343058,179,309,488
269,-1.350869376,0.68018326,004-ABG,-0.335343058,100,188,288
270,-1.350869376,0.68018326,004-ABH,-0.335343058,141,189,330
271,-1.350869376,0.68018326,004-ABI,-0.335343058,224,245,469
272,-1.350869376,0.68018326,004-ABJ,-0.335343058,111,179,290
273,-1.350869376,0.68018326,004-ABK,-0.335343058,144,223,367
274,-1.350869376,0.68018326,004-ABL,-0.335343058,92,232,324
275,-1.350869376,0.68018326,004-ABM,-0.335343058,127,272,399
276,-1.350869376,0.68018326,004-ABN,-0.335343058,90,213,303
277,-1.350869376,0.68018326,004-ABO,-0.335343058,65,157,222
278,-1.350869376,0.68018326,004-ABP,-0.335343058,83,185,268
279,-1.350869376,0.68018326,004-ABQ,-0.335343058,62,149,211
280,-1.350869376,0.68018326,004-ACS,-0.335343058,167,223,390
281,-1.350869376,0.68018326,004-ACT,-0.335343058,202,176,378
282,-1.350869376,0.68018326,004-ACY,-0.335343058,73,104,177
283,-1.350869376,0.68018326,004-ACZ,-0.335343058,115,212,327
284,-1.350869376,0.68018326,004-ABR,-0.335343058,158,196,354
285,-1.350869376,0.68018326,004-ABS,-0.335343058,77,123,200
286,-1.350869376,0.68018326,004-ABT,-0.335343058,162,234,396
287,-1.350869376,0.68018326,004-ABU,-0.335343058,168,259,427
288,-1.350869376,0.68018326,004-ABV,-0.335343058,107,151,258
289,-1.350869376,0.68018326,004-ABW,-0.335343058,91,165,256
290,-1.350869376,0.68018326,004-ABX,-0.335343058,171,229,400
291,-1.350869376,0.68018326,004-ABY,-0.335343058,187,214,401
292,-1.350869376,0.68018326,004-ACU,-0.335343058,166,240,406
293,-1.350869376,0.68018326,004-ACV,-0.335343058,188,199,387
294,-1.350869376,0.68018326,004-ACW,-0.335343058,181,235,416
295,-1.350869376,0.68018326,004-ACX,-0.335343058,123,192,315
296,-1.350869376,0.68018326,004-ADA,-0.335343058,236,191,427
297,-1.350869376,0.68018326,004-ADB,-0.335343058,285,262,547
298,-1.350869376,0.68018326,004-ADC,-0.335343058,222,224,446
299,-1.350869376,0.68018326,004-ADD,-0.335343058,237,162,399
300,-1.350869376,0.68018326,004-ADE,-0.335343058,162,106,268
301,-1.350869376,0.68018326,004-ADI,-0.335343058,156,155,311
302,-1.350869376,0.68018326,004-ADJ,-0.335343058,141,124,265
303,-1.350869376,0.68018326,004-ADK,-0.335343058,181,218,399
304,-1.350869376,0.68018326,004-ADL,-0.335343058,251,230,481
305,-1.350869376,0.68018326,004-ADF,-0.335343058,182,169,351
306,-1.350869376,0.68018326,004-ADG,-0.335343058,146,158,304
307,-1.350869376,0.68018326,004-ADH,-0.335343058,208,185,393
308,-1.350869376,0.68018326,004-ADM,-0.335343058,218,216,434
309,-1.350869376,0.68018326,004-ADN,-0.335343058,213,239,452
310,-1.350869376,0.68018326,004-ADO,-0.335343058,198,148,346
311,-1.350869376,0.68018326,004-ADP,-0.335343058,181,170,351
312,-1.350869376,0.68018326,004-ADQ,-0.335343058,271,283,554
313,-1.350869376,0.68018326,004-ADR,-0.335343058,235,266,501
314,-1.350869376,0.68018326,004-ADT,-0.335343058,236,192,428
315,-1.350869376,0.68018326,004-ADV,-0.335343058,246,306,552
316,-1.350869376,0.68018326,004-ADW,-0.335343058,210,242,452
317,-1.350869376,0.68018326,004-ADX,-0.335343058,117,145,262
318,-1.350869376,0.68018326,004-ADY,-0.335343058,103,178,281
319,-1.350869376,0.68018326,004-ADU,-0.335343058,250,228,478
320,-1.350869376,0.68018326,004-ADZ,-0.335343058,307,249,556
321,-1.350869376,0.68018326,004-AEA,-0.335343058,246,316,562
322,-1.350869376,0.68018326,004-AEB,-0.335343058,312,225,537
323,-1.350869376,0.68018326,004-AEC,-0.335343058,185,216,401
324,-1.350869376,0.68018326,004-AED,-0.335343058,189,199,388
325,-1.350869376,0.68018326,004-AEE,-0.335343058,128,171,299
326,-1.350869376,0.68018326,004-AEF,-0.335343058,203,196,399
327,-1.350869376,0.68018326,004-AEZ,-0.335343058,423,332,755
328,-1.350869376,0.68018326,004-ADS,-0.335343058,95,114,209
329,-1.350869376,0.68018326,004-AEG,-0.335343058,210,234,444
330,-1.350869376,0.68018326,004-AEH,-0.335343058,162,149,311
331,-1.350869376,0.68018326,004-AEI,-0.335343058,117,263,380
332,-1.350869376,0.68018326,004-AEJ,-0.335343058,121,207,328
333,-1.350869376,0.68018326,004-AEK,-0.335343058,203,244,447
334,-1.350869376,0.68018326,004-AEL,-0.335343058,167,272,439
335,-1.350869376,0.68018326,004-AEM,-0.335343058,126,132,258
336,-1.350869376,0.68018326,004-AEN,-0.335343058,159,193,352
337,-1.350869376,0.68018326,004-AEO,-0.335343058,134,189,323
338,-1.350869376,0.68018326,004-AEP,-0.335343058,111,187,298
339,-1.350869376,0.68018326,004-AEQ,-0.335343058,132,191,323
340,-1.350869376,0.68018326,004-AER,-0.335343058,193,229,422
341,-1.350869376,0.68018326,004-AES,-0.335343058,217,140,357
342,-1.350869376,0.68018326,004-AET,-0.335343058,189,208,397
343,-1.350869376,0.68018326,004-AEU,-0.335343058,149,115,264
344,-1.350869376,0.68018326,004-AEX,-0.335343058,222,181,403
345,-1.350869376,0.68018326,004-AEY,-0.335343058,123,109,232
346,-1.350869376,0.68018326,004-AEV,-0.335343058,147,114,261
347,-1.350869376,0.68018326,004-AEW,-0.335343058,187,182,369
348,-1.350869376,0.68018326,005-ABW,-0.335343058,192,249,441
349,-1.350869376,0.68018326,005-ABF,-0.335343058,420,424,844
350,-1.350869376,0.68018326,005-ABG,-0.335343058,225,298,523
351,-1.350869376,0.68018326,005-ABH,-0.335343058,161,359,520
352,-1.350869376,0.68018326,005-ABI,-0.335343058,32,66,98
353,-1.350869376,0.68018326,005-AAA,-0.335343058,45,260,305
354,-1.350869376,0.68018326,005-AAB,-0.335343058,25,349,374
355,-1.350869376,0.68018326,005-AAC,-0.335343058,64,386,450
356,-1.350869376,0.68018326,005-AAD,-0.335343058,137,439,576
357,-1.350869376,0.68018326,005-AAE,-0.335343058,335,707,1042
358,-1.350869376,0.68018326,005-AAF,-0.335343058,94,281,375
359,-1.350869376,0.68018326,005-AAG,-0.335343058,424,1042,1466
360,-1.350869376,0.68018326,005-AAH,-0.335343058,84,353,437
361,-1.350869376,0.68018326,005-AAI,-0.335343058,134,338,472
362,-1.350869376,0.68018326,005-AAJ,-0.335343058,189,459,648
363,-1.350869376,0.68018326,005-AAK,-0.335343058,147,307,454
364,-1.350869376,0.68018326,005-AAL,-0.335343058,177,416,593
365,-1.350869376,0.68018326,005-AAM,-0.335343058,187,398,585
366,-1.350869376,0.68018326,005-AAN,-0.335343058,61,285,346
367,-1.350869376,0.68018326,005-AAO,-0.335343058,53,257,310
368,-1.350869376,0.68018326,005-AAP,-0.335343058,63,488,551
369,-1.350869376,0.68018326,005-AAQ,-0.335343058,61,198,259
370,-1.350869376,0.68018326,005-AAR,-0.335343058,40,145,185
371,-1.350869376,0.68018326,005-AAS,-0.335343058,85,230,315
372,-1.350869376,0.68018326,005-AAT,-0.335343058,90,181,271
373,-1.350869376,0.68018326,005-AAU,-0.335343058,83,398,481
374,-1.350869376,0.68018326,005-AAV,-0.335343058,105,410,515
375,-1.350869376,0.68018326,005-AAW,-0.335343058,336,931,1267
376,-1.350869376,0.68018326,005-ABJ,-0.335343058,362,589,951
377,-1.350869376,0.68018326,005-ABK,-0.335343058,115,286,401
378,-1.350869376,0.68018326,005-ABL,-0.335343058,231,460,691
379,-1.350869376,0.68018326,005-ABO,-0.335343058,75,179,254
380,-1.350869376,0.68018326,005-ACO,-0.335343058,83,178,261
381,-1.350869376,0.68018326,005-ABP,-0.335343058,83,175,258
382,-1.350869376,0.68018326,005-ABQ,-0.335343058,155,397,552
383,-1.350869376,0.68018326,005-ABR,-0.335343058,359,329,688
384,-1.350869376,0.68018326,005-ABS,-0.335343058,106,277,383
385,-1.350869376,0.68018326,005-ABT,-0.335343058,179,287,466
386,-1.350869376,0.68018326,005-ACI,-0.335343058,119,85,204
387,-1.350869376,0.68018326,005-ACE,-0.335343058,57,152,209
388,-1.350869376,0.68018326,005-ACF,-0.335343058,52,141,193
389,-1.350869376,0.68018326,005-ACG,-0.335343058,23,101,124
390,-1.350869376,0.68018326,005-ACH,-0.335343058,20,75,95
391,-1.350869376,0.68018326,005-ABZ,-0.335343058,60,114,174
392,-1.350869376,0.68018326,005-ACB,-0.335343058,44,182,226
393,-1.350869376,0.68018326,005-ABX,-0.335343058,471,525,996
394,-1.350869376,0.68018326,005-ABY,-0.335343058,270,461,731
395,-1.350869376,0.68018326,005-ABU,-0.335343058,151,333,484
396,-1.350869376,0.68018326,005-AAX,-0.335343058,46,138,184
397,-1.350869376,0.68018326,005-AAY,-0.335343058,74,135,209
398,-1.350869376,0.68018326,005-AAZ,-0.335343058,41,110,151
399,-1.350869376,0.68018326,005-ABA,-0.335343058,57,86,143
400,-1.350869376,0.68018326,005-ABB,-0.335343058,35,114,149
401,-1.350869376,0.68018326,005-ABC,-0.335343058,59,160,219
402,-1.350869376,0.68018326,005-ABD,-0.335343058,87,195,282
403,-1.350869376,0.68018326,005-ABE,-0.335343058,60,160,220
404,-1.350869376,0.68018326,005-ACL,-0.335343058,175,377,552
405,-1.350869376,0.68018326,005-ABM,-0.335343058,219,433,652
406,-1.350869376,0.68018326,005-ABN,-0.335343058,269,534,803
407,-1.350869376,0.68018326,005-ACA,-0.335343058,176,274,450
408,-1.350869376,0.68018326,005-ABV,-0.335343058,49,230,279
409,-1.350869376,0.68018326,005-ACC,-0.335343058,216,498,714
410,-1.350869376,0.68018326,005-ACD,-0.335343058,35,102,137
411,-1.350869376,0.68018326,005-ACJ,-0.335343058,387,190,577
412,-1.350869376,0.68018326,005-ACK,-0.335343058,255,114,369
413,-1.350869376,0.68018326,005-ACM,-0.335343058,89,174,263
414,-1.350869376,0.68018326,005-ACN,-0.335343058,88,229,317
415,-1.350869376,0.68018326,005-ACP,-0.335343058,48,144,192
416,-1.350869376,0.68018326,005-ACQ,-0.335343058,213,345,558
417,-1.350869376,0.68018326,006-ABB,-0.335343058,65,48,113
418,-1.350869376,0.68018326,006-AAO,-0.335343058,303,100,403
419,-1.350869376,0.68018326,006-AAS,-0.335343058,209,123,332
420,-1.350869376,0.68018326,006-ABR,-0.335343058,370,170,540
421,-1.350869376,0.68018326,006-AAP,-0.335343058,624,231,855
422,-1.350869376,0.68018326,006-AAR,-0.335343058,531,225,756
423,-1.350869376,0.68018326,006-AAU,-0.335343058,403,106,509
424,-1.350869376,0.68018326,006-AAX,-0.335343058,202,60,262
425,-1.350869376,0.68018326,006-AAY,-0.335343058,447,65,512
426,-1.350869376,0.68018326,006-ABC,-0.335343058,414,117,531
427,-1.350869376,0.68018326,006-AAZ,-0.335343058,650,185,835
428,-1.350869376,0.68018326,006-ABA,-0.335343058,611,156,767
429,-1.350869376,0.68018326,006-ABD,-0.335343058,729,235,964
430,-1.350869376,0.68018326,006-AAV,-0.335343058,690,224,914
431,-1.350869376,0.68018326,006-AAW,-0.335343058,528,174,702
432,-1.350869376,0.68018326,006-ABN,-0.335343058,387,98,485
433,-1.350869376,0.68018326,006-ABF,-0.335343058,473,168,641
434,-1.350869376,0.68018326,006-ABG,-0.335343058,561,226,787
435,-1.350869376,0.68018326,006-ABK,-0.335343058,193,62,255
436,-1.350869376,0.68018326,006-AAA,-0.335343058,400,200,600
437,-1.350869376,0.68018326,006-AAB,-0.335343058,233,148,381
438,-1.350869376,0.68018326,006-AAC,-0.335343058,316,165,481
439,-1.350869376,0.68018326,006-AAD,-0.335343058,531,280,811
440,-1.350869376,0.68018326,006-AAE,-0.335343058,462,281,743
441,-1.350869376,0.68018326,006-AAF,-0.335343058,273,251,524
442,-1.350869376,0.68018326,006-ABH,-0.335343058,646,225,871
443,-1.350869376,0.68018326,006-ABJ,-0.335343058,512,305,817
444,-1.350869376,0.68018326,006-ABL,-0.335343058,693,199,892
445,-1.350869376,0.68018326,006-ABM,-0.335343058,86,26,112
446,-1.350869376,0.68018326,006-AAG,-0.335343058,580,238,818
447,-1.350869376,0.68018326,006-AAH,-0.335343058,468,278,746
448,-1.350869376,0.68018326,006-AAI,-0.335343058,250,151,401
449,-1.350869376,0.68018326,006-AAJ,-0.335343058,380,184,564
450,-1.350869376,0.68018326,006-AAK,-0.335343058,224,147,371
451,-1.350869376,0.68018326,006-AAL,-0.335343058,286,145,431
452,-1.350869376,0.68018326,006-AAM,-0.335343058,219,148,367
453,-1.350869376,0.68018326,006-AAN,-0.335343058,443,257,700
454,-1.350869376,0.68018326,006-ABO,-0.335343058,489,109,598
455,-1.350869376,0.68018326,006-ABP,-0.335343058,304,97,401
456,-1.350869376,0.68018326,006-ABQ,-0.335343058,229,131,360
457,-1.350869376,0.68018326,007-ACD,-0.335343058,56,88,144
458,-1.350869376,0.68018326,007-ACX,-0.335343058,445,402,847
459,-1.350869376,0.68018326,007-ACZ,-0.335343058,434,490,924
460,-1.350869376,0.68018326,007-AAA,-0.335343058,230,374,604
461,-1.350869376,0.68018326,007-AAB,-0.335343058,156,286,442
462,-1.350869376,0.68018326,007-AAE,-0.335343058,166,321,487
463,-1.350869376,0.68018326,007-ABD,-0.335343058,113,107,220
464,-1.350869376,0.68018326,007-ABE,-0.335343058,288,221,509
465,-1.350869376,0.68018326,007-ABV,-0.335343058,246,391,637
466,-1.350869376,0.68018326,007-ABW,-0.335343058,240,282,522
467,-1.350869376,0.68018326,007-ABQ,-0.335343058,201,251,452
468,-1.350869376,0.68018326,007-ABS,-0.335343058,157,208,365
469,-1.350869376,0.68018326,007-ABU,-0.335343058,162,167,329
470,-1.350869376,0.68018326,007-ACQ,-0.335343058,361,295,656
471,-1.350869376,0.68018326,007-AAV,-0.335343058,115,116,231
472,-1.350869376,0.68018326,007-AAU,-0.335343058,110,131,241
473,-1.350869376,0.68018326,007-AAW,-0.335343058,339,340,679
474,-1.350869376,0.68018326,007-AAX,-0.335343058,134,225,359
475,-1.350869376,0.68018326,007-AAY,-0.335343058,209,176,385
476,-1.350869376,0.68018326,007-AAZ,-0.335343058,109,198,307
477,-1.350869376,0.68018326,007-ABN,-0.335343058,314,384,698
478,-1.350869376,0.68018326,007-ADF,-0.335343058,197,234,431
479,-1.350869376,0.68018326,007-ABA,-0.335343058,213,198,411
480,-1.350869376,0.68018326,007-ABC,-0.335343058,125,126,251
481,-1.350869376,0.68018326,007-ADL,-0.335343058,43,10,53
482,-1.350869376,0.68018326,007-ABF,-0.335343058,427,264,691
483,-1.350869376,0.68018326,007-ABB,-0.335343058,58,77,135
484,-1.350869376,0.68018326,007-ABG,-0.335343058,108,86,194
485,-1.350869376,0.68018326,007-ACV,-0.335343058,129,152,281
486,-1.350869376,0.68018326,007-AAF,-0.335343058,355,450,805
487,-1.350869376,0.68018326,007-AAH,-0.335343058,304,467,771
488,-1.350869376,0.68018326,007-AAJ,-0.335343058,99,132,231
489,-1.350869376,0.68018326,007-AAK,-0.335343058,182,189,371
490,-1.350869376,0.68018326,007-AAL,-0.335343058,205,423,628
491,-1.350869376,0.68018326,007-ABP,-0.335343058,197,205,402
492,-1.350869376,0.68018326,007-ACU,-0.335343058,72,63,135
493,-1.350869376,0.68018326,007-ACE,-0.335343058,311,456,767
494,-1.350869376,0.68018326,007-ABZ,-0.335343058,172,247,419
495,-1.350869376,0.68018326,007-ABY,-0.335343058,62,130,192
496,-1.350869376,0.68018326,007-ABX,-0.335343058,122,104,226
497,-1.350869376,0.68018326,007-ADI,-0.335343058,265,450,715
498,-1.350869376,0.68018326,007-ADW,-0.335343058,50,117,167
499,-1.350869376,0.68018326,007-ACF,-0.335343058,320,286,606
500,-1.350869376,0.68018326,007-ACH,-0.335343058,276,347,623
501,-1.350869376,0.68018326,007-ACJ,-0.335343058,277,164,441
502,-1.350869376,0.68018326,007-ACK,-0.335343058,362,241,603
503,-1.350869376,0.68018326,007-ACL,-0.335343058,236,219,455
504,-1.350869376,0.68018326,007-ACM,-0.335343058,338,205,543
505,-1.350869376,0.68018326,007-ACN,-0.335343058,375,232,607
506,-1.350869376,0.68018326,007-ACO,-0.335343058,402,295,697
507,-1.350869376,0.68018326,007-ACP,-0.335343058,166,185,351
508,-1.350869376,0.68018326,007-ABH,-0.335343058,272,360,632
509,-1.350869376,0.68018326,007-ABI,-0.335343058,384,429,813
510,-1.350869376,0.68018326,007-ABL,-0.335343058,239,339,578
511,-1.350869376,0.68018326,007-ACS,-0.335343058,172,144,316
512,-1.350869376,0.68018326,007-AAN,-0.335343058,341,181,522
513,-1.350869376,0.68018326,007-AAO,-0.335343058,150,187,337
514,-1.350869376,0.68018326,007-AAP,-0.335343058,356,267,623
515,-1.350869376,0.68018326,007-AAQ,-0.335343058,178,176,354
516,-1.350869376,0.68018326,007-AAR,-0.335343058,283,189,472
517,-1.350869376,0.68018326,007-AAS,-0.335343058,184,215,399
518,-1.350869376,0.68018326,007-AAT,-0.335343058,188,146,334
519,-1.350869376,0.68018326,007-ACT,-0.335343058,82,97,179
520,-1.350869376,0.68018326,007-ACW,-0.335343058,418,259,677
521,-1.350869376,0.68018326,007-ADH,-0.335343058,204,187,391
522,-1.350869376,0.68018326,007-ADB,-0.335343058,488,392,880
523,-1.350869376,0.68018326,007-ADD,-0.335343058,128,119,247
524,-1.350869376,0.68018326,007-ADE,-0.335343058,167,156,323
525,-1.350869376,0.68018326,007-ADK,-0.335343058,155,252,407
526,-1.350869376,0.68018326,008-AAK,-0.335343058,241,159,400
527,-1.350869376,0.68018326,008-AAL,-0.335343058,140,154,294
528,-1.350869376,0.68018326,008-AAA,-0.335343058,213,156,369
529,-1.350869376,0.68018326,008-ACD,-0.335343058,414,217,631
530,-1.350869376,0.68018326,008-ACE,-0.335343058,444,212,656
531,-1.350869376,0.68018326,008-ACF,-0.335343058,392,183,575
532,-1.350869376,0.68018326,008-AAF,-0.335343058,349,185,534
533,-1.350869376,0.68018326,008-ABS,-0.335343058,207,114,321
534,-1.350869376,0.68018326,008-ACO,-0.335343058,343,317,660
535,-1.350869376,0.68018326,008-ACP,-0.335343058,366,272,638
536,-1.350869376,0.68018326,008-ABI,-0.335343058,314,196,510
537,-1.350869376,0.68018326,008-AAG,-0.335343058,227,110,337
538,-1.350869376,0.68018326,008-AAH,-0.335343058,309,160,469
539,-1.350869376,0.68018326,008-AAM,-0.335343058,267,156,423
540,-1.350869376,0.68018326,008-ACH,-0.335343058,508,260,768
541,-1.350869376,0.68018326,008-ACI,-0.335343058,408,245,653
542,-1.350869376,0.68018326,008-ACJ,-0.335343058,455,323,778
543,-1.350869376,0.68018326,008-ACK,-0.335343058,207,126,333
544,-1.350869376,0.68018326,008-ACG,-0.335343058,513,318,831
545,-1.350869376,0.68018326,008-AAJ,-0.335343058,318,198,516
546,-1.350869376,0.68018326,008-AAW,-0.335343058,377,179,556
547,-1.350869376,0.68018326,008-AAY,-0.335343058,384,180,564
548,-1.350869376,0.68018326,008-ACL,-0.335343058,382,193,575
549,-1.350869376,0.68018326,008-AAV,-0.335343058,389,221,610
550,-1.350869376,0.68018326,008-ACM,-0.335343058,373,254,627
551,-1.350869376,0.68018326,008-ACN,-0.335343058,373,224,597
552,-1.350869376,0.68018326,008-ACQ,-0.335343058,452,337,789
553,-1.350869376,0.68018326,008-ACU,-0.335343058,342,384,726
554,-1.350869376,0.68018326,008-ABP,-0.335343058,194,154,348
555,-1.350869376,0.68018326,008-ACR,-0.335343058,431,225,656
556,-1.350869376,0.68018326,008-ACS,-0.335343058,325,157,482
557,-1.350869376,0.68018326,008-ACT,-0.335343058,465,228,693
558,-1.350869376,0.68018326,008-ABV,-0.335343058,269,114,383
559,-1.350869376,0.68018326,008-ACV,-0.335343058,353,289,642
560,-1.350869376,0.68018326,008-ACW,-0.335343058,448,303,751
561,-1.350869376,0.68018326,009-AAC,-0.335343058,509,183,692
562,-1.350869376,0.68018326,009-AAB,-0.335343058,406,376,782
563,-1.350869376,0.68018326,009-ABC,-0.335343058,339,215,554
564,-1.350869376,0.68018326,009-ABD,-0.335343058,451,178,629
565,-1.350869376,0.68018326,009-ALD,-0.335343058,205,107,312
566,-1.350869376,0.68018326,009-AAL,-0.335343058,408,226,634
567,-1.350869376,0.68018326,009-AAT,-0.335343058,367,187,554
568,-1.350869376,0.68018326,009-ALF,-0.335343058,333,208,541
569,-1.350869376,0.68018326,009-AAM,-0.335343058,342,174,516
570,-1.350869376,0.68018326,009-AAU,-0.335343058,313,256,569
571,-1.350869376,0.68018326,009-ABH,-0.335343058,510,253,763
572,-1.350869376,0.68018326,009-AAK,-0.335343058,242,308,550
573,-1.350869376,0.68018326,009-AAN,-0.335343058,280,209,489
574,-1.350869376,0.68018326,009-AAV,-0.335343058,437,178,615
575,-1.350869376,0.68018326,009-ABI,-0.335343058,409,205,614
576,-1.350869376,0.68018326,009-AAD,-0.335343058,225,255,480
577,-1.350869376,0.68018326,009-AAO,-0.335343058,140,172,312
578,-1.350869376,0.68018326,009-AAW,-0.335343058,347,151,498
579,-1.350869376,0.68018326,009-ABJ,-0.335343058,405,275,680
580,-1.350869376,0.68018326,009-AAE,-0.335343058,201,192,393
581,-1.350869376,0.68018326,009-AAP,-0.335343058,345,201,546
582,-1.350869376,0.68018326,009-AAX,-0.335343058,358,215,573
583,-1.350869376,0.68018326,009-ABK,-0.335343058,452,164,616
584,-1.350869376,0.68018326,009-AAF,-0.335343058,176,352,528
585,-1.350869376,0.68018326,009-AAQ,-0.335343058,345,223,568
586,-1.350869376,0.68018326,009-AAY,-0.335343058,326,238,564
587,-1.350869376,0.68018326,009-ABL,-0.335343058,475,202,677
588,-1.350869376,0.68018326,009-AAG,-0.335343058,377,264,641
589,-1.350869376,0.68018326,009-AAR,-0.335343058,245,278,523
590,-1.350869376,0.68018326,009-AAZ,-0.335343058,405,235,640
591,-1.350869376,0.68018326,009-ABM,-0.335343058,353,173,526
592,-1.350869376,0.68018326,009-AAH,-0.335343058,182,292,474
593,-1.350869376,0.68018326,009-AAS,-0.335343058,168,189,357
594,-1.350869376,0.68018326,009-ABA,-0.335343058,292,187,479
595,-1.350869376,0.68018326,009-ABN,-0.335343058,423,184,607
596,-1.350869376,0.68018326,009-AAI,-0.335343058,260,166,426
597,-1.350869376,0.68018326,009-ALE,-0.335343058,286,302,588
598,-1.350869376,0.68018326,009-ABO,-0.335343058,405,154,559
599,-1.350869376,0.68018326,009-AFO,-0.335343058,409,174,583
600,-1.350869376,0.68018326,009-AFX,-0.335343058,448,174,622
601,-1.350869376,0.68018326,009-AFY,-0.335343058,596,264,860
602,-1.350869376,0.68018326,009-AFZ,-0.335343058,533,274,807
603,-1.350869376,0.68018326,009-AGA,-0.335343058,299,144,443
604,-1.350869376,0.68018326,009-AKW,-0.335343058,48,13,61
605,-1.350869376,0.68018326,009-ALG,-0.335343058,572,247,819
606,-1.350869376,0.68018326,009-ALH,-0.335343058,315,141,456
607,-1.350869376,0.68018326,009-ALI,-0.335343058,362,129,491
608,-1.350869376,0.68018326,009-ALP,-0.335343058,455,314,769
609,-1.350869376,0.68018326,009-AME,-0.335343058,442,190,632
610,-1.350869376,0.68018326,009-AFP,-0.335343058,287,150,437
611,-1.350869376,0.68018326,009-AFQ,-0.335343058,320,182,502
612,-1.350869376,0.68018326,009-AFR,-0.335343058,417,179,596
613,-1.350869376,0.68018326,009-AFS,-0.335343058,291,370,661
614,-1.350869376,0.68018326,009-AFT,-0.335343058,529,279,808
615,-1.350869376,0.68018326,009-AFU,-0.335343058,479,220,699
616,-1.350869376,0.68018326,009-AFV,-0.335343058,475,210,685
617,-1.350869376,0.68018326,009-AFW,-0.335343058,444,168,612
618,-1.350869376,0.68018326,009-ABZ,-0.335343058,315,256,571
619,-1.350869376,0.68018326,009-ACA,-0.335343058,426,235,661
620,-1.350869376,0.68018326,009-ACB,-0.335343058,413,255,668
621,-1.350869376,0.68018326,009-ACC,-0.335343058,236,176,412
622,-1.350869376,0.68018326,009-ACD,-0.335343058,250,188,438
623,-1.350869376,0.68018326,009-ACE,-0.335343058,442,302,744
624,-1.350869376,0.68018326,009-ACF,-0.335343058,552,324,876
625,-1.350869376,0.68018326,009-ACG,-0.335343058,386,254,640
626,-1.350869376,0.68018326,009-ACH,-0.335343058,692,269,961
627,-1.350869376,0.68018326,009-ACI,-0.335343058,247,196,443
628,-1.350869376,0.68018326,009-ABQ,-0.335343058,424,260,684
629,-1.350869376,0.68018326,009-ACN,-0.335343058,23,370,393
630,-1.350869376,0.68018326,009-ACQ,-0.335343058,173,212,385
631,-1.350869376,0.68018326,009-ACT,-0.335343058,276,267,543
632,-1.350869376,0.68018326,009-ACX,-0.335343058,126,203,329
633,-1.350869376,0.68018326,009-ADA,-0.335343058,225,245,470
634,-1.350869376,0.68018326,009-ACJ,-0.335343058,455,240,695
635,-1.350869376,0.68018326,009-ACK,-0.335343058,367,297,664
636,-1.350869376,0.68018326,009-ACL,-0.335343058,439,205,644
637,-1.350869376,0.68018326,009-ACM,-0.335343058,331,132,463
638,-1.350869376,0.68018326,009-ABR,-0.335343058,393,223,616
639,-1.350869376,0.68018326,009-ACO,-0.335343058,22,485,507
640,-1.350869376,0.68018326,009-ACR,-0.335343058,177,165,342
641,-1.350869376,0.68018326,009-ACU,-0.335343058,200,201,401
642,-1.350869376,0.68018326,009-ACY,-0.335343058,184,180,364
643,-1.350869376,0.68018326,009-ADB,-0.335343058,351,279,630
644,-1.350869376,0.68018326,009-ABS,-0.335343058,285,203,488
645,-1.350869376,0.68018326,009-ACS,-0.335343058,312,218,530
646,-1.350869376,0.68018326,009-ACV,-0.335343058,83,448,531
647,-1.350869376,0.68018326,009-ACZ,-0.335343058,431,412,843
648,-1.350869376,0.68018326,009-ADC,-0.335343058,266,213,479
649,-1.350869376,0.68018326,009-ABT,-0.335343058,196,254,450
650,-1.350869376,0.68018326,009-ADD,-0.335343058,413,280,693
651,-1.350869376,0.68018326,009-ABU,-0.335343058,300,229,529
652,-1.350869376,0.68018326,009-ADE,-0.335343058,268,228,496
653,-1.350869376,0.68018326,009-ABV,-0.335343058,307,206,513
654,-1.350869376,0.68018326,009-ADF,-0.335343058,89,76,165
655,-1.350869376,0.68018326,009-ABW,-0.335343058,529,224,753
656,-1.350869376,0.68018326,009-ADG,-0.335343058,319,157,476
657,-1.350869376,0.68018326,009-ABX,-0.335343058,347,269,616
658,-1.350869376,0.68018326,009-AKT,-0.335343058,328,225,553
659,-1.350869376,0.68018326,009-ABY,-0.335343058,352,234,586
660,-1.350869376,0.68018326,009-AMF,-0.335343058,235,180,415
661,-1.350869376,0.68018326,009-ALV,-0.335343058,263,137,400
662,-1.350869376,0.68018326,009-AGB,-0.335343058,125,33,158
663,-1.350869376,0.68018326,009-ALO,-0.335343058,276,96,372
664,-1.350869376,0.68018326,009-AGC,-0.335343058,415,177,592
665,-1.350869376,0.68018326,009-AGD,-0.335343058,373,108,481
666,-1.350869376,0.68018326,009-AGE,-0.335343058,506,185,691
667,-1.350869376,0.68018326,009-AGF,-0.335343058,484,209,693
668,-1.350869376,0.68018326,009-AGG,-0.335343058,60,34,94
669,-1.350869376,0.68018326,009-AGH,-0.335343058,526,217,743
670,-1.350869376,0.68018326,009-ALM,-0.335343058,315,99,414
671,-1.350869376,0.68018326,009-ALN,-0.335343058,214,104,318
672,-1.350869376,0.68018326,009-AGJ,-0.335343058,129,89,218
673,-1.350869376,0.68018326,009-AGK,-0.335343058,178,194,372
674,-1.350869376,0.68018326,009-ALS,-0.335343058,673,274,947
675,-1.350869376,0.68018326,009-AGL,-0.335343058,520,195,715
676,-1.350869376,0.68018326,009-AGU,-0.335343058,444,185,629
677,-1.350869376,0.68018326,009-AGV,-0.335343058,385,225,610
678,-1.350869376,0.68018326,009-AGW,-0.335343058,441,269,710
679,-1.350869376,0.68018326,009-AGX,-0.335343058,461,169,630
680,-1.350869376,0.68018326,009-AKX,-0.335343058,325,145,470
681,-1.350869376,0.68018326,009-AKY,-0.335343058,543,231,774
682,-1.350869376,0.68018326,009-AKZ,-0.335343058,409,207,616
683,-1.350869376,0.68018326,009-ALA,-0.335343058,469,275,744
684,-1.350869376,0.68018326,009-ALB,-0.335343058,388,149,537
685,-1.350869376,0.68018326,009-ALC,-0.335343058,506,209,715
686,-1.350869376,0.68018326,009-AGM,-0.335343058,520,239,759
687,-1.350869376,0.68018326,009-ALJ,-0.335343058,565,214,779
688,-1.350869376,0.68018326,009-ALT,-0.335343058,501,157,658
689,-1.350869376,0.68018326,009-ALU,-0.335343058,708,282,990
690,-1.350869376,0.68018326,009-AMA,-0.335343058,471,209,680
691,-1.350869376,0.68018326,009-AMB,-0.335343058,430,328,758
692,-1.350869376,0.68018326,009-AMC,-0.335343058,459,286,745
693,-1.350869376,0.68018326,009-AGN,-0.335343058,339,92,431
694,-1.350869376,0.68018326,009-AGO,-0.335343058,444,220,664
695,-1.350869376,0.68018326,009-AGP,-0.335343058,508,231,739
696,-1.350869376,0.68018326,009-AGQ,-0.335343058,557,181,738
697,-1.350869376,0.68018326,009-AGR,-0.335343058,582,244,826
698,-1.350869376,0.68018326,009-AGS,-0.335343058,404,202,606
699,-1.350869376,0.68018326,009-AGT,-0.335343058,637,282,919
700,-1.350869376,0.68018326,009-AGY,-0.335343058,368,156,524
701,-1.350869376,0.68018326,009-AGZ,-0.335343058,471,264,735
702,-1.350869376,0.68018326,009-AHA,-0.335343058,250,87,337
703,-1.350869376,0.68018326,009-AHB,-0.335343058,375,170,545
704,-1.350869376,0.68018326,009-AHC,-0.335343058,423,166,589
705,-1.350869376,0.68018326,009-AHD,-0.335343058,475,198,673
706,-1.350869376,0.68018326,009-AHE,-0.335343058,464,234,698
707,-1.350869376,0.68018326,009-ADO,-0.335343058,253,177,430
708,-1.350869376,0.68018326,009-AEH,-0.335343058,263,228,491
709,-1.350869376,0.68018326,009-AEI,-0.335343058,382,300,682
710,-1.350869376,0.68018326,009-ADH,-0.335343058,243,212,455
711,-1.350869376,0.68018326,009-AKU,-0.335343058,156,266,422
712,-1.350869376,0.68018326,009-ADY,-0.335343058,410,166,576
713,-1.350869376,0.68018326,009-AEK,-0.335343058,213,294,507
714,-1.350869376,0.68018326,009-ADI,-0.335343058,318,252,570
715,-1.350869376,0.68018326,009-ADR,-0.335343058,68,449,517
716,-1.350869376,0.68018326,009-ADZ,-0.335343058,292,199,491
717,-1.350869376,0.68018326,009-AEL,-0.335343058,245,258,503
718,-1.350869376,0.68018326,009-ADJ,-0.335343058,342,177,519
719,-1.350869376,0.68018326,009-ADS,-0.335343058,6,433,439
720,-1.350869376,0.68018326,009-AEA,-0.335343058,311,226,537
721,-1.350869376,0.68018326,009-AEM,-0.335343058,294,254,548
722,-1.350869376,0.68018326,009-ADK,-0.335343058,343,189,532
723,-1.350869376,0.68018326,009-ADT,-0.335343058,166,208,374
724,-1.350869376,0.68018326,009-AEB,-0.335343058,248,154,402
725,-1.350869376,0.68018326,009-AEN,-0.335343058,217,200,417
726,-1.350869376,0.68018326,009-ADL,-0.335343058,451,270,721
727,-1.350869376,0.68018326,009-ADU,-0.335343058,150,276,426
728,-1.350869376,0.68018326,009-AEC,-0.335343058,382,221,603
729,-1.350869376,0.68018326,009-AEO,-0.335343058,228,233,461
730,-1.350869376,0.68018326,009-ADM,-0.335343058,184,191,375
731,-1.350869376,0.68018326,009-ADV,-0.335343058,50,419,469
732,-1.350869376,0.68018326,009-AED,-0.335343058,495,248,743
733,-1.350869376,0.68018326,009-AEP,-0.335343058,389,398,787
734,-1.350869376,0.68018326,009-ADN,-0.335343058,277,283,560
735,-1.350869376,0.68018326,009-ADW,-0.335343058,52,238,290
736,-1.350869376,0.68018326,009-AEE,-0.335343058,397,274,671
737,-1.350869376,0.68018326,009-AEQ,-0.335343058,235,360,595
738,-1.350869376,0.68018326,009-ADX,-0.335343058,210,256,466
739,-1.350869376,0.68018326,009-AEF,-0.335343058,291,252,543
740,-1.350869376,0.68018326,009-AER,-0.335343058,323,272,595
741,-1.350869376,0.68018326,009-ADP,-0.335343058,156,268,424
742,-1.350869376,0.68018326,009-AEG,-0.335343058,296,179,475
743,-1.350869376,0.68018326,009-AHF,-0.335343058,376,191,567
744,-1.350869376,0.68018326,009-AHG,-0.335343058,327,167,494
745,-1.350869376,0.68018326,009-AHH,-0.335343058,477,226,703
746,-1.350869376,0.68018326,009-AHI,-0.335343058,60,42,102
747,-1.350869376,0.68018326,009-AKM,-0.335343058,507,295,802
748,-1.350869376,0.68018326,009-AKN,-0.335343058,493,274,767
749,-1.350869376,0.68018326,009-AKO,-0.335343058,496,193,689
750,-1.350869376,0.68018326,009-AKK,-0.335343058,504,259,763
751,-1.350869376,0.68018326,009-AKL,-0.335343058,377,175,552
752,-1.350869376,0.68018326,009-AKP,-0.335343058,285,134,419
753,-1.350869376,0.68018326,009-AKQ,-0.335343058,571,268,839
754,-1.350869376,0.68018326,009-ALW,-0.335343058,445,245,690
755,-1.350869376,0.68018326,009-ALX,-0.335343058,509,218,727
756,-1.350869376,0.68018326,009-AHJ,-0.335343058,324,124,448
757,-1.350869376,0.68018326,009-AHK,-0.335343058,476,123,599
758,-1.350869376,0.68018326,009-AHL,-0.335343058,612,162,774
759,-1.350869376,0.68018326,009-AHM,-0.335343058,565,133,698
760,-1.350869376,0.68018326,009-AHN,-0.335343058,486,136,622
761,-1.350869376,0.68018326,009-AET,-0.335343058,233,428,661
762,-1.350869376,0.68018326,009-AFC,-0.335343058,244,329,573
763,-1.350869376,0.68018326,009-AFD,-0.335343058,251,465,716
764,-1.350869376,0.68018326,009-AFE,-0.335343058,218,413,631
765,-1.350869376,0.68018326,009-AFF,-0.335343058,230,380,610
766,-1.350869376,0.68018326,009-AEU,-0.335343058,184,358,542
767,-1.350869376,0.68018326,009-AEV,-0.335343058,286,524,810
768,-1.350869376,0.68018326,009-AEW,-0.335343058,154,338,492
769,-1.350869376,0.68018326,009-AEX,-0.335343058,221,328,549
770,-1.350869376,0.68018326,009-AEY,-0.335343058,235,355,590
771,-1.350869376,0.68018326,009-AEZ,-0.335343058,202,271,473
772,-1.350869376,0.68018326,009-AFA,-0.335343058,158,367,525
773,-1.350869376,0.68018326,009-AFB,-0.335343058,221,413,634
774,-1.350869376,0.68018326,009-AHO,-0.335343058,392,344,736
775,-1.350869376,0.68018326,009-AHP,-0.335343058,31,24,55
776,-1.350869376,0.68018326,009-AHQ,-0.335343058,306,475,781
777,-1.350869376,0.68018326,009-AHS,-0.335343058,473,211,684
778,-1.350869376,0.68018326,009-AHT,-0.335343058,565,303,868
779,-1.350869376,0.68018326,009-AHU,-0.335343058,444,126,570
780,-1.350869376,0.68018326,009-AHV,-0.335343058,587,171,758
781,-1.350869376,0.68018326,009-AHW,-0.335343058,646,184,830
782,-1.350869376,0.68018326,009-AHX,-0.335343058,586,169,755
783,-1.350869376,0.68018326,009-AHY,-0.335343058,160,79,239
784,-1.350869376,0.68018326,009-AHZ,-0.335343058,374,180,554
785,-1.350869376,0.68018326,009-AIA,-0.335343058,403,165,568
786,-1.350869376,0.68018326,009-AKI,-0.335343058,323,252,575
787,-1.350869376,0.68018326,009-AKJ,-0.335343058,345,159,504
788,-1.350869376,0.68018326,009-AIB,-0.335343058,186,172,358
789,-1.350869376,0.68018326,009-AIC,-0.335343058,220,101,321
790,-1.350869376,0.68018326,009-AID,-0.335343058,184,124,308
791,-1.350869376,0.68018326,009-AIE,-0.335343058,256,103,359
792,-1.350869376,0.68018326,009-AIF,-0.335343058,223,146,369
793,-1.350869376,0.68018326,009-AIG,-0.335343058,298,149,447
794,-1.350869376,0.68018326,009-AIH,-0.335343058,74,44,118
795,-1.350869376,0.68018326,009-AII,-0.335343058,380,142,522
796,-1.350869376,0.68018326,009-AFH,-0.335343058,259,171,430
797,-1.350869376,0.68018326,009-AFI,-0.335343058,351,160,511
798,-1.350869376,0.68018326,009-AFJ,-0.335343058,426,185,611
799,-1.350869376,0.68018326,009-AFK,-0.335343058,402,250,652
800,-1.350869376,0.68018326,009-AFL,-0.335343058,269,115,384
801,-1.350869376,0.68018326,009-AFM,-0.335343058,349,203,552
802,-1.350869376,0.68018326,009-AFN,-0.335343058,500,214,714
803,-1.350869376,0.68018326,009-ALY,-0.335343058,383,204,587
804,-1.350869376,0.68018326,009-ALZ,-0.335343058,318,131,449
805,-1.350869376,0.68018326,009-AKC,-0.335343058,413,182,595
806,-1.350869376,0.68018326,009-AKD,-0.335343058,397,130,527
807,-1.350869376,0.68018326,009-AKE,-0.335343058,155,75,230
808,-1.350869376,0.68018326,009-AKF,-0.335343058,465,165,630
809,-1.350869376,0.68018326,009-AKG,-0.335343058,270,135,405
810,-1.350869376,0.68018326,009-AKH,-0.335343058,17,12,29
811,-1.350869376,0.68018326,009-ALQ,-0.335343058,506,457,963
812,-1.350869376,0.68018326,009-ALR,-0.335343058,242,179,421
813,-1.350869376,0.68018326,009-AIJ,-0.335343058,374,231,605
814,-1.350869376,0.68018326,009-AIS,-0.335343058,333,153,486
815,-1.350869376,0.68018326,009-AIT,-0.335343058,473,193,666
816,-1.350869376,0.68018326,009-AIU,-0.335343058,515,332,847
817,-1.350869376,0.68018326,009-AIV,-0.335343058,444,208,652
818,-1.350869376,0.68018326,009-AIW,-0.335343058,438,214,652
819,-1.350869376,0.68018326,009-AIX,-0.335343058,607,216,823
820,-1.350869376,0.68018326,009-AIY,-0.335343058,469,288,757
821,-1.350869376,0.68018326,009-AIZ,-0.335343058,550,240,790
822,-1.350869376,0.68018326,009-AJA,-0.335343058,352,181,533
823,-1.350869376,0.68018326,009-AJB,-0.335343058,343,264,607
824,-1.350869376,0.68018326,009-AIK,-0.335343058,525,273,798
825,-1.350869376,0.68018326,009-AJC,-0.335343058,412,213,625
826,-1.350869376,0.68018326,009-AJD,-0.335343058,427,197,624
827,-1.350869376,0.68018326,009-AJE,-0.335343058,512,210,722
828,-1.350869376,0.68018326,009-AJF,-0.335343058,554,242,796
829,-1.350869376,0.68018326,009-AJG,-0.335343058,513,230,743
830,-1.350869376,0.68018326,009-AJH,-0.335343058,501,280,781
831,-1.350869376,0.68018326,009-AJI,-0.335343058,323,156,479
832,-1.350869376,0.68018326,009-AJJ,-0.335343058,323,148,471
833,-1.350869376,0.68018326,009-AJK,-0.335343058,317,233,550
834,-1.350869376,0.68018326,009-AJL,-0.335343058,710,438,1148
835,-1.350869376,0.68018326,009-AIL,-0.335343058,441,167,608
836,-1.350869376,0.68018326,009-AJM,-0.335343058,164,239,403
837,-1.350869376,0.68018326,009-AJN,-0.335343058,367,221,588
838,-1.350869376,0.68018326,009-AJO,-0.335343058,312,143,455
839,-1.350869376,0.68018326,009-AJP,-0.335343058,256,240,496
840,-1.350869376,0.68018326,009-AJQ,-0.335343058,333,188,521
841,-1.350869376,0.68018326,009-AJR,-0.335343058,102,206,308
842,-1.350869376,0.68018326,009-AJS,-0.335343058,350,198,548
843,-1.350869376,0.68018326,009-AJT,-0.335343058,507,216,723
844,-1.350869376,0.68018326,009-AJU,-0.335343058,430,209,639
845,-1.350869376,0.68018326,009-AJV,-0.335343058,419,213,632
846,-1.350869376,0.68018326,009-AIM,-0.335343058,356,201,557
847,-1.350869376,0.68018326,009-AJW,-0.335343058,395,175,570
848,-1.350869376,0.68018326,009-AJX,-0.335343058,707,243,950
849,-1.350869376,0.68018326,009-AJY,-0.335343058,512,210,722
850,-1.350869376,0.68018326,009-AJZ,-0.335343058,447,229,676
851,-1.350869376,0.68018326,009-AKA,-0.335343058,296,396,692
852,-1.350869376,0.68018326,009-ALL,-0.335343058,374,292,666
853,-1.350869376,0.68018326,009-AMD,-0.335343058,389,224,613
854,-1.350869376,0.68018326,009-AIN,-0.335343058,284,135,419
855,-1.350869376,0.68018326,009-AIO,-0.335343058,391,232,623
856,-1.350869376,0.68018326,009-AIP,-0.335343058,439,211,650
857,-1.350869376,0.68018326,009-AIQ,-0.335343058,433,160,593
858,-1.350869376,0.68018326,009-ALK,-0.335343058,353,256,609
859,-1.350869376,0.68018326,010-AAA,-0.335343058,407,317,724
860,-1.350869376,0.68018326,010-AAE,-0.335343058,211,243,454
861,-1.350869376,0.68018326,010-AAF,-0.335343058,202,251,453
862,-1.350869376,0.68018326,010-AAG,-0.335343058,257,243,500
863,-1.350869376,0.68018326,010-AAQ,-0.335343058,333,344,677
864,-1.350869376,0.68018326,010-AAR,-0.335343058,276,231,507
865,-1.350869376,0.68018326,010-AAS,-0.335343058,200,162,362
866,-1.350869376,0.68018326,010-AAO,-0.335343058,362,307,669
867,-1.350869376,0.68018326,010-AAV,-0.335343058,226,159,385
868,-1.350869376,0.68018326,010-AAW,-0.335343058,227,199,426
869,-1.350869376,0.68018326,010-AAX,-0.335343058,425,306,731
870,-1.350869376,0.68018326,010-AAY,-0.335343058,289,275,564
871,-1.350869376,0.68018326,010-ABD,-0.335343058,238,191,429
872,-1.350869376,0.68018326,010-AAZ,-0.335343058,307,227,534
873,-1.350869376,0.68018326,010-ABB,-0.335343058,265,233,498
874,-1.350869376,0.68018326,010-AAJ,-0.335343058,206,301,507
875,-1.350869376,0.68018326,010-AAL,-0.335343058,204,289,493
876,-1.350869376,0.68018326,010-AAM,-0.335343058,111,173,284
877,-1.350869376,0.68018326,010-AAC,-0.335343058,288,189,477
878,-1.350869376,0.68018326,010-AAD,-0.335343058,223,166,389
879,-1.350869376,0.68018326,010-ABE,-0.335343058,326,285,611
880,-1.350869376,0.68018326,010-ABG,-0.335343058,331,275,606
881,-1.350869376,0.68018326,010-ABH,-0.335343058,241,228,469
882,-1.350869376,0.68018326,010-ABJ,-0.335343058,384,354,738
883,-1.350869376,0.68018326,010-ABK,-0.335343058,270,231,501
884,-1.350869376,0.68018326,010-ABL,-0.335343058,288,244,532
885,-1.350869376,0.68018326,011-AAT,-0.335343058,422,153,575
886,-1.350869376,0.68018326,011-ABY,-0.335343058,504,254,758
887,-1.350869376,0.68018326,011-AAW,-0.335343058,580,383,963
888,-1.350869376,0.68018326,011-ABA,-0.335343058,290,129,419
889,-1.350869376,0.68018326,011-ABD,-0.335343058,416,193,609
890,-1.350869376,0.68018326,011-ABB,-0.335343058,385,249,634
891,-1.350869376,0.68018326,011-ABF,-0.335343058,496,267,763
892,-1.350869376,0.68018326,011-ACA,-0.335343058,400,216,616
893,-1.350869376,0.68018326,011-ABK,-0.335343058,542,360,902
894,-1.350869376,0.68018326,011-AAY,-0.335343058,329,310,639
895,-1.350869376,0.68018326,011-ABO,-0.335343058,334,258,592
896,-1.350869376,0.68018326,011-ABM,-0.335343058,316,182,498
897,-1.350869376,0.68018326,011-ABQ,-0.335343058,442,193,635
898,-1.350869376,0.68018326,011-ABR,-0.335343058,361,206,567
899,-1.350869376,0.68018326,011-ABH,-0.335343058,515,341,856
900,-1.350869376,0.68018326,011-ABS,-0.335343058,406,239,645
901,-1.350869376,0.68018326,011-ABT,-0.335343058,302,204,506
902,-1.350869376,0.68018326,011-AAA,-0.335343058,217,214,431
903,-1.350869376,0.68018326,011-AAB,-0.335343058,218,269,487
904,-1.350869376,0.68018326,011-AAE,-0.335343058,330,414,744
905,-1.350869376,0.68018326,011-AAH,-0.335343058,530,291,821
906,-1.350869376,0.68018326,011-AAK,-0.335343058,357,330,687
907,-1.350869376,0.68018326,011-AAN,-0.335343058,352,279,631
908,-1.350869376,0.68018326,011-AAP,-0.335343058,304,265,569
909,-1.350869376,0.68018326,011-AAR,-0.335343058,244,270,514
910,-1.350869376,0.68018326,011-ABU,-0.335343058,496,241,737
911,-1.350869376,0.68018326,011-ABV,-0.335343058,485,375,860
912,-1.350869376,0.68018326,011-ABW,-0.335343058,568,300,868
913,-1.350869376,0.68018326,012-ADF,-0.335343058,397,198,595
914,-1.350869376,0.68018326,012-ADG,-0.335343058,256,177,433
915,-1.350869376,0.68018326,012-ADH,-0.335343058,380,248,628
916,-1.350869376,0.68018326,012-ADI,-0.335343058,425,249,674
917,-1.350869376,0.68018326,012-ADJ,-0.335343058,471,252,723
918,-1.350869376,0.68018326,012-ADK,-0.335343058,391,210,601
919,-1.350869376,0.68018326,012-ADA,-0.335343058,429,174,603
920,-1.350869376,0.68018326,012-ADB,-0.335343058,405,343,748
921,-1.350869376,0.68018326,012-ADD,-0.335343058,573,406,979
922,-1.350869376,0.68018326,012-AAA,-0.335343058,514,405,919
923,-1.350869376,0.68018326,012-AAB,-0.335343058,363,209,572
924,-1.350869376,0.68018326,012-AAE,-0.335343058,475,301,776
925,-1.350869376,0.68018326,012-AED,-0.335343058,487,310,797
926,-1.350869376,0.68018326,012-AEF,-0.335343058,345,140,485
927,-1.350869376,0.68018326,012-AAT,-0.335343058,350,499,849
928,-1.350869376,0.68018326,012-ACU,-0.335343058,54,702,756
929,-1.350869376,0.68018326,012-ACF,-0.335343058,59,511,570
930,-1.350869376,0.68018326,012-ACV,-0.335343058,70,624,694
931,-1.350869376,0.68018326,012-ACT,-0.335343058,52,647,699
932,-1.350869376,0.68018326,012-ACR,-0.335343058,121,62,183
933,-1.350869376,0.68018326,012-ACO,-0.335343058,262,304,566
934,-1.350869376,0.68018326,012-ACN,-0.335343058,262,372,634
935,-1.350869376,0.68018326,012-ACM,-0.335343058,137,347,484
936,-1.350869376,0.68018326,012-AAG,-0.335343058,181,360,541
937,-1.350869376,0.68018326,012-AAH,-0.335343058,154,236,390
938,-1.350869376,0.68018326,012-AAS,-0.335343058,283,326,609
939,-1.350869376,0.68018326,012-AAI,-0.335343058,224,327,551
940,-1.350869376,0.68018326,012-AAJ,-0.335343058,227,298,525
941,-1.350869376,0.68018326,012-AAK,-0.335343058,223,282,505
942,-1.350869376,0.68018326,012-AAL,-0.335343058,163,261,424
943,-1.350869376,0.68018326,012-ABE,-0.335343058,174,427,601
944,-1.350869376,0.68018326,012-ABD,-0.335343058,180,456,636
945,-1.350869376,0.68018326,012-ABC,-0.335343058,423,359,782
946,-1.350869376,0.68018326,012-ABH,-0.335343058,282,328,610
947,-1.350869376,0.68018326,012-ABG,-0.335343058,312,294,606
948,-1.350869376,0.68018326,012-ABF,-0.335343058,259,448,707
949,-1.350869376,0.68018326,012-AAR,-0.335343058,236,388,624
950,-1.350869376,0.68018326,012-ABJ,-0.335343058,275,426,701
951,-1.350869376,0.68018326,012-ABI,-0.335343058,423,418,841
952,-1.350869376,0.68018326,012-ABK,-0.335343058,325,370,695
953,-1.350869376,0.68018326,012-ABX,-0.335343058,288,284,572
954,-1.350869376,0.68018326,012-ABZ,-0.335343058,378,359,737
955,-1.350869376,0.68018326,012-ACA,-0.335343058,283,355,638
956,-1.350869376,0.68018326,012-ACB,-0.335343058,253,328,581
957,-1.350869376,0.68018326,012-ACC,-0.335343058,454,414,868
958,-1.350869376,0.68018326,012-ACD,-0.335343058,675,478,1153
959,-1.350869376,0.68018326,012-AAP,-0.335343058,258,530,788
960,-1.350869376,0.68018326,012-AAO,-0.335343058,175,465,640
961,-1.350869376,0.68018326,012-AAQ,-0.335343058,137,467,604
962,-1.350869376,0.68018326,012-ACI,-0.335343058,51,623,674
963,-1.350869376,0.68018326,012-ACH,-0.335343058,141,818,959
964,-1.350869376,0.68018326,012-ACG,-0.335343058,73,401,474
965,-1.350869376,0.68018326,012-AEG,-0.335343058,454,257,711
966,-1.350869376,0.68018326,012-AEI,-0.335343058,509,312,821
967,-1.350869376,0.68018326,012-ADM,-0.335343058,471,300,771
968,-1.350869376,0.68018326,012-ADN,-0.335343058,415,237,652
969,-1.350869376,0.68018326,012-ADO,-0.335343058,208,203,411
970,-1.350869376,0.68018326,012-ADP,-0.335343058,424,335,759
971,-1.350869376,0.68018326,012-ADQ,-0.335343058,603,373,976
972,-1.350869376,0.68018326,012-ADS,-0.335343058,310,203,513
973,-1.350869376,0.68018326,012-ADV,-0.335343058,411,259,670
974,-1.350869376,0.68018326,012-ADW,-0.335343058,559,364,923
975,-1.350869376,0.68018326,012-ADZ,-0.335343058,314,248,562
976,-1.350869376,0.68018326,012-AEA,-0.335343058,476,296,772
977,-1.350869376,0.68018326,012-AEB,-0.335343058,282,216,498
978,-1.350869376,0.68018326,012-AEV,-0.335343058,188,140,328
979,-1.350869376,0.68018326,012-AEX,-0.335343058,295,259,554
980,-1.350869376,0.68018326,012-AEY,-0.335343058,342,265,607
981,-1.350869376,0.68018326,012-AFA,-0.335343058,715,418,1133
982,-1.350869376,0.68018326,012-AFB,-0.335343058,473,366,839
983,-1.350869376,0.68018326,012-AEU,-0.335343058,420,244,664
984,-1.350869376,0.68018326,012-AFD,-0.335343058,455,281,736
985,-1.350869376,0.68018326,012-AFE,-0.335343058,398,348,746
986,-1.350869376,0.68018326,012-AFF,-0.335343058,288,239,527
987,-1.350869376,0.68018326,012-AFG,-0.335343058,373,301,674
988,-1.350869376,0.68018326,012-AEW,-0.335343058,366,272,638
989,-1.350869376,0.68018326,012-AEK,-0.335343058,643,398,1041
990,-1.350869376,0.68018326,012-AEM,-0.335343058,515,275,790
991,-1.350869376,0.68018326,012-AEN,-0.335343058,327,193,520
992,-1.350869376,0.68018326,012-AEP,-0.335343058,326,174,500
993,-1.350869376,0.68018326,012-AEQ,-0.335343058,579,351,930
994,-1.350869376,0.68018326,012-AER,-0.335343058,253,192,445
995,-1.350869376,0.68018326,012-AET,-0.335343058,360,159,519
996,-1.350869376,0.68018326,012-AFH,-0.335343058,590,295,885
997,-1.350869376,0.68018326,012-AFI,-0.335343058,703,367,1070
998,-1.350869376,0.68018326,012-AFL,-0.335343058,307,237,544
999,-1.350869376,0.68018326,012-AFM,-0.335343058,276,205,481
1000,-1.350869376,0.68018326,012-AFN,-0.335343058,305,225,530
1001,-1.350869376,0.68018326,012-AFO,-0.335343058,450,269,719
1002,-1.350869376,0.68018326,012-AFP,-0.335343058,301,308,609
1003,-1.350869376,0.68018326,012-AFQ,-0.335343058,454,298,752
1004,-1.350869376,0.68018326,012-AFR,-0.335343058,179,258,437
1005,-1.350869376,0.68018326,012-AFW,-0.335343058,434,263,697
1006,-1.350869376,0.68018326,012-AGD,-0.335343058,246,257,503
1007,-1.350869376,0.68018326,012-AFX,-0.335343058,309,255,564
1008,-1.350869376,0.68018326,012-AFY,-0.335343058,274,156,430
1009,-1.350869376,0.68018326,012-AFZ,-0.335343058,300,222,522
1010,-1.350869376,0.68018326,012-AGA,-0.335343058,304,185,489
1011,-1.350869376,0.68018326,012-AGB,-0.335343058,332,232,564
1012,-1.350869376,0.68018326,012-AGC,-0.335343058,330,232,562
1013,-1.350869376,0.68018326,013-AED,-0.335343058,392,219,611
1014,-1.350869376,0.68018326,013-AAO,-0.335343058,425,268,693
1015,-1.350869376,0.68018326,013-AHQ,-0.335343058,386,192,578
1016,-1.350869376,0.68018326,013-AAC,-0.335343058,456,260,716
1017,-1.350869376,0.68018326,013-AAD,-0.335343058,492,305,797
1018,-1.350869376,0.68018326,013-AAE,-0.335343058,417,252,669
1019,-1.350869376,0.68018326,013-AAF,-0.335343058,583,244,827
1020,-1.350869376,0.68018326,013-AAG,-0.335343058,457,312,769
1021,-1.350869376,0.68018326,013-AAH,-0.335343058,242,134,376
1022,-1.350869376,0.68018326,013-AAI,-0.335343058,582,289,871
1023,-1.350869376,0.68018326,013-AAJ,-0.335343058,360,140,500
1024,-1.350869376,0.68018326,013-AAK,-0.335343058,195,80,275
1025,-1.350869376,0.68018326,013-AAL,-0.335343058,499,274,773
1026,-1.350869376,0.68018326,013-AAM,-0.335343058,635,350,985
1027,-1.350869376,0.68018326,013-AAN,-0.335343058,188,171,359
1028,-1.350869376,0.68018326,013-AHR,-0.335343058,383,187,570
1029,-1.350869376,0.68018326,013-AAP,-0.335343058,175,100,275
1030,-1.350869376,0.68018326,013-AAQ,-0.335343058,110,83,193
1031,-1.350869376,0.68018326,013-AAR,-0.335343058,153,79,232
1032,-1.350869376,0.68018326,013-AEV,-0.335343058,300,118,418
1033,-1.350869376,0.68018326,013-AEW,-0.335343058,108,79,187
1034,-1.350869376,0.68018326,013-AEX,-0.335343058,215,136,351
1035,-1.350869376,0.68018326,013-AHO,-0.335343058,98,114,212
1036,-1.350869376,0.68018326,013-AAS,-0.335343058,174,100,274
1037,-1.350869376,0.68018326,013-AAT,-0.335343058,179,98,277
1038,-1.350869376,0.68018326,013-AAU,-0.335343058,280,122,402
1039,-1.350869376,0.68018326,013-AAV,-0.335343058,338,164,502
1040,-1.350869376,0.68018326,013-AAZ,-0.335343058,165,80,245
1041,-1.350869376,0.68018326,013-ABA,-0.335343058,360,143,503
1042,-1.350869376,0.68018326,013-ABB,-0.335343058,166,65,231
1043,-1.350869376,0.68018326,013-ABC,-0.335343058,411,117,528
1044,-1.350869376,0.68018326,013-ABD,-0.335343058,483,227,710
1045,-1.350869376,0.68018326,013-ABE,-0.335343058,205,94,299
1046,-1.350869376,0.68018326,013-ABF,-0.335343058,304,174,478
1047,-1.350869376,0.68018326,013-ABG,-0.335343058,226,110,336
1048,-1.350869376,0.68018326,013-ABH,-0.335343058,274,170,444
1049,-1.350869376,0.68018326,013-ABI,-0.335343058,322,104,426
1050,-1.350869376,0.68018326,013-ABJ,-0.335343058,272,110,382
1051,-1.350869376,0.68018326,013-ABK,-0.335343058,466,227,693
1052,-1.350869376,0.68018326,013-ABL,-0.335343058,283,163,446
1053,-1.350869376,0.68018326,013-ABM,-0.335343058,594,229,823
1054,-1.350869376,0.68018326,013-ABN,-0.335343058,369,145,514
1055,-1.350869376,0.68018326,013-ABO,-0.335343058,224,82,306
1056,-1.350869376,0.68018326,013-ABP,-0.335343058,439,181,620
1057,-1.350869376,0.68018326,013-AAA,-0.335343058,143,123,266
1058,-1.350869376,0.68018326,013-AAB,-0.335343058,451,235,686
1059,-1.350869376,0.68018326,013-ABQ,-0.335343058,307,166,473
1060,-1.350869376,0.68018326,013-ABR,-0.335343058,309,150,459
1061,-1.350869376,0.68018326,013-ABS,-0.335343058,135,123,258
1062,-1.350869376,0.68018326,013-ABT,-0.335343058,360,189,549
1063,-1.350869376,0.68018326,013-ABU,-0.335343058,441,182,623
1064,-1.350869376,0.68018326,013-ABV,-0.335343058,351,177,528
1065,-1.350869376,0.68018326,013-ABW,-0.335343058,267,107,374
1066,-1.350869376,0.68018326,013-ABX,-0.335343058,400,187,587
1067,-1.350869376,0.68018326,013-ABY,-0.335343058,247,118,365
1068,-1.350869376,0.68018326,013-ABZ,-0.335343058,171,108,279
1069,-1.350869376,0.68018326,013-ACA,-0.335343058,559,328,887
1070,-1.350869376,0.68018326,013-ACB,-0.335343058,608,348,956
1071,-1.350869376,0.68018326,013-ACC,-0.335343058,344,142,486
1072,-1.350869376,0.68018326,013-ACD,-0.335343058,449,182,631
1073,-1.350869376,0.68018326,013-ACE,-0.335343058,256,152,408
1074,-1.350869376,0.68018326,013-ACF,-0.335343058,277,135,412
1075,-1.350869376,0.68018326,013-ACG,-0.335343058,237,106,343
1076,-1.350869376,0.68018326,013-ACH,-0.335343058,194,95,289
1077,-1.350869376,0.68018326,013-ACI,-0.335343058,210,88,298
1078,-1.350869376,0.68018326,013-ACJ,-0.335343058,213,99,312
1079,-1.350869376,0.68018326,013-ACK,-0.335343058,393,191,584
1080,-1.350869376,0.68018326,013-ACL,-0.335343058,444,190,634
1081,-1.350869376,0.68018326,013-ACM,-0.335343058,406,147,553
1082,-1.350869376,0.68018326,013-AHS,-0.335343058,332,152,484
1083,-1.350869376,0.68018326,013-ACN,-0.335343058,436,207,643
1084,-1.350869376,0.68018326,013-AHT,-0.335343058,406,225,631
1085,-1.350869376,0.68018326,013-ACO,-0.335343058,410,217,627
1086,-1.350869376,0.68018326,013-AHU,-0.335343058,478,168,646
1087,-1.350869376,0.68018326,013-ACP,-0.335343058,170,91,261
1088,-1.350869376,0.68018326,013-AHV,-0.335343058,770,307,1077
1089,-1.350869376,0.68018326,013-ACQ,-0.335343058,239,131,370
1090,-1.350869376,0.68018326,013-AHW,-0.335343058,458,215,673
1091,-1.350869376,0.68018326,013-ACR,-0.335343058,358,176,534
1092,-1.350869376,0.68018326,013-ACS,-0.335343058,438,220,658
1093,-1.350869376,0.68018326,013-ACT,-0.335343058,267,101,368
1094,-1.350869376,0.68018326,013-ACU,-0.335343058,138,94,232
1095,-1.350869376,0.68018326,013-ACV,-0.335343058,266,104,370
1096,-1.350869376,0.68018326,013-ACW,-0.335343058,310,172,482
1097,-1.350869376,0.68018326,013-ACX,-0.335343058,299,163,462
1098,-1.350869376,0.68018326,013-ACY,-0.335343058,430,186,616
1099,-1.350869376,0.68018326,013-ACZ,-0.335343058,727,335,1062
1100,-1.350869376,0.68018326,013-ADA,-0.335343058,852,323,1175
1101,-1.350869376,0.68018326,013-AHG,-0.335343058,215,155,370
1102,-1.350869376,0.68018326,013-AHH,-0.335343058,225,155,380
1103,-1.350869376,0.68018326,013-AHI,-0.335343058,100,80,180
1104,-1.350869376,0.68018326,013-AHJ,-0.335343058,129,104,233
1105,-1.350869376,0.68018326,013-AHK,-0.335343058,247,182,429
1106,-1.350869376,0.68018326,013-AHL,-0.335343058,213,179,392
1107,-1.350869376,0.68018326,013-AHM,-0.335343058,292,252,544
1108,-1.350869376,0.68018326,013-AHN,-0.335343058,488,243,731
1109,-1.350869376,0.68018326,013-ADB,-0.335343058,140,103,243
1110,-1.350869376,0.68018326,013-ADC,-0.335343058,217,120,337
1111,-1.350869376,0.68018326,013-ADD,-0.335343058,199,89,288
1112,-1.350869376,0.68018326,013-ADE,-0.335343058,176,91,267
1113,-1.350869376,0.68018326,013-ADF,-0.335343058,461,228,689
1114,-1.350869376,0.68018326,013-ADG,-0.335343058,251,93,344
1115,-1.350869376,0.68018326,013-ADH,-0.335343058,183,122,305
1116,-1.350869376,0.68018326,013-ADI,-0.335343058,94,40,134
1117,-1.350869376,0.68018326,013-ADJ,-0.335343058,134,100,234
1118,-1.350869376,0.68018326,013-ADK,-0.335343058,202,98,300
1119,-1.350869376,0.68018326,013-AGP,-0.335343058,75,43,118
1120,-1.350869376,0.68018326,013-ADO,-0.335343058,203,193,396
1121,-1.350869376,0.68018326,013-ADP,-0.335343058,142,118,260
1122,-1.350869376,0.68018326,013-ADQ,-0.335343058,240,130,370
1123,-1.350869376,0.68018326,013-AGT,-0.335343058,92,50,142
1124,-1.350869376,0.68018326,013-ADL,-0.335343058,263,150,413
1125,-1.350869376,0.68018326,013-ADM,-0.335343058,192,112,304
1126,-1.350869376,0.68018326,013-ADN,-0.335343058,250,125,375
1127,-1.350869376,0.68018326,013-AEE,-0.335343058,198,137,335
1128,-1.350869376,0.68018326,013-ADR,-0.335343058,289,124,413
1129,-1.350869376,0.68018326,013-ADS,-0.335343058,783,284,1067
1130,-1.350869376,0.68018326,013-ADT,-0.335343058,271,169,440
1131,-1.350869376,0.68018326,013-ADU,-0.335343058,270,134,404
1132,-1.350869376,0.68018326,013-ADV,-0.335343058,532,203,735
1133,-1.350869376,0.68018326,013-ADW,-0.335343058,297,124,421
1134,-1.350869376,0.68018326,013-ADX,-0.335343058,378,164,542
1135,-1.350869376,0.68018326,013-ADY,-0.335343058,89,47,136
1136,-1.350869376,0.68018326,013-ADZ,-0.335343058,543,224,767
1137,-1.350869376,0.68018326,013-AEA,-0.335343058,326,180,506
1138,-1.350869376,0.68018326,013-AEB,-0.335343058,344,181,525
1139,-1.350869376,0.68018326,013-AEC,-0.335343058,186,80,266
1140,-1.350869376,0.68018326,013-AEF,-0.335343058,261,79,340
1141,-1.350869376,0.68018326,013-AEG,-0.335343058,358,117,475
1142,-1.350869376,0.68018326,013-AEH,-0.335343058,378,140,518
1143,-1.350869376,0.68018326,013-AEI,-0.335343058,205,87,292
1144,-1.350869376,0.68018326,013-AEJ,-0.335343058,371,158,529
1145,-1.350869376,0.68018326,013-AEK,-0.335343058,293,116,409
1146,-1.350869376,0.68018326,013-AEL,-0.335343058,206,67,273
1147,-1.350869376,0.68018326,013-AEM,-0.335343058,284,124,408
1148,-1.350869376,0.68018326,013-AEN,-0.335343058,216,79,295
1149,-1.350869376,0.68018326,013-AEO,-0.335343058,265,111,376
1150,-1.350869376,0.68018326,013-AEP,-0.335343058,278,106,384
1151,-1.350869376,0.68018326,013-AEQ,-0.335343058,193,65,258
1152,-1.350869376,0.68018326,013-AER,-0.335343058,208,67,275
1153,-1.350869376,0.68018326,013-AES,-0.335343058,279,98,377
1154,-1.350869376,0.68018326,013-AET,-0.335343058,457,163,620
1155,-1.350869376,0.68018326,013-AEU,-0.335343058,218,99,317
1156,-1.350869376,0.68018326,013-AEY,-0.335343058,530,227,757
1157,-1.350869376,0.68018326,013-AEZ,-0.335343058,199,117,316
1158,-1.350869376,0.68018326,013-AFA,-0.335343058,436,290,726
1159,-1.350869376,0.68018326,013-AFB,-0.335343058,461,269,730
1160,-1.350869376,0.68018326,013-AFC,-0.335343058,343,177,520
1161,-1.350869376,0.68018326,013-AFD,-0.335343058,456,218,674
1162,-1.350869376,0.68018326,013-AFE,-0.335343058,541,251,792
1163,-1.350869376,0.68018326,013-AFF,-0.335343058,336,197,533
1164,-1.350869376,0.68018326,013-AFG,-0.335343058,528,283,811
1165,-1.350869376,0.68018326,013-AFH,-0.335343058,457,218,675
1166,-1.350869376,0.68018326,013-AFI,-0.335343058,187,84,271
1167,-1.350869376,0.68018326,013-AFJ,-0.335343058,608,279,887
1168,-1.350869376,0.68018326,013-AFK,-0.335343058,182,95,277
1169,-1.350869376,0.68018326,013-AFL,-0.335343058,111,65,176
1170,-1.350869376,0.68018326,013-AFM,-0.335343058,313,281,594
1171,-1.350869376,0.68018326,013-AFO,-0.335343058,351,200,551
1172,-1.350869376,0.68018326,013-AFP,-0.335343058,226,115,341
1173,-1.350869376,0.68018326,013-AFQ,-0.335343058,384,215,599
1174,-1.350869376,0.68018326,013-AFR,-0.335343058,245,146,391
1175,-1.350869376,0.68018326,013-AFS,-0.335343058,376,294,670
1176,-1.350869376,0.68018326,013-AFT,-0.335343058,309,197,506
1177,-1.350869376,0.68018326,013-AFU,-0.335343058,311,266,577
1178,-1.350869376,0.68018326,013-AFV,-0.335343058,254,141,395
1179,-1.350869376,0.68018326,013-AFW,-0.335343058,299,124,423
1180,-1.350869376,0.68018326,013-AFX,-0.335343058,190,119,309
1181,-1.350869376,0.68018326,013-AFY,-0.335343058,196,126,322
1182,-1.350869376,0.68018326,013-AGA,-0.335343058,308,177,485
1183,-1.350869376,0.68018326,013-AGC,-0.335343058,306,214,520
1184,-1.350869376,0.68018326,013-AGD,-0.335343058,454,245,699
1185,-1.350869376,0.68018326,013-AGE,-0.335343058,376,165,541
1186,-1.350869376,0.68018326,013-AGG,-0.335343058,181,109,290
1187,-1.350869376,0.68018326,013-AHP,-0.335343058,575,336,911
1188,-1.350869376,0.68018326,013-AGH,-0.335343058,267,149,416
1189,-1.350869376,0.68018326,013-AHX,-0.335343058,475,168,643
1190,-1.350869376,0.68018326,013-AGI,-0.335343058,293,133,426
1191,-1.350869376,0.68018326,013-AGJ,-0.335343058,504,236,740
1192,-1.350869376,0.68018326,013-AHY,-0.335343058,381,177,558
1193,-1.350869376,0.68018326,013-AGK,-0.335343058,122,52,174
1194,-1.350869376,0.68018326,013-AGL,-0.335343058,332,191,523
1195,-1.350869376,0.68018326,013-AGM,-0.335343058,283,155,438
1196,-1.350869376,0.68018326,013-AGN,-0.335343058,254,158,412
1197,-1.350869376,0.68018326,013-AGO,-0.335343058,283,132,415
1198,-1.350869376,0.68018326,013-AGQ,-0.335343058,291,152,443
1199,-1.350869376,0.68018326,013-AGR,-0.335343058,119,81,200
1200,-1.350869376,0.68018326,013-AGS,-0.335343058,127,117,244
1201,-1.350869376,0.68018326,013-AGU,-0.335343058,249,106,355
1202,-1.350869376,0.68018326,013-AGV,-0.335343058,370,159,529
1203,-1.350869376,0.68018326,013-AGW,-0.335343058,229,104,333
1204,-1.350869376,0.68018326,013-AGX,-0.335343058,230,126,356
1205,-1.350869376,0.68018326,013-AGY,-0.335343058,285,118,403
1206,-1.350869376,0.68018326,013-AGZ,-0.335343058,333,153,486
1207,-1.350869376,0.68018326,013-AHA,-0.335343058,246,116,362
1208,-1.350869376,0.68018326,013-AHB,-0.335343058,242,152,394
1209,-1.350869376,0.68018326,013-AHC,-0.335343058,245,103,348
1210,-1.350869376,0.68018326,013-AHD,-0.335343058,176,87,263
1211,-1.350869376,0.68018326,013-AHE,-0.335343058,181,83,264
1212,-1.350869376,0.68018326,013-AHF,-0.335343058,273,135,408
1213,-1.350869376,0.68018326,014-AAQ,-0.335343058,400,133,533
1214,-1.350869376,0.68018326,014-ACD,-0.335343058,453,197,650
1215,-1.350869376,0.68018326,014-ABG,-0.335343058,338,198,536
1216,-1.350869376,0.68018326,014-ABI,-0.335343058,226,111,337
1217,-1.350869376,0.68018326,014-ABJ,-0.335343058,532,263,795
1218,-1.350869376,0.68018326,014-AAS,-0.335343058,406,196,602
1219,-1.350869376,0.68018326,014-ACB,-0.335343058,353,172,525
1220,-1.350869376,0.68018326,014-AAU,-0.335343058,517,214,731
1221,-1.350869376,0.68018326,014-ABS,-0.335343058,123,54,177
1222,-1.350869376,0.68018326,014-ABY,-0.335343058,450,186,636
1223,-1.350869376,0.68018326,014-ABA,-0.335343058,329,150,479
1224,-1.350869376,0.68018326,014-ABC,-0.335343058,319,155,474
1225,-1.350869376,0.68018326,014-ABE,-0.335343058,465,158,623
1226,-1.350869376,0.68018326,014-AAW,-0.335343058,118,35,153
1227,-1.350869376,0.68018326,014-ABB,-0.335343058,43,49,92
1228,-1.350869376,0.68018326,014-AAY,-0.335343058,252,153,405
1229,-1.350869376,0.68018326,014-ABD,-0.335343058,48,45,93
1230,-1.350869376,0.68018326,014-ABK,-0.335343058,344,149,493
1231,-1.350869376,0.68018326,014-ABM,-0.335343058,356,222,578
1232,-1.350869376,0.68018326,014-ABN,-0.335343058,239,154,393
1233,-1.350869376,0.68018326,014-ABQ,-0.335343058,381,154,535
1234,-1.350869376,0.68018326,014-ACE,-0.335343058,313,175,488
1235,-1.350869376,0.68018326,014-ABR,-0.335343058,608,256,864
1236,-1.350869376,0.68018326,014-ABT,-0.335343058,404,148,552
1237,-1.350869376,0.68018326,014-ABZ,-0.335343058,465,163,628
1238,-1.350869376,0.68018326,014-ABU,-0.335343058,337,141,478
1239,-1.350869376,0.68018326,014-ACC,-0.335343058,410,181,591
1240,-1.350869376,0.68018326,014-ABW,-0.335343058,267,88,355
1241,-1.350869376,0.68018326,014-AAA,-0.335343058,284,211,495
1242,-1.350869376,0.68018326,014-AAB,-0.335343058,417,224,641
1243,-1.350869376,0.68018326,014-AAE,-0.335343058,227,220,447
1244,-1.350869376,0.68018326,014-AAF,-0.335343058,184,242,426
1245,-1.350869376,0.68018326,014-AAI,-0.335343058,263,194,457
1246,-1.350869376,0.68018326,014-AAJ,-0.335343058,464,382,846
1247,-1.350869376,0.68018326,014-AAM,-0.335343058,242,241,483
1248,-1.350869376,0.68018326,014-AAN,-0.335343058,331,294,625
1249,-1.350869376,0.68018326,014-ACA,-0.335343058,314,179,493
1250,-1.350869376,0.68018326,014-ABX,-0.335343058,187,71,258
1251,-1.350869376,0.68018326,015-ABX,-0.335343058,392,159,551
1252,-1.350869376,0.68018326,015-ABY,-0.335343058,423,232,655
1253,-1.350869376,0.68018326,015-ABZ,-0.335343058,444,167,611
1254,-1.350869376,0.68018326,015-ACB,-0.335343058,283,205,488
1255,-1.350869376,0.68018326,015-ACC,-0.335343058,240,245,485
1256,-1.350869376,0.68018326,015-ACD,-0.335343058,244,257,501
1257,-1.350869376,0.68018326,015-ACR,-0.335343058,307,190,497
1258,-1.350869376,0.68018326,015-ACS,-0.335343058,146,178,324
1259,-1.350869376,0.68018326,015-ACT,-0.335343058,253,209,462
1260,-1.350869376,0.68018326,015-ACU,-0.335343058,492,297,789
1261,-1.350869376,0.68018326,015-ACV,-0.335343058,292,256,548
1262,-1.350869376,0.68018326,015-ACW,-0.335343058,202,194,396
1263,-1.350869376,0.68018326,015-AAA,-0.335343058,188,219,407
1264,-1.350869376,0.68018326,015-AAB,-0.335343058,105,283,388
1265,-1.350869376,0.68018326,015-AAC,-0.335343058,65,114,179
1266,-1.350869376,0.68018326,015-AAF,-0.335343058,63,71,134
1267,-1.350869376,0.68018326,015-AAG,-0.335343058,130,163,293
1268,-1.350869376,0.68018326,015-AAH,-0.335343058,190,245,435
1269,-1.350869376,0.68018326,015-AAK,-0.335343058,288,224,512
1270,-1.350869376,0.68018326,015-AAL,-0.335343058,165,263,428
1271,-1.350869376,0.68018326,015-AAM,-0.335343058,58,74,132
1272,-1.350869376,0.68018326,015-AAP,-0.335343058,75,132,207
1273,-1.350869376,0.68018326,015-AAQ,-0.335343058,153,186,339
1274,-1.350869376,0.68018326,015-AAR,-0.335343058,117,120,237
1275,-1.350869376,0.68018326,015-AAS,-0.335343058,235,241,476
1276,-1.350869376,0.68018326,015-AAU,-0.335343058,179,237,416
1277,-1.350869376,0.68018326,015-AAW,-0.335343058,237,239,476
1278,-1.350869376,0.68018326,015-AAX,-0.335343058,332,291,623
1279,-1.350869376,0.68018326,015-ACJ,-0.335343058,224,220,444
1280,-1.350869376,0.68018326,015-ACK,-0.335343058,286,235,521
1281,-1.350869376,0.68018326,015-ACM,-0.335343058,278,188,466
1282,-1.350869376,0.68018326,015-ACN,-0.335343058,379,188,567
1283,-1.350869376,0.68018326,015-ACP,-0.335343058,245,173,418
1284,-1.350869376,0.68018326,015-ACQ,-0.335343058,313,214,527
1285,-1.350869376,0.68018326,015-ACZ,-0.335343058,226,144,370
1286,-1.350869376,0.68018326,015-ADC,-0.335343058,418,324,742
1287,-1.350869376,0.68018326,015-ADB,-0.335343058,375,247,622
1288,-1.350869376,0.68018326,015-ADD,-0.335343058,285,178,463
1289,-1.350869376,0.68018326,015-ADF,-0.335343058,301,228,529
1290,-1.350869376,0.68018326,015-ADG,-0.335343058,399,240,639
1291,-1.350869376,0.68018326,015-ADH,-0.335343058,246,144,390
1292,-1.350869376,0.68018326,015-ADI,-0.335343058,372,211,583
1293,-1.350869376,0.68018326,015-AEQ,-0.335343058,254,270,524
1294,-1.350869376,0.68018326,015-AER,-0.335343058,171,216,387
1295,-1.350869376,0.68018326,015-ACE,-0.335343058,274,277,551
1296,-1.350869376,0.68018326,015-ACH,-0.335343058,165,170,335
1297,-1.350869376,0.68018326,015-ACI,-0.335343058,155,152,307
1298,-1.350869376,0.68018326,015-ADJ,-0.335343058,213,157,370
1299,-1.350869376,0.68018326,015-ADL,-0.335343058,383,262,645
1300,-1.350869376,0.68018326,015-ADM,-0.335343058,267,218,485
1301,-1.350869376,0.68018326,015-ADN,-0.335343058,223,271,494
1302,-1.350869376,0.68018326,015-ADO,-0.335343058,275,202,477
1303,-1.350869376,0.68018326,015-ADP,-0.335343058,295,209,504
1304,-1.350869376,0.68018326,015-ADQ,-0.335343058,312,324,636
1305,-1.350869376,0.68018326,015-ADU,-0.335343058,355,221,576
1306,-1.350869376,0.68018326,015-ADS,-0.335343058,249,239,488
1307,-1.350869376,0.68018326,015-ADR,-0.335343058,358,208,566
1308,-1.350869376,0.68018326,015-ADW,-0.335343058,266,142,408
1309,-1.350869376,0.68018326,015-ADX,-0.335343058,298,269,567
1310,-1.350869376,0.68018326,015-ADZ,-0.335343058,245,175,420
1311,-1.350869376,0.68018326,015-ADY,-0.335343058,296,285,581
1312,-1.350869376,0.68018326,015-AEA,-0.335343058,200,199,399
1313,-1.350869376,0.68018326,015-ABA,-0.335343058,138,173,311
1314,-1.350869376,0.68018326,015-ABB,-0.335343058,365,276,641
1315,-1.350869376,0.68018326,015-ABC,-0.335343058,329,251,580
1316,-1.350869376,0.68018326,015-ABE,-0.335343058,173,212,385
1317,-1.350869376,0.68018326,015-ABF,-0.335343058,153,184,337
1318,-1.350869376,0.68018326,015-ABG,-0.335343058,195,233,428
1319,-1.350869376,0.68018326,015-ABI,-0.335343058,115,179,294
1320,-1.350869376,0.68018326,015-ABJ,-0.335343058,144,137,281
1321,-1.350869376,0.68018326,015-ABK,-0.335343058,224,204,428
1322,-1.350869376,0.68018326,015-ABL,-0.335343058,235,175,410
1323,-1.350869376,0.68018326,015-ABM,-0.335343058,255,179,434
1324,-1.350869376,0.68018326,015-ABN,-0.335343058,253,234,487
1325,-1.350869376,0.68018326,015-ABO,-0.335343058,173,223,396
1326,-1.350869376,0.68018326,015-AEM,-0.335343058,393,250,643
1327,-1.350869376,0.68018326,015-AEN,-0.335343058,340,256,596
1328,-1.350869376,0.68018326,015-AEO,-0.335343058,331,204,535
1329,-1.350869376,0.68018326,015-AEZ,-0.335343058,227,237,464
1330,-1.350869376,0.68018326,015-AED,-0.335343058,274,208,482
1331,-1.350869376,0.68018326,015-AEF,-0.335343058,362,301,663
1332,-1.350869376,0.68018326,015-AEG,-0.335343058,155,158,313
1333,-1.350869376,0.68018326,015-AEI,-0.335343058,230,192,422
1334,-1.350869376,0.68018326,015-AEH,-0.335343058,249,238,487
1335,-1.350869376,0.68018326,015-AEK,-0.335343058,429,271,700
1336,-1.350869376,0.68018326,015-AEJ,-0.335343058,171,154,325
1337,-1.350869376,0.68018326,015-AEL,-0.335343058,238,260,498
1338,-1.350869376,0.68018326,015-AET,-0.335343058,264,286,550
1339,-1.350869376,0.68018326,015-AEU,-0.335343058,330,260,590
1340,-1.350869376,0.68018326,015-AEV,-0.335343058,353,275,628
1341,-1.350869376,0.68018326,015-AEW,-0.335343058,318,216,534
1342,-1.350869376,0.68018326,015-AEY,-0.335343058,237,165,402
1343,-1.350869376,0.68018326,015-AFB,-0.335343058,212,196,408
1344,-1.350869376,0.68018326,015-ABQ,-0.335343058,74,140,214
1345,-1.350869376,0.68018326,015-ABR,-0.335343058,122,190,312
1346,-1.350869376,0.68018326,015-ABT,-0.335343058,94,216,310
1347,-1.350869376,0.68018326,015-ABV,-0.335343058,74,160,234
1348,-1.350869376,0.68018326,015-ABW,-0.335343058,98,173,271
1349,-1.350869376,0.68018326,015-AFC,-0.335343058,263,205,468
1350,-1.350869376,0.68018326,015-AFD,-0.335343058,302,267,569
1351,-1.350869376,0.68018326,015-AFE,-0.335343058,277,122,399
1352,-1.350869376,0.68018326,015-AFF,-0.335343058,348,364,712
1353,-1.350869376,0.68018326,015-AFH,-0.335343058,169,167,336
1354,-1.350869376,0.68018326,016-AAO,-0.335343058,219,134,353
1355,-1.350869376,0.68018326,016-AAP,-0.335343058,163,106,269
1356,-1.350869376,0.68018326,016-AAQ,-0.335343058,347,254,601
1357,-1.350869376,0.68018326,016-AAR,-0.335343058,140,100,240
1358,-1.350869376,0.68018326,016-AAA,-0.335343058,175,184,359
1359,-1.350869376,0.68018326,016-AAB,-0.335343058,95,221,316
1360,-1.350869376,0.68018326,016-AAC,-0.335343058,99,185,284
1361,-1.350869376,0.68018326,016-AAD,-0.335343058,240,266,506
1362,-1.350869376,0.68018326,016-AAE,-0.335343058,84,160,244
1363,-1.350869376,0.68018326,016-AAF,-0.335343058,129,152,281
1364,-1.350869376,0.68018326,016-AAG,-0.335343058,141,199,340
1365,-1.350869376,0.68018326,016-AAH,-0.335343058,186,203,389
1366,-1.350869376,0.68018326,016-AAI,-0.335343058,299,216,515
1367,-1.350869376,0.68018326,016-AAJ,-0.335343058,193,152,345
1368,-1.350869376,0.68018326,016-AAK,-0.335343058,152,218,370
1369,-1.350869376,0.68018326,016-AAL,-0.335343058,169,172,341
1370,-1.350869376,0.68018326,016-AAM,-0.335343058,169,149,318
1371,-1.350869376,0.68018326,016-AAN,-0.335343058,326,189,515
1372,-1.350869376,0.68018326,016-AAS,-0.335343058,175,90,265
1373,-1.350869376,0.68018326,016-AAT,-0.335343058,320,271,591
1374,-1.350869376,0.68018326,016-AAU,-0.335343058,340,253,593
1375,-1.350869376,0.68018326,016-AAV,-0.335343058,257,170,427
1376,-1.350869376,0.68018326,016-AAW,-0.335343058,252,217,469
1377,-1.350869376,0.68018326,016-AAY,-0.335343058,251,209,460
1378,-1.350869376,0.68018326,016-AAZ,-0.335343058,260,193,453
1379,-1.350869376,0.68018326,016-ABA,-0.335343058,276,301,577
1380,-1.350869376,0.68018326,016-ABB,-0.335343058,166,186,352
1381,-1.350869376,0.68018326,016-ABE,-0.335343058,164,182,346
1382,-1.350869376,0.68018326,016-ABF,-0.335343058,122,60,182
1383,-1.350869376,0.68018326,016-ABG,-0.335343058,134,101,235
1384,-1.350869376,0.68018326,016-ABH,-0.335343058,135,73,208
1385,-1.350869376,0.68018326,016-ABI,-0.335343058,417,366,783
1386,-1.350869376,0.68018326,016-ABJ,-0.335343058,211,101,312
1387,-1.350869376,0.68018326,016-ABK,-0.335343058,186,95,281
1388,-1.350869376,0.68018326,016-ABL,-0.335343058,107,32,139
1389,-1.350869376,0.68018326,016-ABM,-0.335343058,72,100,172
1390,-1.350869376,0.68018326,016-ABN,-0.335343058,231,266,497
1391,-1.350869376,0.68018326,016-ABO,-0.335343058,145,121,266
1392,-1.350869376,0.68018326,016-AAX,-0.335343058,174,135,309
1393,-1.350869376,0.68018326,016-ABP,-0.335343058,184,149,333
1394,-1.350869376,0.68018326,016-ABC,-0.335343058,180,226,406
1395,-1.350869376,0.68018326,016-ABD,-0.335343058,258,267,525
1396,-1.350869376,0.68018326,016-ABQ,-0.335343058,332,265,597
1397,-1.350869376,0.68018326,017-ABR,-0.335343058,233,149,382
1398,-1.350869376,0.68018326,017-AAA,-0.335343058,248,222,470
1399,-1.350869376,0.68018326,017-AAB,-0.335343058,266,202,468
1400,-1.350869376,0.68018326,017-AAE,-0.335343058,228,230,458
1401,-1.350869376,0.68018326,017-AAF,-0.335343058,316,223,539
1402,-1.350869376,0.68018326,017-AAH,-0.335343058,299,150,449
1403,-1.350869376,0.68018326,017-AAJ,-0.335343058,335,234,569
1404,-1.350869376,0.68018326,017-AAK,-0.335343058,339,214,553
1405,-1.350869376,0.68018326,017-AAN,-0.335343058,416,263,679
1406,-1.350869376,0.68018326,017-AAP,-0.335343058,287,231,518
1407,-1.350869376,0.68018326,017-AAQ,-0.335343058,269,202,471
1408,-1.350869376,0.68018326,017-ABS,-0.335343058,362,167,529
1409,-1.350869376,0.68018326,017-ABT,-0.335343058,283,97,380
1410,-1.350869376,0.68018326,017-ABU,-0.335343058,287,73,360
1411,-1.350869376,0.68018326,017-AAT,-0.335343058,331,298,629
1412,-1.350869376,0.68018326,017-AAV,-0.335343058,143,172,315
1413,-1.350869376,0.68018326,017-AAW,-0.335343058,211,208,419
1414,-1.350869376,0.68018326,017-AAY,-0.335343058,259,291,550
1415,-1.350869376,0.68018326,017-ABX,-0.335343058,188,80,268
1416,-1.350869376,0.68018326,017-ABB,-0.335343058,337,226,563
1417,-1.350869376,0.68018326,017-ABC,-0.335343058,271,310,581
1418,-1.350869376,0.68018326,017-ABF,-0.335343058,229,213,442
1419,-1.350869376,0.68018326,017-ABG,-0.335343058,300,189,489
1420,-1.350869376,0.68018326,017-ABI,-0.335343058,179,235,414
1421,-1.350869376,0.68018326,017-ABK,-0.335343058,233,298,531
1422,-1.350869376,0.68018326,017-ABM,-0.335343058,258,208,466
1423,-1.350869376,0.68018326,017-ABO,-0.335343058,232,218,450
1424,-1.350869376,0.68018326,017-ABP,-0.335343058,282,270,552
1425,-1.350869376,0.68018326,017-ABY,-0.335343058,256,109,365
1426,-1.350869376,0.68018326,017-ABZ,-0.335343058,246,115,361
1427,-1.350869376,0.68018326,017-ACA,-0.335343058,106,76,182
1428,-1.350869376,0.68018326,017-ACB,-0.335343058,336,229,565
1429,-1.350869376,0.68018326,017-ACC,-0.335343058,266,118,384
1430,-1.350869376,0.68018326,017-ACD,-0.335343058,314,139,453
1431,-1.350869376,0.68018326,017-ACE,-0.335343058,268,131,399
1432,-1.350869376,0.68018326,017-ACF,-0.335343058,257,88,345
1433,-1.350869376,0.68018326,017-ACS,-0.335343058,323,153,476
1434,-1.350869376,0.68018326,017-ACG,-0.335343058,188,94,282
1435,-1.350869376,0.68018326,017-ACH,-0.335343058,300,170,470
1436,-1.350869376,0.68018326,017-ACJ,-0.335343058,206,147,353
1437,-1.350869376,0.68018326,017-ACK,-0.335343058,181,97,278
1438,-1.350869376,0.68018326,017-ACL,-0.335343058,122,66,188
1439,-1.350869376,0.68018326,017-ACM,-0.335343058,244,112,356
1440,-1.350869376,0.68018326,017-ACN,-0.335343058,292,115,407
1441,-1.350869376,0.68018326,017-ACO,-0.335343058,482,278,760
1442,-1.350869376,0.68018326,017-ACR,-0.335343058,308,178,486
1443,-1.350869376,0.68018326,018-AAA,-0.335343058,244,254,498
1444,-1.350869376,0.68018326,018-AAB,-0.335343058,246,274,520
1445,-1.350869376,0.68018326,018-AAC,-0.335343058,187,267,454
1446,-1.350869376,0.68018326,018-AAD,-0.335343058,246,236,482
1447,-1.350869376,0.68018326,018-AAE,-0.335343058,215,279,494
1448,-1.350869376,0.68018326,018-AAH,-0.335343058,270,246,516
1449,-1.350869376,0.68018326,018-AAI,-0.335343058,218,275,493
1450,-1.350869376,0.68018326,018-AAJ,-0.335343058,192,238,430
1451,-1.350869376,0.68018326,018-AAK,-0.335343058,200,229,429
1452,-1.350869376,0.68018326,018-AAL,-0.335343058,216,285,501
1453,-1.350869376,0.68018326,018-AAO,-0.335343058,263,221,484
1454,-1.350869376,0.68018326,018-AAP,-0.335343058,216,237,453
1455,-1.350869376,0.68018326,018-AAQ,-0.335343058,251,245,496
1456,-1.350869376,0.68018326,018-AAR,-0.335343058,249,206,455
1457,-1.350869376,0.68018326,018-AAS,-0.335343058,248,231,479
1458,-1.350869376,0.68018326,018-AAV,-0.335343058,258,202,460
1459,-1.350869376,0.68018326,018-AAW,-0.335343058,232,207,439
1460,-1.350869376,0.68018326,018-AAX,-0.335343058,294,215,509
1461,-1.350869376,0.68018326,018-AAY,-0.335343058,248,219,467
1462,-1.350869376,0.68018326,018-AAZ,-0.335343058,220,172,392
1463,-1.350869376,0.68018326,018-ABA,-0.335343058,255,199,454
1464,-1.350869376,0.68018326,018-ABD,-0.335343058,143,327,470
1465,-1.350869376,0.68018326,018-ABE,-0.335343058,265,254,519
1466,-1.350869376,0.68018326,018-ABF,-0.335343058,87,318,405
1467,-1.350869376,0.68018326,018-ABG,-0.335343058,106,409,515
1468,-1.350869376,0.68018326,018-ABH,-0.335343058,14,254,268
1469,-1.350869376,0.68018326,018-ABI,-0.335343058,141,345,486
1470,-1.350869376,0.68018326,018-ABJ,-0.335343058,204,224,428
1471,-1.350869376,0.68018326,018-ABK,-0.335343058,132,414,546
1472,-1.350869376,0.68018326,018-ABL,-0.335343058,80,402,482
1473,-1.350869376,0.68018326,018-ABM,-0.335343058,100,484,584
1474,-1.350869376,0.68018326,018-ABN,-0.335343058,148,367,515
1475,-1.350869376,0.68018326,018-ABO,-0.335343058,90,190,280
1476,-1.350869376,0.68018326,018-ABP,-0.335343058,192,614,806
1477,-1.350869376,0.68018326,018-ABQ,-0.335343058,168,221,389
1478,-1.350869376,0.68018326,018-ABR,-0.335343058,169,489,658
1479,-1.350869376,0.68018326,018-ACP,-0.335343058,83,267,350
1480,-1.350869376,0.68018326,018-ACQ,-0.335343058,66,509,575
1481,-1.350869376,0.68018326,018-ACR,-0.335343058,12,106,118
1482,-1.350869376,0.68018326,018-ACS,-0.335343058,25,775,800
1483,-1.350869376,0.68018326,018-ACU,-0.335343058,37,281,318
1484,-1.350869376,0.68018326,018-ACV,-0.335343058,24,347,371
1485,-1.350869376,0.68018326,018-ACW,-0.335343058,20,607,627
1486,-1.350869376,0.68018326,018-ACY,-0.335343058,11,592,603
1487,-1.350869376,0.68018326,018-ACZ,-0.335343058,53,543,596
1488,-1.350869376,0.68018326,018-ADA,-0.335343058,50,520,570
1489,-1.350869376,0.68018326,018-ADE,-0.335343058,39,684,723
1490,-1.350869376,0.68018326,018-ADF,-0.335343058,74,441,515
1491,-1.350869376,0.68018326,018-ABU,-0.335343058,85,276,361
1492,-1.350869376,0.68018326,018-ABV,-0.335343058,173,588,761
1493,-1.350869376,0.68018326,018-ABX,-0.335343058,106,426,532
1494,-1.350869376,0.68018326,018-ABY,-0.335343058,172,381,553
1495,-1.350869376,0.68018326,018-ACA,-0.335343058,95,299,394
1496,-1.350869376,0.68018326,018-ACB,-0.335343058,70,172,242
1497,-1.350869376,0.68018326,018-ACC,-0.335343058,132,338,470
1498,-1.350869376,0.68018326,018-ACE,-0.335343058,90,490,580
1499,-1.350869376,0.68018326,018-ACF,-0.335343058,127,203,330
1500,-1.350869376,0.68018326,018-ACG,-0.335343058,69,394,463
1501,-1.350869376,0.68018326,018-ACI,-0.335343058,119,215,334
1502,-1.350869376,0.68018326,018-ACJ,-0.335343058,57,134,191
1503,-1.350869376,0.68018326,018-ACK,-0.335343058,135,211,346
1504,-1.350869376,0.68018326,018-ACM,-0.335343058,157,353,510
1505,-1.350869376,0.68018326,018-ACN,-0.335343058,181,317,498
1506,-1.350869376,0.68018326,018-CZS,-0.335343058,353,256,609
1507,-1.350869376,0.68018326,018-ADI,-0.335343058,123,405,528
1508,-1.350869376,0.68018326,018-ADJ,-0.335343058,127,297,424
1509,-1.350869376,0.68018326,018-ADK,-0.335343058,136,312,448
1510,-1.350869376,0.68018326,018-ADL,-0.335343058,79,183,262
1511,-1.350869376,0.68018326,018-ADN,-0.335343058,240,305,545
1512,-1.350869376,0.68018326,018-ADO,-0.335343058,342,550,892
1513,-1.350869376,0.68018326,018-ADP,-0.335343058,133,221,354
1514,-1.350869376,0.68018326,018-ADQ,-0.335343058,136,205,341
1515,-1.350869376,0.68018326,018-ADR,-0.335343058,63,164,227
1516,-1.350869376,0.68018326,018-ADU,-0.335343058,255,319,574
1517,-1.350869376,0.68018326,018-ADV,-0.335343058,215,289,504
1518,-1.350869376,0.68018326,018-ADW,-0.335343058,205,265,470
1519,-1.350869376,0.68018326,018-ADX,-0.335343058,221,255,476
1520,-1.350869376,0.68018326,018-AEB,-0.335343058,123,335,458
1521,-1.350869376,0.68018326,018-AEC,-0.335343058,179,273,452
1522,-1.350869376,0.68018326,018-AED,-0.335343058,139,229,368
1523,-1.350869376,0.68018326,018-AEE,-0.335343058,178,276,454
1524,-1.350869376,0.68018326,018-AEH,-0.335343058,155,248,403
1525,-1.350869376,0.68018326,018-AEI,-0.335343058,173,309,482
1526,-1.350869376,0.68018326,018-AEJ,-0.335343058,183,258,441
1527,-1.350869376,0.68018326,018-AEK,-0.335343058,212,314,526
1528,-1.350869376,0.68018326,018-CZT,-0.335343058,206,332,538
1529,-1.350869376,0.68018326,018-CZU,-0.335343058,151,255,406
1530,-1.350869376,0.68018326,018-AEN,-0.335343058,140,124,264
1531,-1.350869376,0.68018326,018-AEO,-0.335343058,310,261,571
1532,-1.350869376,0.68018326,018-AEP,-0.335343058,260,158,418
1533,-1.350869376,0.68018326,018-AEQ,-0.335343058,461,242,703
1534,-1.350869376,0.68018326,018-AER,-0.335343058,216,179,395
1535,-1.350869376,0.68018326,018-AES,-0.335343058,251,175,426
1536,-1.350869376,0.68018326,018-AET,-0.335343058,368,248,616
1537,-1.350869376,0.68018326,018-AEU,-0.335343058,236,205,441
1538,-1.350869376,0.68018326,018-AEV,-0.335343058,267,282,549
1539,-1.350869376,0.68018326,018-AEW,-0.335343058,347,260,607
1540,-1.350869376,0.68018326,018-AEX,-0.335343058,264,202,466
1541,-1.350869376,0.68018326,018-AEY,-0.335343058,598,381,979
1542,-1.350869376,0.68018326,018-AEZ,-0.335343058,348,213,561
1543,-1.350869376,0.68018326,018-AFA,-0.335343058,226,173,399
1544,-1.350869376,0.68018326,018-AFB,-0.335343058,350,246,596
1545,-1.350869376,0.68018326,018-AFC,-0.335343058,350,231,581
1546,-1.350869376,0.68018326,018-DFD,-0.335343058,432,293,725
1547,-1.350869376,0.68018326,018-DFE,-0.335343058,329,278,607
1548,-1.350869376,0.68018326,018-DFF,-0.335343058,144,217,361
1549,-1.350869376,0.68018326,018-DFG,-0.335343058,138,198,336
1550,-1.350869376,0.68018326,018-DFH,-0.335343058,330,220,550
1551,-1.350869376,0.68018326,018-AFF,-0.335343058,338,244,582
1552,-1.350869376,0.68018326,018-AFG,-0.335343058,373,268,641
1553,-1.350869376,0.68018326,018-AFH,-0.335343058,354,247,601
1554,-1.350869376,0.68018326,018-AFI,-0.335343058,304,189,493
1555,-1.350869376,0.68018326,018-AFK,-0.335343058,252,221,473
1556,-1.350869376,0.68018326,018-AFL,-0.335343058,302,238,540
1557,-1.350869376,0.68018326,018-AFM,-0.335343058,352,231,583
1558,-1.350869376,0.68018326,018-AFP,-0.335343058,337,236,573
1559,-1.350869376,0.68018326,018-AFQ,-0.335343058,294,233,527
1560,-1.350869376,0.68018326,018-AFR,-0.335343058,441,320,761
1561,-1.350869376,0.68018326,018-AFU,-0.335343058,370,302,672
1562,-1.350869376,0.68018326,018-AFV,-0.335343058,77,160,237
1563,-1.350869376,0.68018326,018-AFW,-0.335343058,285,300,585
1564,-1.350869376,0.68018326,018-DFI,-0.335343058,447,276,723
1565,-1.350869376,0.68018326,018-CZX,-0.335343058,257,248,505
1566,-1.350869376,0.68018326,018-CZY,-0.335343058,189,208,397
1567,-1.350869376,0.68018326,018-AFZ,-0.335343058,131,307,438
1568,-1.350869376,0.68018326,018-AGA,-0.335343058,215,291,506
1569,-1.350869376,0.68018326,018-AGB,-0.335343058,207,245,452
1570,-1.350869376,0.68018326,018-AGC,-0.335343058,97,241,338
1571,-1.350869376,0.68018326,018-AGD,-0.335343058,198,316,514
1572,-1.350869376,0.68018326,018-AGE,-0.335343058,161,243,404
1573,-1.350869376,0.68018326,018-AGF,-0.335343058,334,546,880
1574,-1.350869376,0.68018326,018-AGG,-0.335343058,148,293,441
1575,-1.350869376,0.68018326,018-AGH,-0.335343058,183,240,423
1576,-1.350869376,0.68018326,018-AGI,-0.335343058,135,239,374
1577,-1.350869376,0.68018326,018-AGJ,-0.335343058,134,214,348
1578,-1.350869376,0.68018326,018-AGK,-0.335343058,179,319,498
1579,-1.350869376,0.68018326,018-AGO,-0.335343058,106,136,242
1580,-1.350869376,0.68018326,018-AGP,-0.335343058,133,321,454
1581,-1.350869376,0.68018326,018-AGQ,-0.335343058,182,304,486
1582,-1.350869376,0.68018326,018-AGR,-0.335343058,136,274,410
1583,-1.350869376,0.68018326,018-AGS,-0.335343058,230,407,637
1584,-1.350869376,0.68018326,018-AGW,-0.335343058,199,347,546
1585,-1.350869376,0.68018326,018-AGX,-0.335343058,162,314,476
1586,-1.350869376,0.68018326,018-AGY,-0.335343058,161,299,460
1587,-1.350869376,0.68018326,018-AGZ,-0.335343058,114,302,416
1588,-1.350869376,0.68018326,018-AHA,-0.335343058,184,262,446
1589,-1.350869376,0.68018326,018-AHD,-0.335343058,0,0,0
1590,-1.350869376,0.68018326,018-AHE,-0.335343058,196,296,492
1591,-1.350869376,0.68018326,018-AHF,-0.335343058,229,337,566
1592,-1.350869376,0.68018326,018-AHG,-0.335343058,183,307,490
1593,-1.350869376,0.68018326,018-AHH,-0.335343058,118,217,335
1594,-1.350869376,0.68018326,018-AHI,-0.335343058,185,344,529
1595,-1.350869376,0.68018326,018-AHK,-0.335343058,150,220,370
1596,-1.350869376,0.68018326,018-AHL,-0.335343058,192,295,487
1597,-1.350869376,0.68018326,018-AHM,-0.335343058,138,190,328
1598,-1.350869376,0.68018326,018-AHN,-0.335343058,155,278,433
1599,-1.350869376,0.68018326,018-AHO,-0.335343058,128,247,375
1600,-1.350869376,0.68018326,018-AHP,-0.335343058,183,293,476
1601,-1.350869376,0.68018326,018-DAF,-0.335343058,53,32,85
1602,-1.350869376,0.68018326,018-CZZ,-0.335343058,137,189,326
1603,-1.350869376,0.68018326,018-DAA,-0.335343058,215,228,443
1604,-1.350869376,0.68018326,018-DAB,-0.335343058,181,238,419
1605,-1.350869376,0.68018326,018-DAC,-0.335343058,231,193,424
1606,-1.350869376,0.68018326,018-DAD,-0.335343058,260,226,486
1607,-1.350869376,0.68018326,018-DAE,-0.335343058,252,227,479
1608,-1.350869376,0.68018326,018-BJS,-0.335343058,97,462,559
1609,-1.350869376,0.68018326,018-BJT,-0.335343058,91,332,423
1610,-1.350869376,0.68018326,018-BJU,-0.335343058,111,473,584
1611,-1.350869376,0.68018326,018-BJV,-0.335343058,64,332,396
1612,-1.350869376,0.68018326,018-BJW,-0.335343058,39,390,429
1613,-1.350869376,0.68018326,018-BJX,-0.335343058,64,243,307
1614,-1.350869376,0.68018326,018-BJY,-0.335343058,116,371,487
1615,-1.350869376,0.68018326,018-BJZ,-0.335343058,79,344,423
1616,-1.350869376,0.68018326,018-BKA,-0.335343058,73,366,439
1617,-1.350869376,0.68018326,018-BKB,-0.335343058,82,367,449
1618,-1.350869376,0.68018326,018-BKG,-0.335343058,86,454,540
1619,-1.350869376,0.68018326,018-BKH,-0.335343058,86,376,462
1620,-1.350869376,0.68018326,018-BKI,-0.335343058,118,318,436
1621,-1.350869376,0.68018326,018-BKJ,-0.335343058,57,366,423
1622,-1.350869376,0.68018326,018-BKK,-0.335343058,117,419,536
1623,-1.350869376,0.68018326,018-BKL,-0.335343058,121,410,531
1624,-1.350869376,0.68018326,018-BKM,-0.335343058,74,399,473
1625,-1.350869376,0.68018326,018-BKN,-0.335343058,64,420,484
1626,-1.350869376,0.68018326,018-BKO,-0.335343058,55,403,458
1627,-1.350869376,0.68018326,018-BKP,-0.335343058,26,498,524
1628,-1.350869376,0.68018326,018-BKQ,-0.335343058,120,299,419
1629,-1.350869376,0.68018326,018-BKV,-0.335343058,13,372,385
1630,-1.350869376,0.68018326,018-BKW,-0.335343058,19,551,570
1631,-1.350869376,0.68018326,018-BKX,-0.335343058,58,424,482
1632,-1.350869376,0.68018326,018-BKY,-0.335343058,23,358,381
1633,-1.350869376,0.68018326,018-BKZ,-0.335343058,36,452,488
1634,-1.350869376,0.68018326,018-BLA,-0.335343058,74,447,521
1635,-1.350869376,0.68018326,018-BLB,-0.335343058,77,414,491
1636,-1.350869376,0.68018326,018-BLC,-0.335343058,43,462,505
1637,-1.350869376,0.68018326,018-BLG,-0.335343058,53,435,488
1638,-1.350869376,0.68018326,018-BLH,-0.335343058,247,372,619
1639,-1.350869376,0.68018326,018-BLI,-0.335343058,236,317,553
1640,-1.350869376,0.68018326,018-BLJ,-0.335343058,86,415,501
1641,-1.350869376,0.68018326,018-BLK,-0.335343058,211,328,539
1642,-1.350869376,0.68018326,018-BLL,-0.335343058,22,373,395
1643,-1.350869376,0.68018326,018-BLM,-0.335343058,59,409,468
1644,-1.350869376,0.68018326,018-BLN,-0.335343058,84,447,531
1645,-1.350869376,0.68018326,018-BLO,-0.335343058,102,380,482
1646,-1.350869376,0.68018326,018-BLP,-0.335343058,93,517,610
1647,-1.350869376,0.68018326,018-BLQ,-0.335343058,140,524,664
1648,-1.350869376,0.68018326,018-BLR,-0.335343058,102,398,500
1649,-1.350869376,0.68018326,018-BLS,-0.335343058,29,447,476
1650,-1.350869376,0.68018326,018-BLT,-0.335343058,73,500,573
1651,-1.350869376,0.68018326,018-BLZ,-0.335343058,35,501,536
1652,-1.350869376,0.68018326,018-BMA,-0.335343058,46,472,518
1653,-1.350869376,0.68018326,018-BMB,-0.335343058,56,417,473
1654,-1.350869376,0.68018326,018-BMC,-0.335343058,29,411,440
1655,-1.350869376,0.68018326,018-BMD,-0.335343058,24,459,483
1656,-1.350869376,0.68018326,018-BME,-0.335343058,72,462,534
1657,-1.350869376,0.68018326,018-BMF,-0.335343058,47,358,405
1658,-1.350869376,0.68018326,018-BMG,-0.335343058,17,572,589
1659,-1.350869376,0.68018326,018-BMH,-0.335343058,54,425,479
1660,-1.350869376,0.68018326,018-BMI,-0.335343058,21,436,457
1661,-1.350869376,0.68018326,018-BMJ,-0.335343058,38,473,511
1662,-1.350869376,0.68018326,018-BMK,-0.335343058,8,420,428
1663,-1.350869376,0.68018326,018-AHS,-0.335343058,4,481,485
1664,-1.350869376,0.68018326,018-AHU,-0.335343058,3,479,482
1665,-1.350869376,0.68018326,018-AHW,-0.335343058,3,438,441
1666,-1.350869376,0.68018326,018-AHY,-0.335343058,3,479,482
1667,-1.350869376,0.68018326,018-AIA,-0.335343058,6,452,458
1668,-1.350869376,0.68018326,018-AIC,-0.335343058,5,499,504
1669,-1.350869376,0.68018326,018-AIE,-0.335343058,3,479,482
1670,-1.350869376,0.68018326,018-AIG,-0.335343058,7,516,523
1671,-1.350869376,0.68018326,018-AII,-0.335343058,5,552,557
1672,-1.350869376,0.68018326,018-AIK,-0.335343058,7,492,499
1673,-1.350869376,0.68018326,018-AIM,-0.335343058,7,538,545
1674,-1.350869376,0.68018326,018-AIO,-0.335343058,8,441,449
1675,-1.350869376,0.68018326,018-AIQ,-0.335343058,6,556,562
1676,-1.350869376,0.68018326,018-AIS,-0.335343058,9,578,587
1677,-1.350869376,0.68018326,018-AIU,-0.335343058,2,558,560
1678,-1.350869376,0.68018326,018-AIW,-0.335343058,5,472,477
1679,-1.350869376,0.68018326,018-AIX,-0.335343058,6,572,578
1680,-1.350869376,0.68018326,018-AIY,-0.335343058,2,552,554
1681,-1.350869376,0.68018326,018-AIZ,-0.335343058,2,524,526
1682,-1.350869376,0.68018326,018-AJA,-0.335343058,6,511,517
1683,-1.350869376,0.68018326,018-AJB,-0.335343058,0,494,494
1684,-1.350869376,0.68018326,018-AJC,-0.335343058,1,496,497
1685,-1.350869376,0.68018326,018-AJD,-0.335343058,4,553,557
1686,-1.350869376,0.68018326,018-AJH,-0.335343058,3,311,314
1687,-1.350869376,0.68018326,018-AJJ,-0.335343058,46,312,358
1688,-1.350869376,0.68018326,018-AJL,-0.335343058,4,509,513
1689,-1.350869376,0.68018326,018-AJN,-0.335343058,5,104,109
1690,-1.350869376,0.68018326,018-AJP,-0.335343058,3,641,644
1691,-1.350869376,0.68018326,018-AJR,-0.335343058,9,319,328
1692,-1.350869376,0.68018326,018-AJT,-0.335343058,3,620,623
1693,-1.350869376,0.68018326,018-AJV,-0.335343058,141,567,708
1694,-1.350869376,0.68018326,018-AJX,-0.335343058,3,523,526
1695,-1.350869376,0.68018326,018-AJY,-0.335343058,2,396,398
1696,-1.350869376,0.68018326,018-AJZ,-0.335343058,4,389,393
1697,-1.350869376,0.68018326,018-AKA,-0.335343058,2,524,526
1698,-1.350869376,0.68018326,018-AKB,-0.335343058,1,583,584
1699,-1.350869376,0.68018326,018-AKC,-0.335343058,18,90,108
1700,-1.350869376,0.68018326,018-AKD,-0.335343058,4,570,574
1701,-1.350869376,0.68018326,018-AKE,-0.335343058,3,413,416
1702,-1.350869376,0.68018326,018-AKF,-0.335343058,6,417,423
1703,-1.350869376,0.68018326,018-AKG,-0.335343058,4,554,558
1704,-1.350869376,0.68018326,018-AKH,-0.335343058,4,656,660
1705,-1.350869376,0.68018326,018-AKI,-0.335343058,3,425,428
1706,-1.350869376,0.68018326,018-AKP,-0.335343058,8,658,666
1707,-1.350869376,0.68018326,018-AKR,-0.335343058,5,588,593
1708,-1.350869376,0.68018326,018-AKT,-0.335343058,3,350,353
1709,-1.350869376,0.68018326,018-AKV,-0.335343058,5,561,566
1710,-1.350869376,0.68018326,018-AKX,-0.335343058,2,408,410
1711,-1.350869376,0.68018326,018-AKZ,-0.335343058,1,373,374
1712,-1.350869376,0.68018326,018-ALB,-0.335343058,1,518,519
1713,-1.350869376,0.68018326,018-ALD,-0.335343058,0,299,299
1714,-1.350869376,0.68018326,018-ALF,-0.335343058,2,618,620
1715,-1.350869376,0.68018326,018-ALH,-0.335343058,3,374,377
1716,-1.350869376,0.68018326,018-ALJ,-0.335343058,4,385,389
1717,-1.350869376,0.68018326,018-ALL,-0.335343058,2,365,367
1718,-1.350869376,0.68018326,018-ALN,-0.335343058,2,423,425
1719,-1.350869376,0.68018326,018-ALP,-0.335343058,2,476,478
1720,-1.350869376,0.68018326,018-ALQ,-0.335343058,1,310,311
1721,-1.350869376,0.68018326,018-ALR,-0.335343058,2,540,542
1722,-1.350869376,0.68018326,018-ALS,-0.335343058,3,399,402
1723,-1.350869376,0.68018326,018-ALT,-0.335343058,2,438,440
1724,-1.350869376,0.68018326,018-ALU,-0.335343058,2,429,431
1725,-1.350869376,0.68018326,018-ALV,-0.335343058,3,449,452
1726,-1.350869376,0.68018326,018-ALW,-0.335343058,5,487,492
1727,-1.350869376,0.68018326,018-AMC,-0.335343058,5,297,302
1728,-1.350869376,0.68018326,018-AME,-0.335343058,23,318,341
1729,-1.350869376,0.68018326,018-AMG,-0.335343058,2,351,353
1730,-1.350869376,0.68018326,018-AMI,-0.335343058,6,644,650
1731,-1.350869376,0.68018326,018-AMK,-0.335343058,2,370,372
1732,-1.350869376,0.68018326,018-AMM,-0.335343058,13,475,488
1733,-1.350869376,0.68018326,018-AMO,-0.335343058,75,444,519
1734,-1.350869376,0.68018326,018-AMQ,-0.335343058,6,468,474
1735,-1.350869376,0.68018326,018-AMS,-0.335343058,5,480,485
1736,-1.350869376,0.68018326,018-AMU,-0.335343058,0,504,504
1737,-1.350869376,0.68018326,018-AMV,-0.335343058,4,414,418
1738,-1.350869376,0.68018326,018-AMX,-0.335343058,3,427,430
1739,-1.350869376,0.68018326,018-AMZ,-0.335343058,1,516,517
1740,-1.350869376,0.68018326,018-ANA,-0.335343058,1,485,486
1741,-1.350869376,0.68018326,018-ANB,-0.335343058,1,479,480
1742,-1.350869376,0.68018326,018-ANC,-0.335343058,23,274,297
1743,-1.350869376,0.68018326,018-AND,-0.335343058,5,483,488
1744,-1.350869376,0.68018326,018-ANE,-0.335343058,2,549,551
1745,-1.350869376,0.68018326,018-ANF,-0.335343058,30,461,491
1746,-1.350869376,0.68018326,018-ANN,-0.335343058,23,636,659
1747,-1.350869376,0.68018326,018-ANP,-0.335343058,15,85,100
1748,-1.350869376,0.68018326,018-ANR,-0.335343058,26,238,264
1749,-1.350869376,0.68018326,018-ANT,-0.335343058,3,476,479
1750,-1.350869376,0.68018326,018-ANV,-0.335343058,0,506,506
1751,-1.350869376,0.68018326,018-ANX,-0.335343058,1,680,681
1752,-1.350869376,0.68018326,018-ANZ,-0.335343058,10,501,511
1753,-1.350869376,0.68018326,018-AOB,-0.335343058,7,431,438
1754,-1.350869376,0.68018326,018-AOD,-0.335343058,7,301,308
1755,-1.350869376,0.68018326,018-AOF,-0.335343058,24,132,156
1756,-1.350869376,0.68018326,018-AOH,-0.335343058,0,459,459
1757,-1.350869376,0.68018326,018-AOJ,-0.335343058,5,410,415
1758,-1.350869376,0.68018326,018-AOL,-0.335343058,11,497,508
1759,-1.350869376,0.68018326,018-AON,-0.335343058,1,402,403
1760,-1.350869376,0.68018326,018-AOP,-0.335343058,16,95,111
1761,-1.350869376,0.68018326,018-AOQ,-0.335343058,4,40,44
1762,-1.350869376,0.68018326,018-AOR,-0.335343058,2,528,530
1763,-1.350869376,0.68018326,018-AOS,-0.335343058,3,512,515
1764,-1.350869376,0.68018326,018-AOT,-0.335343058,2,355,357
1765,-1.350869376,0.68018326,018-AOU,-0.335343058,3,625,628
1766,-1.350869376,0.68018326,018-DDP,-0.335343058,0,16,16
1767,-1.350869376,0.68018326,018-APB,-0.335343058,23,365,388
1768,-1.350869376,0.68018326,018-APD,-0.335343058,34,205,239
1769,-1.350869376,0.68018326,018-APF,-0.335343058,0,6,6
1770,-1.350869376,0.68018326,018-APH,-0.335343058,20,233,253
1771,-1.350869376,0.68018326,018-APJ,-0.335343058,0,10,10
1772,-1.350869376,0.68018326,018-APL,-0.335343058,179,415,594
1773,-1.350869376,0.68018326,018-APN,-0.335343058,8,481,489
1774,-1.350869376,0.68018326,018-APP,-0.335343058,0,426,426
1775,-1.350869376,0.68018326,018-APR,-0.335343058,3,398,401
1776,-1.350869376,0.68018326,018-APT,-0.335343058,1,285,286
1777,-1.350869376,0.68018326,018-APV,-0.335343058,34,292,326
1778,-1.350869376,0.68018326,018-APX,-0.335343058,5,393,398
1779,-1.350869376,0.68018326,018-APY,-0.335343058,2,395,397
1780,-1.350869376,0.68018326,018-APZ,-0.335343058,3,385,388
1781,-1.350869376,0.68018326,018-AQA,-0.335343058,72,396,468
1782,-1.350869376,0.68018326,018-AQB,-0.335343058,3,515,518
1783,-1.350869376,0.68018326,018-AQC,-0.335343058,9,487,496
1784,-1.350869376,0.68018326,018-AQD,-0.335343058,24,337,361
1785,-1.350869376,0.68018326,018-AQE,-0.335343058,17,639,656
1786,-1.350869376,0.68018326,018-AQF,-0.335343058,104,239,343
1787,-1.350869376,0.68018326,018-AQG,-0.335343058,4,357,361
1788,-1.350869376,0.68018326,018-AQH,-0.335343058,15,274,289
1789,-1.350869376,0.68018326,018-DDX,-0.335343058,1,151,152
1790,-1.350869376,0.68018326,018-DDY,-0.335343058,0,54,54
1791,-1.350869376,0.68018326,018-AQM,-0.335343058,3,468,471
1792,-1.350869376,0.68018326,018-AQO,-0.335343058,2,474,476
1793,-1.350869376,0.68018326,018-AQQ,-0.335343058,1,190,191
1794,-1.350869376,0.68018326,018-AQS,-0.335343058,4,390,394
1795,-1.350869376,0.68018326,018-AQU,-0.335343058,1,445,446
1796,-1.350869376,0.68018326,018-AQW,-0.335343058,4,329,333
1797,-1.350869376,0.68018326,018-AQY,-0.335343058,12,432,444
1798,-1.350869376,0.68018326,018-ARA,-0.335343058,2,337,339
1799,-1.350869376,0.68018326,018-ARC,-0.335343058,1,400,401
1800,-1.350869376,0.68018326,018-ARE,-0.335343058,4,464,468
1801,-1.350869376,0.68018326,018-ARF,-0.335343058,10,72,82
1802,-1.350869376,0.68018326,018-ARG,-0.335343058,1,298,299
1803,-1.350869376,0.68018326,018-ARH,-0.335343058,5,330,335
1804,-1.350869376,0.68018326,018-ARI,-0.335343058,7,451,458
1805,-1.350869376,0.68018326,018-ARJ,-0.335343058,7,311,318
1806,-1.350869376,0.68018326,018-ARK,-0.335343058,4,398,402
1807,-1.350869376,0.68018326,018-ARL,-0.335343058,3,190,193
1808,-1.350869376,0.68018326,018-ARM,-0.335343058,16,156,172
1809,-1.350869376,0.68018326,018-ARN,-0.335343058,1,346,347
1810,-1.350869376,0.68018326,018-ARO,-0.335343058,18,516,534
1811,-1.350869376,0.68018326,018-ARP,-0.335343058,19,475,494
1812,-1.350869376,0.68018326,018-DDR,-0.335343058,39,273,312
1813,-1.350869376,0.68018326,018-DDS,-0.335343058,3,156,159
1814,-1.350869376,0.68018326,018-DED,-0.335343058,2,58,60
1815,-1.350869376,0.68018326,018-ARV,-0.335343058,3,461,464
1816,-1.350869376,0.68018326,018-ARX,-0.335343058,8,550,558
1817,-1.350869376,0.68018326,018-ARZ,-0.335343058,2,552,554
1818,-1.350869376,0.68018326,018-ASB,-0.335343058,7,434,441
1819,-1.350869376,0.68018326,018-ASD,-0.335343058,4,369,373
1820,-1.350869376,0.68018326,018-ASF,-0.335343058,0,62,62
1821,-1.350869376,0.68018326,018-ASH,-0.335343058,2,317,319
1822,-1.350869376,0.68018326,018-ASJ,-0.335343058,5,395,400
1823,-1.350869376,0.68018326,018-ASL,-0.335343058,2,308,310
1824,-1.350869376,0.68018326,018-ASN,-0.335343058,16,370,386
1825,-1.350869376,0.68018326,018-ASP,-0.335343058,1,675,676
1826,-1.350869376,0.68018326,018-ASQ,-0.335343058,8,195,203
1827,-1.350869376,0.68018326,018-ASR,-0.335343058,1,559,560
1828,-1.350869376,0.68018326,018-ASS,-0.335343058,2,472,474
1829,-1.350869376,0.68018326,018-AST,-0.335343058,3,561,564
1830,-1.350869376,0.68018326,018-ASU,-0.335343058,1,495,496
1831,-1.350869376,0.68018326,018-ASV,-0.335343058,2,563,565
1832,-1.350869376,0.68018326,018-ASW,-0.335343058,1,386,387
1833,-1.350869376,0.68018326,018-ASX,-0.335343058,2,517,519
1834,-1.350869376,0.68018326,018-ATF,-0.335343058,21,215,236
1835,-1.350869376,0.68018326,018-ATH,-0.335343058,4,470,474
1836,-1.350869376,0.68018326,018-ATJ,-0.335343058,3,421,424
1837,-1.350869376,0.68018326,018-ATL,-0.335343058,1,480,481
1838,-1.350869376,0.68018326,018-ATN,-0.335343058,1,481,482
1839,-1.350869376,0.68018326,018-ATP,-0.335343058,2,428,430
1840,-1.350869376,0.68018326,018-ATR,-0.335343058,3,469,472
1841,-1.350869376,0.68018326,018-ATT,-0.335343058,2,345,347
1842,-1.350869376,0.68018326,018-ATV,-0.335343058,0,362,362
1843,-1.350869376,0.68018326,018-ATX,-0.335343058,1,333,334
1844,-1.350869376,0.68018326,018-ATZ,-0.335343058,3,476,479
1845,-1.350869376,0.68018326,018-AUB,-0.335343058,7,461,468
1846,-1.350869376,0.68018326,018-AUD,-0.335343058,1,399,400
1847,-1.350869376,0.68018326,018-AUE,-0.335343058,2,398,400
1848,-1.350869376,0.68018326,018-AUF,-0.335343058,8,424,432
1849,-1.350869376,0.68018326,018-AUG,-0.335343058,126,886,1012
1850,-1.350869376,0.68018326,018-AUH,-0.335343058,2,414,416
1851,-1.350869376,0.68018326,018-AUI,-0.335343058,3,448,451
1852,-1.350869376,0.68018326,018-AUJ,-0.335343058,29,222,251
1853,-1.350869376,0.68018326,018-AUR,-0.335343058,5,355,360
1854,-1.350869376,0.68018326,018-AUT,-0.335343058,3,311,314
1855,-1.350869376,0.68018326,018-AUV,-0.335343058,5,498,503
1856,-1.350869376,0.68018326,018-AUX,-0.335343058,10,533,543
1857,-1.350869376,0.68018326,018-AUZ,-0.335343058,10,475,485
1858,-1.350869376,0.68018326,018-AVB,-0.335343058,17,305,322
1859,-1.350869376,0.68018326,018-AVD,-0.335343058,10,512,522
1860,-1.350869376,0.68018326,018-AVF,-0.335343058,5,438,443
1861,-1.350869376,0.68018326,018-AVG,-0.335343058,12,607,619
1862,-1.350869376,0.68018326,018-AVH,-0.335343058,2,393,395
1863,-1.350869376,0.68018326,018-AVI,-0.335343058,2,389,391
1864,-1.350869376,0.68018326,018-AVJ,-0.335343058,4,497,501
1865,-1.350869376,0.68018326,018-AVK,-0.335343058,7,476,483
1866,-1.350869376,0.68018326,018-AVL,-0.335343058,5,440,445
1867,-1.350869376,0.68018326,018-AVM,-0.335343058,7,296,303
1868,-1.350869376,0.68018326,018-AVN,-0.335343058,16,253,269
1869,-1.350869376,0.68018326,018-AVO,-0.335343058,8,453,461
1870,-1.350869376,0.68018326,018-AVP,-0.335343058,5,365,370
1871,-1.350869376,0.68018326,018-AVQ,-0.335343058,9,420,429
1872,-1.350869376,0.68018326,018-DDZ,-0.335343058,6,338,344
1873,-1.350869376,0.68018326,018-DEE,-0.335343058,0,230,230
1874,-1.350869376,0.68018326,018-AVY,-0.335343058,59,263,322
1875,-1.350869376,0.68018326,018-AWA,-0.335343058,42,638,680
1876,-1.350869376,0.68018326,018-AWC,-0.335343058,193,377,570
1877,-1.350869376,0.68018326,018-AWE,-0.335343058,102,374,476
1878,-1.350869376,0.68018326,018-AWG,-0.335343058,9,217,226
1879,-1.350869376,0.68018326,018-AWI,-0.335343058,26,505,531
1880,-1.350869376,0.68018326,018-AWK,-0.335343058,21,302,323
1881,-1.350869376,0.68018326,018-AWM,-0.335343058,49,436,485
1882,-1.350869376,0.68018326,018-AWN,-0.335343058,103,322,425
1883,-1.350869376,0.68018326,018-AWO,-0.335343058,104,350,454
1884,-1.350869376,0.68018326,018-AWP,-0.335343058,43,331,374
1885,-1.350869376,0.68018326,018-AWQ,-0.335343058,52,310,362
1886,-1.350869376,0.68018326,018-AWR,-0.335343058,41,555,596
1887,-1.350869376,0.68018326,018-AWS,-0.335343058,50,315,365
1888,-1.350869376,0.68018326,018-AWT,-0.335343058,35,368,403
1889,-1.350869376,0.68018326,018-AWU,-0.335343058,126,439,565
1890,-1.350869376,0.68018326,018-AWV,-0.335343058,37,395,432
1891,-1.350869376,0.68018326,018-AWW,-0.335343058,29,366,395
1892,-1.350869376,0.68018326,018-AWX,-0.335343058,42,502,544
1893,-1.350869376,0.68018326,018-AWY,-0.335343058,39,432,471
1894,-1.350869376,0.68018326,018-AWZ,-0.335343058,40,403,443
1895,-1.350869376,0.68018326,018-AXF,-0.335343058,75,349,424
1896,-1.350869376,0.68018326,018-AXH,-0.335343058,40,369,409
1897,-1.350869376,0.68018326,018-AXJ,-0.335343058,73,227,300
1898,-1.350869376,0.68018326,018-AXL,-0.335343058,72,339,411
1899,-1.350869376,0.68018326,018-AXN,-0.335343058,72,277,349
1900,-1.350869376,0.68018326,018-AXO,-0.335343058,113,339,452
1901,-1.350869376,0.68018326,018-AXP,-0.335343058,56,263,319
1902,-1.350869376,0.68018326,018-AXQ,-0.335343058,59,372,431
1903,-1.350869376,0.68018326,018-AXR,-0.335343058,53,303,356
1904,-1.350869376,0.68018326,018-AXS,-0.335343058,64,283,347
1905,-1.350869376,0.68018326,018-AXT,-0.335343058,49,309,358
1906,-1.350869376,0.68018326,018-AXU,-0.335343058,34,320,354
1907,-1.350869376,0.68018326,018-AXV,-0.335343058,48,198,246
1908,-1.350869376,0.68018326,018-AXW,-0.335343058,25,392,417
1909,-1.350869376,0.68018326,018-AXX,-0.335343058,28,212,240
1910,-1.350869376,0.68018326,018-AXY,-0.335343058,91,334,425
1911,-1.350869376,0.68018326,018-AYJ,-0.335343058,35,380,415
1912,-1.350869376,0.68018326,018-AYL,-0.335343058,79,322,401
1913,-1.350869376,0.68018326,018-AYN,-0.335343058,87,352,439
1914,-1.350869376,0.68018326,018-AYP,-0.335343058,47,296,343
1915,-1.350869376,0.68018326,018-AYR,-0.335343058,104,354,458
1916,-1.350869376,0.68018326,018-AYT,-0.335343058,8,221,229
1917,-1.350869376,0.68018326,018-AYV,-0.335343058,273,687,960
1918,-1.350869376,0.68018326,018-AYX,-0.335343058,7,122,129
1919,-1.350869376,0.68018326,018-AYZ,-0.335343058,107,332,439
1920,-1.350869376,0.68018326,018-AZB,-0.335343058,30,191,221
1921,-1.350869376,0.68018326,018-AZC,-0.335343058,59,359,418
1922,-1.350869376,0.68018326,018-AZD,-0.335343058,116,433,549
1923,-1.350869376,0.68018326,018-AZE,-0.335343058,93,491,584
1924,-1.350869376,0.68018326,018-AZF,-0.335343058,111,546,657
1925,-1.350869376,0.68018326,018-AZG,-0.335343058,11,73,84
1926,-1.350869376,0.68018326,018-AZH,-0.335343058,14,84,98
1927,-1.350869376,0.68018326,018-AZI,-0.335343058,44,164,208
1928,-1.350869376,0.68018326,018-AZJ,-0.335343058,38,119,157
1929,-1.350869376,0.68018326,018-AZK,-0.335343058,29,84,113
1930,-1.350869376,0.68018326,018-AZL,-0.335343058,86,387,473
1931,-1.350869376,0.68018326,018-AZM,-0.335343058,61,481,542
1932,-1.350869376,0.68018326,018-AZN,-0.335343058,17,320,337
1933,-1.350869376,0.68018326,018-AZO,-0.335343058,65,336,401
1934,-1.350869376,0.68018326,018-DDT,-0.335343058,6,454,460
1935,-1.350869376,0.68018326,018-DDU,-0.335343058,10,18,28
1936,-1.350869376,0.68018326,018-DDV,-0.335343058,18,51,69
1937,-1.350869376,0.68018326,018-AZS,-0.335343058,27,87,114
1938,-1.350869376,0.68018326,018-AZU,-0.335343058,69,268,337
1939,-1.350869376,0.68018326,018-AZW,-0.335343058,0,2,2
1940,-1.350869376,0.68018326,018-AZY,-0.335343058,0,1,1
1941,-1.350869376,0.68018326,018-BAA,-0.335343058,59,272,331
1942,-1.350869376,0.68018326,018-BAC,-0.335343058,39,260,299
1943,-1.350869376,0.68018326,018-BAE,-0.335343058,63,297,360
1944,-1.350869376,0.68018326,018-BAG,-0.335343058,86,341,427
1945,-1.350869376,0.68018326,018-BAI,-0.335343058,41,232,273
1946,-1.350869376,0.68018326,018-BAJ,-0.335343058,77,307,384
1947,-1.350869376,0.68018326,018-BAL,-0.335343058,62,277,339
1948,-1.350869376,0.68018326,018-BAM,-0.335343058,54,188,242
1949,-1.350869376,0.68018326,018-BAN,-0.335343058,68,386,454
1950,-1.350869376,0.68018326,018-BAO,-0.335343058,72,245,317
1951,-1.350869376,0.68018326,018-BAP,-0.335343058,31,212,243
1952,-1.350869376,0.68018326,018-BAQ,-0.335343058,59,262,321
1953,-1.350869376,0.68018326,018-BAR,-0.335343058,41,233,274
1954,-1.350869376,0.68018326,018-BAS,-0.335343058,72,217,289
1955,-1.350869376,0.68018326,018-BAT,-0.335343058,40,191,231
1956,-1.350869376,0.68018326,018-BAU,-0.335343058,67,272,339
1957,-1.350869376,0.68018326,018-BBB,-0.335343058,84,321,405
1958,-1.350869376,0.68018326,018-BBD,-0.335343058,24,104,128
1959,-1.350869376,0.68018326,018-BBF,-0.335343058,68,299,367
1960,-1.350869376,0.68018326,018-BBH,-0.335343058,65,307,372
1961,-1.350869376,0.68018326,018-BBJ,-0.335343058,69,298,367
1962,-1.350869376,0.68018326,018-BBL,-0.335343058,96,373,469
1963,-1.350869376,0.68018326,018-BBN,-0.335343058,254,317,571
1964,-1.350869376,0.68018326,018-BBP,-0.335343058,75,194,269
1965,-1.350869376,0.68018326,018-BBQ,-0.335343058,65,237,302
1966,-1.350869376,0.68018326,018-BBR,-0.335343058,161,430,591
1967,-1.350869376,0.68018326,018-BBS,-0.335343058,219,341,560
1968,-1.350869376,0.68018326,018-BBT,-0.335343058,221,279,500
1969,-1.350869376,0.68018326,018-BBU,-0.335343058,274,308,582
1970,-1.350869376,0.68018326,018-BBV,-0.335343058,203,366,569
1971,-1.350869376,0.68018326,018-BBW,-0.335343058,181,395,576
1972,-1.350869376,0.68018326,018-BBX,-0.335343058,128,332,460
1973,-1.350869376,0.68018326,018-BBY,-0.335343058,17,53,70
1974,-1.350869376,0.68018326,018-BBZ,-0.335343058,207,482,689
1975,-1.350869376,0.68018326,018-DEA,-0.335343058,23,99,122
1976,-1.350869376,0.68018326,018-BCI,-0.335343058,96,245,341
1977,-1.350869376,0.68018326,018-BCK,-0.335343058,32,49,81
1978,-1.350869376,0.68018326,018-BCM,-0.335343058,10,21,31
1979,-1.350869376,0.68018326,018-BCO,-0.335343058,228,292,520
1980,-1.350869376,0.68018326,018-BCQ,-0.335343058,165,312,477
1981,-1.350869376,0.68018326,018-BCS,-0.335343058,211,421,632
1982,-1.350869376,0.68018326,018-BCU,-0.335343058,189,377,566
1983,-1.350869376,0.68018326,018-BCW,-0.335343058,167,384,551
1984,-1.350869376,0.68018326,018-BCY,-0.335343058,170,269,439
1985,-1.350869376,0.68018326,018-BCZ,-0.335343058,27,73,100
1986,-1.350869376,0.68018326,018-BDA,-0.335343058,152,327,479
1987,-1.350869376,0.68018326,018-BDB,-0.335343058,186,339,525
1988,-1.350869376,0.68018326,018-BDC,-0.335343058,233,361,594
1989,-1.350869376,0.68018326,018-BDD,-0.335343058,226,328,554
1990,-1.350869376,0.68018326,018-BDE,-0.335343058,220,302,522
1991,-1.350869376,0.68018326,018-BDF,-0.335343058,232,373,605
1992,-1.350869376,0.68018326,018-BDG,-0.335343058,189,356,545
1993,-1.350869376,0.68018326,018-BDH,-0.335343058,222,376,598
1994,-1.350869376,0.68018326,018-BDI,-0.335343058,234,384,618
1995,-1.350869376,0.68018326,018-BDQ,-0.335343058,68,372,440
1996,-1.350869376,0.68018326,018-BDS,-0.335343058,68,290,358
1997,-1.350869376,0.68018326,018-BDU,-0.335343058,31,110,141
1998,-1.350869376,0.68018326,018-BDV,-0.335343058,50,296,346
1999,-1.350869376,0.68018326,018-BDW,-0.335343058,74,376,450
2000,-1.350869376,0.68018326,018-BDX,-0.335343058,70,345,415
2001,-1.350869376,0.68018326,018-BDY,-0.335343058,55,292,347
2002,-1.350869376,0.68018326,018-BDZ,-0.335343058,114,432,546
2003,-1.350869376,0.68018326,018-BEA,-0.335343058,62,388,450
2004,-1.350869376,0.68018326,018-BEB,-0.335343058,110,291,401
2005,-1.350869376,0.68018326,018-BEC,-0.335343058,69,336,405
2006,-1.350869376,0.68018326,018-BED,-0.335343058,55,339,394
2007,-1.350869376,0.68018326,018-BEE,-0.335343058,57,373,430
2008,-1.350869376,0.68018326,018-BEF,-0.335343058,49,243,292
2009,-1.350869376,0.68018326,018-BEG,-0.335343058,68,319,387
2010,-1.350869376,0.68018326,018-BEH,-0.335343058,33,153,186
2011,-1.350869376,0.68018326,018-BES,-0.335343058,115,248,363
2012,-1.350869376,0.68018326,018-BEU,-0.335343058,8,17,25
2013,-1.350869376,0.68018326,018-BEV,-0.335343058,144,494,638
2014,-1.350869376,0.68018326,018-BEW,-0.335343058,71,362,433
2015,-1.350869376,0.68018326,018-BEX,-0.335343058,80,445,525
2016,-1.350869376,0.68018326,018-BEY,-0.335343058,74,430,504
2017,-1.350869376,0.68018326,018-BEZ,-0.335343058,103,424,527
2018,-1.350869376,0.68018326,018-BFA,-0.335343058,56,326,382
2019,-1.350869376,0.68018326,018-BFB,-0.335343058,105,341,446
2020,-1.350869376,0.68018326,018-BFC,-0.335343058,60,346,406
2021,-1.350869376,0.68018326,018-BFD,-0.335343058,60,213,273
2022,-1.350869376,0.68018326,018-BFE,-0.335343058,55,326,381
2023,-1.350869376,0.68018326,018-BFF,-0.335343058,111,333,444
2024,-1.350869376,0.68018326,018-BFG,-0.335343058,70,346,416
2025,-1.350869376,0.68018326,018-BFH,-0.335343058,114,381,495
2026,-1.350869376,0.68018326,018-BFI,-0.335343058,77,356,433
2027,-1.350869376,0.68018326,018-BFJ,-0.335343058,82,282,364
2028,-1.350869376,0.68018326,018-BFK,-0.335343058,92,347,439
2029,-1.350869376,0.68018326,018-BFL,-0.335343058,51,258,309
2030,-1.350869376,0.68018326,018-BFT,-0.335343058,0,12,12
2031,-1.350869376,0.68018326,018-BFV,-0.335343058,34,192,226
2032,-1.350869376,0.68018326,018-BFX,-0.335343058,18,391,409
2033,-1.350869376,0.68018326,018-BFZ,-0.335343058,13,461,474
2034,-1.350869376,0.68018326,018-BGB,-0.335343058,51,352,403
2035,-1.350869376,0.68018326,018-BGD,-0.335343058,136,393,529
2036,-1.350869376,0.68018326,018-BGE,-0.335343058,79,361,440
2037,-1.350869376,0.68018326,018-BGF,-0.335343058,98,336,434
2038,-1.350869376,0.68018326,018-BGG,-0.335343058,91,324,415
2039,-1.350869376,0.68018326,018-BGH,-0.335343058,103,386,489
2040,-1.350869376,0.68018326,018-BGI,-0.335343058,92,311,403
2041,-1.350869376,0.68018326,018-BGJ,-0.335343058,99,366,465
2042,-1.350869376,0.68018326,018-BGK,-0.335343058,87,429,516
2043,-1.350869376,0.68018326,018-BGL,-0.335343058,114,343,457
2044,-1.350869376,0.68018326,018-BGM,-0.335343058,46,188,234
2045,-1.350869376,0.68018326,018-BGN,-0.335343058,65,418,483
2046,-1.350869376,0.68018326,018-BGO,-0.335343058,87,377,464
2047,-1.350869376,0.68018326,018-BGP,-0.335343058,159,355,514
2048,-1.350869376,0.68018326,018-BGQ,-0.335343058,143,389,532
2049,-1.350869376,0.68018326,018-BGY,-0.335343058,144,250,394
2050,-1.350869376,0.68018326,018-BHA,-0.335343058,140,274,414
2051,-1.350869376,0.68018326,018-BHC,-0.335343058,212,341,553
2052,-1.350869376,0.68018326,018-BHE,-0.335343058,122,285,407
2053,-1.350869376,0.68018326,018-BHG,-0.335343058,147,316,463
2054,-1.350869376,0.68018326,018-BHI,-0.335343058,139,276,415
2055,-1.350869376,0.68018326,018-BHK,-0.335343058,139,369,508
2056,-1.350869376,0.68018326,018-BHM,-0.335343058,92,351,443
2057,-1.350869376,0.68018326,018-BHO,-0.335343058,83,389,472
2058,-1.350869376,0.68018326,018-BHP,-0.335343058,117,314,431
2059,-1.350869376,0.68018326,018-BHQ,-0.335343058,124,316,440
2060,-1.350869376,0.68018326,018-BHR,-0.335343058,126,336,462
2061,-1.350869376,0.68018326,018-BHS,-0.335343058,153,302,455
2062,-1.350869376,0.68018326,018-BHT,-0.335343058,139,252,391
2063,-1.350869376,0.68018326,018-BHU,-0.335343058,164,308,472
2064,-1.350869376,0.68018326,018-BHV,-0.335343058,118,278,396
2065,-1.350869376,0.68018326,018-BHW,-0.335343058,147,317,464
2066,-1.350869376,0.68018326,018-BHX,-0.335343058,134,306,440
2067,-1.350869376,0.68018326,018-BHY,-0.335343058,75,205,280
2068,-1.350869376,0.68018326,018-BHZ,-0.335343058,128,571,699
2069,-1.350869376,0.68018326,018-BIG,-0.335343058,237,324,561
2070,-1.350869376,0.68018326,018-BII,-0.335343058,261,311,572
2071,-1.350869376,0.68018326,018-BIK,-0.335343058,181,283,464
2072,-1.350869376,0.68018326,018-BIM,-0.335343058,105,339,444
2073,-1.350869376,0.68018326,018-BIO,-0.335343058,173,302,475
2074,-1.350869376,0.68018326,018-BIQ,-0.335343058,126,294,420
2075,-1.350869376,0.68018326,018-BIS,-0.335343058,133,291,424
2076,-1.350869376,0.68018326,018-BIU,-0.335343058,115,196,311
2077,-1.350869376,0.68018326,018-BIW,-0.335343058,207,342,549
2078,-1.350869376,0.68018326,018-BIY,-0.335343058,250,310,560
2079,-1.350869376,0.68018326,018-BJA,-0.335343058,250,312,562
2080,-1.350869376,0.68018326,018-BJC,-0.335343058,190,289,479
2081,-1.350869376,0.68018326,018-BJE,-0.335343058,204,306,510
2082,-1.350869376,0.68018326,018-BJF,-0.335343058,219,354,573
2083,-1.350869376,0.68018326,018-BJG,-0.335343058,186,295,481
2084,-1.350869376,0.68018326,018-BJH,-0.335343058,246,390,636
2085,-1.350869376,0.68018326,018-BJI,-0.335343058,216,431,647
2086,-1.350869376,0.68018326,018-BJJ,-0.335343058,141,230,371
2087,-1.350869376,0.68018326,018-BJK,-0.335343058,184,304,488
2088,-1.350869376,0.68018326,018-BJL,-0.335343058,192,322,514
2089,-1.350869376,0.68018326,018-BJM,-0.335343058,157,233,390
2090,-1.350869376,0.68018326,018-BJN,-0.335343058,189,299,488
2091,-1.350869376,0.68018326,018-BJO,-0.335343058,223,343,566
2092,-1.350869376,0.68018326,018-DCU,-0.335343058,175,173,348
2093,-1.350869376,0.68018326,018-BMQ,-0.335343058,5,346,351
2094,-1.350869376,0.68018326,018-BMR,-0.335343058,2,297,299
2095,-1.350869376,0.68018326,018-BMS,-0.335343058,1,335,336
2096,-1.350869376,0.68018326,018-BMT,-0.335343058,3,310,313
2097,-1.350869376,0.68018326,018-BMU,-0.335343058,2,310,312
2098,-1.350869376,0.68018326,018-BMV,-0.335343058,8,360,368
2099,-1.350869376,0.68018326,018-BMW,-0.335343058,0,359,359
2100,-1.350869376,0.68018326,018-BMX,-0.335343058,4,485,489
2101,-1.350869376,0.68018326,018-BNF,-0.335343058,3,358,361
2102,-1.350869376,0.68018326,018-BNG,-0.335343058,4,224,228
2103,-1.350869376,0.68018326,018-BNH,-0.335343058,19,399,418
2104,-1.350869376,0.68018326,018-BNI,-0.335343058,0,282,282
2105,-1.350869376,0.68018326,018-BNJ,-0.335343058,5,173,178
2106,-1.350869376,0.68018326,018-BNK,-0.335343058,4,341,345
2107,-1.350869376,0.68018326,018-BNL,-0.335343058,2,413,415
2108,-1.350869376,0.68018326,018-BNM,-0.335343058,14,370,384
2109,-1.350869376,0.68018326,018-BNN,-0.335343058,3,305,308
2110,-1.350869376,0.68018326,018-BNV,-0.335343058,3,311,314
2111,-1.350869376,0.68018326,018-BNW,-0.335343058,5,382,387
2112,-1.350869376,0.68018326,018-BNX,-0.335343058,4,425,429
2113,-1.350869376,0.68018326,018-BNY,-0.335343058,71,558,629
2114,-1.350869376,0.68018326,018-BNZ,-0.335343058,4,508,512
2115,-1.350869376,0.68018326,018-BOA,-0.335343058,3,427,430
2116,-1.350869376,0.68018326,018-BOB,-0.335343058,1,439,440
2117,-1.350869376,0.68018326,018-BOC,-0.335343058,4,404,408
2118,-1.350869376,0.68018326,018-BOK,-0.335343058,223,317,540
2119,-1.350869376,0.68018326,018-BOL,-0.335343058,107,317,424
2120,-1.350869376,0.68018326,018-BOM,-0.335343058,113,313,426
2121,-1.350869376,0.68018326,018-BON,-0.335343058,121,419,540
2122,-1.350869376,0.68018326,018-BOO,-0.335343058,158,403,561
2123,-1.350869376,0.68018326,018-BOP,-0.335343058,119,437,556
2124,-1.350869376,0.68018326,018-BOQ,-0.335343058,190,340,530
2125,-1.350869376,0.68018326,018-BOR,-0.335343058,143,352,495
2126,-1.350869376,0.68018326,018-BOS,-0.335343058,277,429,706
2127,-1.350869376,0.68018326,018-BOT,-0.335343058,145,396,541
2128,-1.350869376,0.68018326,018-BOU,-0.335343058,89,408,497
2129,-1.350869376,0.68018326,018-BQA,-0.335343058,143,405,548
2130,-1.350869376,0.68018326,018-BOW,-0.335343058,119,406,525
2131,-1.350869376,0.68018326,018-BPD,-0.335343058,158,424,582
2132,-1.350869376,0.68018326,018-BPE,-0.335343058,100,451,551
2133,-1.350869376,0.68018326,018-BPF,-0.335343058,59,662,721
2134,-1.350869376,0.68018326,018-BPG,-0.335343058,88,375,463
2135,-1.350869376,0.68018326,018-BPH,-0.335343058,109,316,425
2136,-1.350869376,0.68018326,018-BPI,-0.335343058,145,310,455
2137,-1.350869376,0.68018326,018-BPJ,-0.335343058,120,325,445
2138,-1.350869376,0.68018326,018-BPK,-0.335343058,32,679,711
2139,-1.350869376,0.68018326,018-BPL,-0.335343058,216,314,530
2140,-1.350869376,0.68018326,018-BPM,-0.335343058,235,339,574
2141,-1.350869376,0.68018326,018-BPN,-0.335343058,171,269,440
2142,-1.350869376,0.68018326,018-BRE,-0.335343058,26,214,240
2143,-1.350869376,0.68018326,018-BOV,-0.335343058,57,237,294
2144,-1.350869376,0.68018326,018-BQK,-0.335343058,187,352,539
2145,-1.350869376,0.68018326,018-BQC,-0.335343058,43,476,519
2146,-1.350869376,0.68018326,018-BQJ,-0.335343058,168,417,585
2147,-1.350869376,0.68018326,018-BQE,-0.335343058,7,472,479
2148,-1.350869376,0.68018326,018-BQF,-0.335343058,103,439,542
2149,-1.350869376,0.68018326,018-BQG,-0.335343058,6,503,509
2150,-1.350869376,0.68018326,018-BQH,-0.335343058,113,298,411
2151,-1.350869376,0.68018326,018-BQI,-0.335343058,158,326,484
2152,-1.350869376,0.68018326,018-BQT,-0.335343058,73,553,626
2153,-1.350869376,0.68018326,018-BQU,-0.335343058,42,500,542
2154,-1.350869376,0.68018326,018-BQV,-0.335343058,50,517,567
2155,-1.350869376,0.68018326,018-BQW,-0.335343058,13,936,949
2156,-1.350869376,0.68018326,018-BQX,-0.335343058,24,296,320
2157,-1.350869376,0.68018326,018-BQY,-0.335343058,197,524,721
2158,-1.350869376,0.68018326,018-BQZ,-0.335343058,29,253,282
2159,-1.350869376,0.68018326,018-BRA,-0.335343058,66,159,225
2160,-1.350869376,0.68018326,018-BRB,-0.335343058,169,457,626
2161,-1.350869376,0.68018326,018-BRC,-0.335343058,76,412,488
2162,-1.350869376,0.68018326,018-BRD,-0.335343058,173,472,645
2163,-1.350869376,0.68018326,018-BQD,-0.335343058,134,455,589
2164,-1.350869376,0.68018326,018-BQB,-0.335343058,146,343,489
2165,-1.350869376,0.68018326,018-BPZ,-0.335343058,69,255,324
2166,-1.350869376,0.68018326,018-BRM,-0.335343058,274,188,462
2167,-1.350869376,0.68018326,018-BRN,-0.335343058,211,245,456
2168,-1.350869376,0.68018326,018-BRO,-0.335343058,240,224,464
2169,-1.350869376,0.68018326,018-BRP,-0.335343058,192,344,536
2170,-1.350869376,0.68018326,018-BRS,-0.335343058,63,116,179
2171,-1.350869376,0.68018326,018-BRT,-0.335343058,213,244,457
2172,-1.350869376,0.68018326,018-BRU,-0.335343058,236,324,560
2173,-1.350869376,0.68018326,018-BRV,-0.335343058,209,343,552
2174,-1.350869376,0.68018326,018-BRX,-0.335343058,261,302,563
2175,-1.350869376,0.68018326,018-BRY,-0.335343058,282,310,592
2176,-1.350869376,0.68018326,018-BRZ,-0.335343058,233,324,557
2177,-1.350869376,0.68018326,018-BSA,-0.335343058,262,295,557
2178,-1.350869376,0.68018326,018-BSE,-0.335343058,232,298,530
2179,-1.350869376,0.68018326,018-BSF,-0.335343058,206,278,484
2180,-1.350869376,0.68018326,018-BSG,-0.335343058,217,263,480
2181,-1.350869376,0.68018326,018-BSH,-0.335343058,130,224,354
2182,-1.350869376,0.68018326,018-BSJ,-0.335343058,237,240,477
2183,-1.350869376,0.68018326,018-BSK,-0.335343058,242,263,505
2184,-1.350869376,0.68018326,018-BSL,-0.335343058,195,243,438
2185,-1.350869376,0.68018326,018-BSM,-0.335343058,239,255,494
2186,-1.350869376,0.68018326,018-BSP,-0.335343058,18,595,613
2187,-1.350869376,0.68018326,018-BSQ,-0.335343058,2,82,84
2188,-1.350869376,0.68018326,018-BSR,-0.335343058,4,429,433
2189,-1.350869376,0.68018326,018-BSS,-0.335343058,7,528,535
2190,-1.350869376,0.68018326,018-BST,-0.335343058,5,457,462
2191,-1.350869376,0.68018326,018-BSX,-0.335343058,137,338,475
2192,-1.350869376,0.68018326,018-BSY,-0.335343058,143,313,456
2193,-1.350869376,0.68018326,018-BSZ,-0.335343058,110,307,417
2194,-1.350869376,0.68018326,018-BTA,-0.335343058,124,248,372
2195,-1.350869376,0.68018326,018-BTF,-0.335343058,11,9,20
2196,-1.350869376,0.68018326,018-BTH,-0.335343058,140,410,550
2197,-1.350869376,0.68018326,018-BTI,-0.335343058,166,429,595
2198,-1.350869376,0.68018326,018-BTM,-0.335343058,173,476,649
2199,-1.350869376,0.68018326,018-BTN,-0.335343058,199,363,562
2200,-1.350869376,0.68018326,018-BTO,-0.335343058,241,417,658
2201,-1.350869376,0.68018326,018-BTT,-0.335343058,209,335,544
2202,-1.350869376,0.68018326,018-BTU,-0.335343058,147,273,420
2203,-1.350869376,0.68018326,018-BTV,-0.335343058,105,248,353
2204,-1.350869376,0.68018326,018-BTW,-0.335343058,203,287,490
2205,-1.350869376,0.68018326,018-BUA,-0.335343058,221,294,515
2206,-1.350869376,0.68018326,018-BUB,-0.335343058,153,320,473
2207,-1.350869376,0.68018326,018-BUC,-0.335343058,175,349,524
2208,-1.350869376,0.68018326,018-BUD,-0.335343058,184,358,542
2209,-1.350869376,0.68018326,018-BUI,-0.335343058,188,302,490
2210,-1.350869376,0.68018326,018-BUJ,-0.335343058,240,448,688
2211,-1.350869376,0.68018326,018-BUK,-0.335343058,175,350,525
2212,-1.350869376,0.68018326,018-BUL,-0.335343058,209,389,598
2213,-1.350869376,0.68018326,018-BTG,-0.335343058,127,281,408
2214,-1.350869376,0.68018326,018-DBX,-0.335343058,353,235,588
2215,-1.350869376,0.68018326,018-DBY,-0.335343058,324,227,551
2216,-1.350869376,0.68018326,018-DBZ,-0.335343058,346,216,562
2217,-1.350869376,0.68018326,018-DAK,-0.335343058,33,122,155
2218,-1.350869376,0.68018326,018-DAL,-0.335343058,68,60,128
2219,-1.350869376,0.68018326,018-DAM,-0.335343058,21,76,97
2220,-1.350869376,0.68018326,018-BUP,-0.335343058,415,333,748
2221,-1.350869376,0.68018326,018-BUQ,-0.335343058,353,298,651
2222,-1.350869376,0.68018326,018-BUS,-0.335343058,395,328,723
2223,-1.350869376,0.68018326,018-BUT,-0.335343058,264,211,475
2224,-1.350869376,0.68018326,018-BUW,-0.335343058,392,302,694
2225,-1.350869376,0.68018326,018-BUX,-0.335343058,380,310,690
2226,-1.350869376,0.68018326,018-BUZ,-0.335343058,358,272,630
2227,-1.350869376,0.68018326,018-BVA,-0.335343058,364,323,687
2228,-1.350869376,0.68018326,018-DCS,-0.335343058,11,423,434
2229,-1.350869376,0.68018326,018-DAN,-0.335343058,260,147,407
2230,-1.350869376,0.68018326,018-BVC,-0.335343058,262,237,499
2231,-1.350869376,0.68018326,018-BVD,-0.335343058,181,171,352
2232,-1.350869376,0.68018326,018-BVE,-0.335343058,348,239,587
2233,-1.350869376,0.68018326,018-BVF,-0.335343058,347,243,590
2234,-1.350869376,0.68018326,018-BVG,-0.335343058,309,226,535
2235,-1.350869376,0.68018326,018-BVH,-0.335343058,434,276,710
2236,-1.350869376,0.68018326,018-BVI,-0.335343058,432,243,675
2237,-1.350869376,0.68018326,018-BVJ,-0.335343058,291,221,512
2238,-1.350869376,0.68018326,018-BVM,-0.335343058,243,228,471
2239,-1.350869376,0.68018326,018-BVN,-0.335343058,164,245,409
2240,-1.350869376,0.68018326,018-BVO,-0.335343058,177,297,474
2241,-1.350869376,0.68018326,018-BVP,-0.335343058,171,329,500
2242,-1.350869376,0.68018326,018-BVQ,-0.335343058,147,227,374
2243,-1.350869376,0.68018326,018-BVR,-0.335343058,130,280,410
2244,-1.350869376,0.68018326,018-BVS,-0.335343058,104,293,397
2245,-1.350869376,0.68018326,018-BVT,-0.335343058,142,220,362
2246,-1.350869376,0.68018326,018-BVU,-0.335343058,136,384,520
2247,-1.350869376,0.68018326,018-BVV,-0.335343058,85,256,341
2248,-1.350869376,0.68018326,018-BVW,-0.335343058,98,252,350
2249,-1.350869376,0.68018326,018-BVX,-0.335343058,115,349,464
2250,-1.350869376,0.68018326,018-BVY,-0.335343058,192,282,474
2251,-1.350869376,0.68018326,018-BVZ,-0.335343058,117,205,322
2252,-1.350869376,0.68018326,018-BWA,-0.335343058,139,429,568
2253,-1.350869376,0.68018326,018-BWF,-0.335343058,153,238,391
2254,-1.350869376,0.68018326,018-BWG,-0.335343058,114,242,356
2255,-1.350869376,0.68018326,018-BWH,-0.335343058,125,321,446
2256,-1.350869376,0.68018326,018-BWI,-0.335343058,100,221,321
2257,-1.350869376,0.68018326,018-BWJ,-0.335343058,146,344,490
2258,-1.350869376,0.68018326,018-BWK,-0.335343058,93,260,353
2259,-1.350869376,0.68018326,018-BWL,-0.335343058,129,245,374
2260,-1.350869376,0.68018326,018-BWM,-0.335343058,116,241,357
2261,-1.350869376,0.68018326,018-BWN,-0.335343058,94,269,363
2262,-1.350869376,0.68018326,018-BWO,-0.335343058,90,250,340
2263,-1.350869376,0.68018326,018-BWP,-0.335343058,91,264,355
2264,-1.350869376,0.68018326,018-BWQ,-0.335343058,140,320,460
2265,-1.350869376,0.68018326,018-BWR,-0.335343058,164,378,542
2266,-1.350869376,0.68018326,018-BWS,-0.335343058,109,303,412
2267,-1.350869376,0.68018326,018-BWT,-0.335343058,111,286,397
2268,-1.350869376,0.68018326,018-BWU,-0.335343058,97,303,400
2269,-1.350869376,0.68018326,018-BWV,-0.335343058,98,292,390
2270,-1.350869376,0.68018326,018-BXA,-0.335343058,95,220,315
2271,-1.350869376,0.68018326,018-BXB,-0.335343058,70,193,263
2272,-1.350869376,0.68018326,018-BXC,-0.335343058,169,256,425
2273,-1.350869376,0.68018326,018-BXD,-0.335343058,157,298,455
2274,-1.350869376,0.68018326,018-BXE,-0.335343058,118,244,362
2275,-1.350869376,0.68018326,018-BXF,-0.335343058,148,259,407
2276,-1.350869376,0.68018326,018-BXG,-0.335343058,130,232,362
2277,-1.350869376,0.68018326,018-BXH,-0.335343058,88,230,318
2278,-1.350869376,0.68018326,018-BXI,-0.335343058,101,268,369
2279,-1.350869376,0.68018326,018-BXJ,-0.335343058,90,297,387
2280,-1.350869376,0.68018326,018-BXK,-0.335343058,117,243,360
2281,-1.350869376,0.68018326,018-BXL,-0.335343058,169,447,616
2282,-1.350869376,0.68018326,018-BXM,-0.335343058,119,241,360
2283,-1.350869376,0.68018326,018-BXN,-0.335343058,128,315,443
2284,-1.350869376,0.68018326,018-BXO,-0.335343058,135,242,377
2285,-1.350869376,0.68018326,018-BXP,-0.335343058,111,239,350
2286,-1.350869376,0.68018326,018-BXQ,-0.335343058,107,217,324
2287,-1.350869376,0.68018326,018-BXV,-0.335343058,162,271,433
2288,-1.350869376,0.68018326,018-BXW,-0.335343058,169,437,606
2289,-1.350869376,0.68018326,018-BXX,-0.335343058,118,391,509
2290,-1.350869376,0.68018326,018-BXY,-0.335343058,98,206,304
2291,-1.350869376,0.68018326,018-BXZ,-0.335343058,60,266,326
2292,-1.350869376,0.68018326,018-BYA,-0.335343058,71,275,346
2293,-1.350869376,0.68018326,018-BYB,-0.335343058,91,282,373
2294,-1.350869376,0.68018326,018-BYC,-0.335343058,84,282,366
2295,-1.350869376,0.68018326,018-BYD,-0.335343058,122,348,470
2296,-1.350869376,0.68018326,018-BYE,-0.335343058,143,252,395
2297,-1.350869376,0.68018326,018-BYF,-0.335343058,87,354,441
2298,-1.350869376,0.68018326,018-BYG,-0.335343058,76,231,307
2299,-1.350869376,0.68018326,018-BYH,-0.335343058,49,256,305
2300,-1.350869376,0.68018326,018-BYI,-0.335343058,68,234,302
2301,-1.350869376,0.68018326,018-BYJ,-0.335343058,130,316,446
2302,-1.350869376,0.68018326,018-BYK,-0.335343058,57,253,310
2303,-1.350869376,0.68018326,018-CZW,-0.335343058,10,33,43
2304,-1.350869376,0.68018326,018-BYP,-0.335343058,175,276,451
2305,-1.350869376,0.68018326,018-BYQ,-0.335343058,209,263,472
2306,-1.350869376,0.68018326,018-BYR,-0.335343058,244,291,535
2307,-1.350869376,0.68018326,018-BYS,-0.335343058,180,245,425
2308,-1.350869376,0.68018326,018-BYT,-0.335343058,211,196,407
2309,-1.350869376,0.68018326,018-BYV,-0.335343058,220,298,518
2310,-1.350869376,0.68018326,018-BYW,-0.335343058,228,262,490
2311,-1.350869376,0.68018326,018-BYX,-0.335343058,202,237,439
2312,-1.350869376,0.68018326,018-BYY,-0.335343058,310,303,613
2313,-1.350869376,0.68018326,018-BZB,-0.335343058,235,567,802
2314,-1.350869376,0.68018326,018-BZC,-0.335343058,268,318,586
2315,-1.350869376,0.68018326,018-BZD,-0.335343058,64,98,162
2316,-1.350869376,0.68018326,018-BZE,-0.335343058,239,295,534
2317,-1.350869376,0.68018326,018-BZF,-0.335343058,70,226,296
2318,-1.350869376,0.68018326,018-BZJ,-0.335343058,237,254,491
2319,-1.350869376,0.68018326,018-BZK,-0.335343058,171,222,393
2320,-1.350869376,0.68018326,018-BZL,-0.335343058,192,278,470
2321,-1.350869376,0.68018326,018-BZM,-0.335343058,214,175,389
2322,-1.350869376,0.68018326,018-BZN,-0.335343058,202,267,469
2323,-1.350869376,0.68018326,018-BZQ,-0.335343058,85,364,449
2324,-1.350869376,0.68018326,018-BZR,-0.335343058,117,224,341
2325,-1.350869376,0.68018326,018-BZS,-0.335343058,84,336,420
2326,-1.350869376,0.68018326,018-BZT,-0.335343058,110,334,444
2327,-1.350869376,0.68018326,018-BZV,-0.335343058,49,300,349
2328,-1.350869376,0.68018326,018-BZW,-0.335343058,82,287,369
2329,-1.350869376,0.68018326,018-BZX,-0.335343058,93,353,446
2330,-1.350869376,0.68018326,018-BZY,-0.335343058,77,422,499
2331,-1.350869376,0.68018326,018-CAB,-0.335343058,79,311,390
2332,-1.350869376,0.68018326,018-CAC,-0.335343058,100,353,453
2333,-1.350869376,0.68018326,018-CAD,-0.335343058,32,279,311
2334,-1.350869376,0.68018326,018-CAE,-0.335343058,82,301,383
2335,-1.350869376,0.68018326,018-CAG,-0.335343058,64,407,471
2336,-1.350869376,0.68018326,018-CAH,-0.335343058,37,396,433
2337,-1.350869376,0.68018326,018-CAI,-0.335343058,70,371,441
2338,-1.350869376,0.68018326,018-CAJ,-0.335343058,47,406,453
2339,-1.350869376,0.68018326,018-CAL,-0.335343058,33,382,415
2340,-1.350869376,0.68018326,018-CAM,-0.335343058,66,445,511
2341,-1.350869376,0.68018326,018-CAN,-0.335343058,43,349,392
2342,-1.350869376,0.68018326,018-CAO,-0.335343058,30,352,382
2343,-1.350869376,0.68018326,018-CAQ,-0.335343058,40,422,462
2344,-1.350869376,0.68018326,018-CAR,-0.335343058,31,439,470
2345,-1.350869376,0.68018326,018-CAS,-0.335343058,26,450,476
2346,-1.350869376,0.68018326,018-CAT,-0.335343058,27,388,415
2347,-1.350869376,0.68018326,018-CAV,-0.335343058,38,488,526
2348,-1.350869376,0.68018326,018-CAW,-0.335343058,34,492,526
2349,-1.350869376,0.68018326,018-CAX,-0.335343058,36,395,431
2350,-1.350869376,0.68018326,018-CAY,-0.335343058,15,435,450
2351,-1.350869376,0.68018326,018-CBA,-0.335343058,154,385,539
2352,-1.350869376,0.68018326,018-CBC,-0.335343058,187,283,470
2353,-1.350869376,0.68018326,018-CBE,-0.335343058,173,488,661
2354,-1.350869376,0.68018326,018-CBG,-0.335343058,191,299,490
2355,-1.350869376,0.68018326,018-CBI,-0.335343058,187,282,469
2356,-1.350869376,0.68018326,018-CBK,-0.335343058,234,349,583
2357,-1.350869376,0.68018326,018-CBM,-0.335343058,159,219,378
2358,-1.350869376,0.68018326,018-CBO,-0.335343058,203,251,454
2359,-1.350869376,0.68018326,018-CBP,-0.335343058,165,241,406
2360,-1.350869376,0.68018326,018-CBQ,-0.335343058,212,230,442
2361,-1.350869376,0.68018326,018-CBR,-0.335343058,204,276,480
2362,-1.350869376,0.68018326,018-CBS,-0.335343058,267,408,675
2363,-1.350869376,0.68018326,018-CBT,-0.335343058,180,247,427
2364,-1.350869376,0.68018326,018-CBU,-0.335343058,186,160,346
2365,-1.350869376,0.68018326,018-CBV,-0.335343058,221,238,459
2366,-1.350869376,0.68018326,018-CBW,-0.335343058,161,173,334
2367,-1.350869376,0.68018326,018-CBX,-0.335343058,139,174,313
2368,-1.350869376,0.68018326,018-CBY,-0.335343058,115,234,349
2369,-1.350869376,0.68018326,018-CBZ,-0.335343058,171,234,405
2370,-1.350869376,0.68018326,018-CCA,-0.335343058,187,227,414
2371,-1.350869376,0.68018326,018-CCB,-0.335343058,94,270,364
2372,-1.350869376,0.68018326,018-DCC,-0.335343058,287,213,500
2373,-1.350869376,0.68018326,018-DCE,-0.335343058,285,219,504
2374,-1.350869376,0.68018326,018-DCG,-0.335343058,231,155,386
2375,-1.350869376,0.68018326,018-DCH,-0.335343058,91,132,223
2376,-1.350869376,0.68018326,018-DCI,-0.335343058,201,222,423
2377,-1.350869376,0.68018326,018-CCH,-0.335343058,257,373,630
2378,-1.350869376,0.68018326,018-CCI,-0.335343058,201,284,485
2379,-1.350869376,0.68018326,018-CCJ,-0.335343058,219,240,459
2380,-1.350869376,0.68018326,018-CCK,-0.335343058,331,489,820
2381,-1.350869376,0.68018326,018-CCN,-0.335343058,189,175,364
2382,-1.350869376,0.68018326,018-CCO,-0.335343058,188,188,376
2383,-1.350869376,0.68018326,018-CCP,-0.335343058,128,243,371
2384,-1.350869376,0.68018326,018-CCQ,-0.335343058,190,259,449
2385,-1.350869376,0.68018326,018-CCR,-0.335343058,182,190,372
2386,-1.350869376,0.68018326,018-CCT,-0.335343058,278,300,578
2387,-1.350869376,0.68018326,018-CCU,-0.335343058,195,212,407
2388,-1.350869376,0.68018326,018-CCV,-0.335343058,212,183,395
2389,-1.350869376,0.68018326,018-CCW,-0.335343058,202,210,412
2390,-1.350869376,0.68018326,018-CCX,-0.335343058,255,243,498
2391,-1.350869376,0.68018326,018-CDA,-0.335343058,251,219,470
2392,-1.350869376,0.68018326,018-CDB,-0.335343058,276,227,503
2393,-1.350869376,0.68018326,018-CDC,-0.335343058,274,219,493
2394,-1.350869376,0.68018326,018-CDD,-0.335343058,212,276,488
2395,-1.350869376,0.68018326,018-DBS,-0.335343058,196,279,475
2396,-1.350869376,0.68018326,018-DBT,-0.335343058,172,246,418
2397,-1.350869376,0.68018326,018-DBU,-0.335343058,233,248,481
2398,-1.350869376,0.68018326,018-DBV,-0.335343058,158,258,416
2399,-1.350869376,0.68018326,018-DBW,-0.335343058,209,269,478
2400,-1.350869376,0.68018326,018-DAO,-0.335343058,125,209,334
2401,-1.350869376,0.68018326,018-DAP,-0.335343058,155,285,440
2402,-1.350869376,0.68018326,018-CDH,-0.335343058,237,276,513
2403,-1.350869376,0.68018326,018-CDI,-0.335343058,220,236,456
2404,-1.350869376,0.68018326,018-CDJ,-0.335343058,263,297,560
2405,-1.350869376,0.68018326,018-CDK,-0.335343058,239,242,481
2406,-1.350869376,0.68018326,018-CDL,-0.335343058,277,291,568
2407,-1.350869376,0.68018326,018-CDM,-0.335343058,169,229,398
2408,-1.350869376,0.68018326,018-CDN,-0.335343058,153,219,372
2409,-1.350869376,0.68018326,018-CDO,-0.335343058,166,151,317
2410,-1.350869376,0.68018326,018-CDP,-0.335343058,207,194,401
2411,-1.350869376,0.68018326,018-DEC,-0.335343058,313,329,642
2412,-1.350869376,0.68018326,018-CDT,-0.335343058,241,269,510
2413,-1.350869376,0.68018326,018-CDU,-0.335343058,214,296,510
2414,-1.350869376,0.68018326,018-CDV,-0.335343058,250,236,486
2415,-1.350869376,0.68018326,018-CDW,-0.335343058,227,207,434
2416,-1.350869376,0.68018326,018-CDX,-0.335343058,193,288,481
2417,-1.350869376,0.68018326,018-CDY,-0.335343058,202,268,470
2418,-1.350869376,0.68018326,018-CDZ,-0.335343058,122,176,298
2419,-1.350869376,0.68018326,018-CEA,-0.335343058,165,218,383
2420,-1.350869376,0.68018326,018-CEB,-0.335343058,276,351,627
2421,-1.350869376,0.68018326,018-CEE,-0.335343058,291,355,646
2422,-1.350869376,0.68018326,018-CEF,-0.335343058,311,373,684
2423,-1.350869376,0.68018326,018-CEG,-0.335343058,287,296,583
2424,-1.350869376,0.68018326,018-CEH,-0.335343058,313,307,620
2425,-1.350869376,0.68018326,018-CEI,-0.335343058,194,325,519
2426,-1.350869376,0.68018326,018-CEJ,-0.335343058,250,352,602
2427,-1.350869376,0.68018326,018-CEK,-0.335343058,271,351,622
2428,-1.350869376,0.68018326,018-CEL,-0.335343058,259,286,545
2429,-1.350869376,0.68018326,018-CES,-0.335343058,189,284,473
2430,-1.350869376,0.68018326,018-CET,-0.335343058,233,254,487
2431,-1.350869376,0.68018326,018-CEU,-0.335343058,99,186,285
2432,-1.350869376,0.68018326,018-CEV,-0.335343058,254,325,579
2433,-1.350869376,0.68018326,018-CEW,-0.335343058,110,212,322
2434,-1.350869376,0.68018326,018-CEX,-0.335343058,147,177,324
2435,-1.350869376,0.68018326,018-CEY,-0.335343058,230,335,565
2436,-1.350869376,0.68018326,018-CEZ,-0.335343058,184,285,469
2437,-1.350869376,0.68018326,018-CFA,-0.335343058,243,203,446
2438,-1.350869376,0.68018326,018-DCQ,-0.335343058,31,189,220
2439,-1.350869376,0.68018326,018-DCR,-0.335343058,14,277,291
2440,-1.350869376,0.68018326,018-CFD,-0.335343058,321,321,642
2441,-1.350869376,0.68018326,018-CFE,-0.335343058,339,288,627
2442,-1.350869376,0.68018326,018-CFF,-0.335343058,285,255,540
2443,-1.350869376,0.68018326,018-CFG,-0.335343058,391,343,734
2444,-1.350869376,0.68018326,018-CFI,-0.335343058,383,299,682
2445,-1.350869376,0.68018326,018-CFJ,-0.335343058,434,336,770
2446,-1.350869376,0.68018326,018-CFK,-0.335343058,337,219,556
2447,-1.350869376,0.68018326,018-CFL,-0.335343058,428,253,681
2448,-1.350869376,0.68018326,018-CFQ,-0.335343058,432,316,748
2449,-1.350869376,0.68018326,018-CFR,-0.335343058,143,269,412
2450,-1.350869376,0.68018326,018-CFS,-0.335343058,300,257,557
2451,-1.350869376,0.68018326,018-CFT,-0.335343058,213,261,474
2452,-1.350869376,0.68018326,018-CFU,-0.335343058,327,178,505
2453,-1.350869376,0.68018326,018-CFW,-0.335343058,253,226,479
2454,-1.350869376,0.68018326,018-CFX,-0.335343058,244,194,438
2455,-1.350869376,0.68018326,018-CFY,-0.335343058,159,212,371
2456,-1.350869376,0.68018326,018-CFZ,-0.335343058,304,205,509
2457,-1.350869376,0.68018326,018-CGA,-0.335343058,131,139,270
2458,-1.350869376,0.68018326,018-CGB,-0.335343058,167,220,387
2459,-1.350869376,0.68018326,018-CGC,-0.335343058,283,334,617
2460,-1.350869376,0.68018326,018-CGD,-0.335343058,195,254,449
2461,-1.350869376,0.68018326,018-CGE,-0.335343058,279,237,516
2462,-1.350869376,0.68018326,018-CGF,-0.335343058,373,339,712
2463,-1.350869376,0.68018326,018-CGG,-0.335343058,329,380,709
2464,-1.350869376,0.68018326,018-CGH,-0.335343058,310,248,558
2465,-1.350869376,0.68018326,018-CGI,-0.335343058,288,204,492
2466,-1.350869376,0.68018326,018-CGJ,-0.335343058,246,226,472
2467,-1.350869376,0.68018326,018-CGK,-0.335343058,477,288,765
2468,-1.350869376,0.68018326,018-CGL,-0.335343058,523,316,839
2469,-1.350869376,0.68018326,018-DAS,-0.335343058,74,488,562
2470,-1.350869376,0.68018326,018-DAW,-0.335343058,7,537,544
2471,-1.350869376,0.68018326,018-DAX,-0.335343058,36,184,220
2472,-1.350869376,0.68018326,018-DAY,-0.335343058,10,28,38
2473,-1.350869376,0.68018326,018-DAZ,-0.335343058,99,205,304
2474,-1.350869376,0.68018326,018-DBA,-0.335343058,5,11,16
2475,-1.350869376,0.68018326,018-DBC,-0.335343058,30,367,397
2476,-1.350869376,0.68018326,018-CGN,-0.335343058,194,265,459
2477,-1.350869376,0.68018326,018-CGO,-0.335343058,310,328,638
2478,-1.350869376,0.68018326,018-CGP,-0.335343058,233,289,522
2479,-1.350869376,0.68018326,018-CGQ,-0.335343058,327,352,679
2480,-1.350869376,0.68018326,018-CGS,-0.335343058,396,443,839
2481,-1.350869376,0.68018326,018-CGT,-0.335343058,186,257,443
2482,-1.350869376,0.68018326,018-CGV,-0.335343058,241,282,523
2483,-1.350869376,0.68018326,018-CGW,-0.335343058,294,375,669
2484,-1.350869376,0.68018326,018-DBD,-0.335343058,285,360,645
2485,-1.350869376,0.68018326,018-DBE,-0.335343058,148,162,310
2486,-1.350869376,0.68018326,018-DBF,-0.335343058,238,246,484
2487,-1.350869376,0.68018326,018-DBG,-0.335343058,314,394,708
2488,-1.350869376,0.68018326,018-DBH,-0.335343058,260,188,448
2489,-1.350869376,0.68018326,018-DBI,-0.335343058,346,401,747
2490,-1.350869376,0.68018326,018-DBJ,-0.335343058,672,714,1386
2491,-1.350869376,0.68018326,018-DBK,-0.335343058,123,184,307
2492,-1.350869376,0.68018326,018-DBL,-0.335343058,77,96,173
2493,-1.350869376,0.68018326,018-DBM,-0.335343058,221,363,584
2494,-1.350869376,0.68018326,018-DBN,-0.335343058,437,399,836
2495,-1.350869376,0.68018326,018-DBO,-0.335343058,85,140,225
2496,-1.350869376,0.68018326,018-DAG,-0.335343058,108,392,500
2497,-1.350869376,0.68018326,018-DAH,-0.335343058,183,348,531
2498,-1.350869376,0.68018326,018-DAI,-0.335343058,277,492,769
2499,-1.350869376,0.68018326,018-DAJ,-0.335343058,126,270,396
2500,-1.350869376,0.68018326,018-CLV,-0.335343058,289,512,801
2501,-1.350869376,0.68018326,018-CLX,-0.335343058,171,238,409
2502,-1.350869376,0.68018326,018-CLZ,-0.335343058,215,248,463
2503,-1.350869376,0.68018326,018-CMB,-0.335343058,158,254,412
2504,-1.350869376,0.68018326,018-CMC,-0.335343058,172,213,385
2505,-1.350869376,0.68018326,018-CMD,-0.335343058,184,234,418
2506,-1.350869376,0.68018326,018-CME,-0.335343058,196,273,469
2507,-1.350869376,0.68018326,018-CMF,-0.335343058,208,266,474
2508,-1.350869376,0.68018326,018-CMG,-0.335343058,152,194,346
2509,-1.350869376,0.68018326,018-CMH,-0.335343058,189,280,469
2510,-1.350869376,0.68018326,018-CMI,-0.335343058,153,240,393
2511,-1.350869376,0.68018326,018-CMJ,-0.335343058,173,264,437
2512,-1.350869376,0.68018326,018-CMK,-0.335343058,227,274,501
2513,-1.350869376,0.68018326,018-CML,-0.335343058,145,255,400
2514,-1.350869376,0.68018326,018-CMM,-0.335343058,174,219,393
2515,-1.350869376,0.68018326,018-CMN,-0.335343058,147,231,378
2516,-1.350869376,0.68018326,018-CMO,-0.335343058,186,252,438
2517,-1.350869376,0.68018326,018-CMP,-0.335343058,168,194,362
2518,-1.350869376,0.68018326,018-CMQ,-0.335343058,169,234,403
2519,-1.350869376,0.68018326,018-CMR,-0.335343058,91,244,335
2520,-1.350869376,0.68018326,018-CMS,-0.335343058,148,180,328
2521,-1.350869376,0.68018326,018-CMT,-0.335343058,185,232,417
2522,-1.350869376,0.68018326,018-CMU,-0.335343058,188,285,473
2523,-1.350869376,0.68018326,018-CGX,-0.335343058,168,277,445
2524,-1.350869376,0.68018326,018-CGY,-0.335343058,172,288,460
2525,-1.350869376,0.68018326,018-CGZ,-0.335343058,108,248,356
2526,-1.350869376,0.68018326,018-CHA,-0.335343058,264,237,501
2527,-1.350869376,0.68018326,018-CHB,-0.335343058,110,287,397
2528,-1.350869376,0.68018326,018-CHC,-0.335343058,216,273,489
2529,-1.350869376,0.68018326,018-CHD,-0.335343058,118,195,313
2530,-1.350869376,0.68018326,018-CHE,-0.335343058,169,271,440
2531,-1.350869376,0.68018326,018-CHF,-0.335343058,178,239,417
2532,-1.350869376,0.68018326,018-CHG,-0.335343058,82,154,236
2533,-1.350869376,0.68018326,018-CHL,-0.335343058,202,274,476
2534,-1.350869376,0.68018326,018-CHM,-0.335343058,185,281,466
2535,-1.350869376,0.68018326,018-CHN,-0.335343058,177,250,427
2536,-1.350869376,0.68018326,018-CHO,-0.335343058,67,157,224
2537,-1.350869376,0.68018326,018-CHP,-0.335343058,152,222,374
2538,-1.350869376,0.68018326,018-CHQ,-0.335343058,176,266,442
2539,-1.350869376,0.68018326,018-CHR,-0.335343058,180,272,452
2540,-1.350869376,0.68018326,018-CHS,-0.335343058,193,305,498
2541,-1.350869376,0.68018326,018-CHT,-0.335343058,169,202,371
2542,-1.350869376,0.68018326,018-CHU,-0.335343058,144,240,384
2543,-1.350869376,0.68018326,018-CHV,-0.335343058,193,279,472
2544,-1.350869376,0.68018326,018-CIA,-0.335343058,139,232,371
2545,-1.350869376,0.68018326,018-CIB,-0.335343058,205,303,508
2546,-1.350869376,0.68018326,018-CIC,-0.335343058,187,251,438
2547,-1.350869376,0.68018326,018-CID,-0.335343058,189,206,395
2548,-1.350869376,0.68018326,018-CIE,-0.335343058,161,249,410
2549,-1.350869376,0.68018326,018-CIF,-0.335343058,129,239,368
2550,-1.350869376,0.68018326,018-CIG,-0.335343058,208,285,493
2551,-1.350869376,0.68018326,018-CIH,-0.335343058,8,23,31
2552,-1.350869376,0.68018326,018-CII,-0.335343058,188,330,518
2553,-1.350869376,0.68018326,018-CIJ,-0.335343058,177,249,426
2554,-1.350869376,0.68018326,018-CIP,-0.335343058,249,324,573
2555,-1.350869376,0.68018326,018-CIQ,-0.335343058,187,267,454
2556,-1.350869376,0.68018326,018-CIR,-0.335343058,156,224,380
2557,-1.350869376,0.68018326,018-CIS,-0.335343058,149,238,387
2558,-1.350869376,0.68018326,018-CIT,-0.335343058,171,249,420
2559,-1.350869376,0.68018326,018-CIU,-0.335343058,185,267,452
2560,-1.350869376,0.68018326,018-CIV,-0.335343058,152,259,411
2561,-1.350869376,0.68018326,018-CIW,-0.335343058,53,176,229
2562,-1.350869376,0.68018326,018-CIX,-0.335343058,173,283,456
2563,-1.350869376,0.68018326,018-CJB,-0.335343058,207,254,461
2564,-1.350869376,0.68018326,018-CJC,-0.335343058,219,253,472
2565,-1.350869376,0.68018326,018-CJD,-0.335343058,314,235,549
2566,-1.350869376,0.68018326,018-CJE,-0.335343058,211,213,424
2567,-1.350869376,0.68018326,018-CJF,-0.335343058,416,381,797
2568,-1.350869376,0.68018326,018-CJG,-0.335343058,164,234,398
2569,-1.350869376,0.68018326,018-CJH,-0.335343058,182,237,419
2570,-1.350869376,0.68018326,018-CJI,-0.335343058,311,376,687
2571,-1.350869376,0.68018326,018-CJJ,-0.335343058,170,175,345
2572,-1.350869376,0.68018326,018-CJK,-0.335343058,236,258,494
2573,-1.350869376,0.68018326,018-CJP,-0.335343058,190,317,507
2574,-1.350869376,0.68018326,018-CJQ,-0.335343058,191,150,341
2575,-1.350869376,0.68018326,018-CJR,-0.335343058,187,205,392
2576,-1.350869376,0.68018326,018-CJS,-0.335343058,140,181,321
2577,-1.350869376,0.68018326,018-CJT,-0.335343058,208,274,482
2578,-1.350869376,0.68018326,018-CJU,-0.335343058,212,300,512
2579,-1.350869376,0.68018326,018-CJV,-0.335343058,274,293,567
2580,-1.350869376,0.68018326,018-CJW,-0.335343058,159,239,398
2581,-1.350869376,0.68018326,018-CJX,-0.335343058,174,193,367
2582,-1.350869376,0.68018326,018-CJY,-0.335343058,278,266,544
2583,-1.350869376,0.68018326,018-CKD,-0.335343058,115,212,327
2584,-1.350869376,0.68018326,018-CKE,-0.335343058,305,266,571
2585,-1.350869376,0.68018326,018-CKF,-0.335343058,360,349,709
2586,-1.350869376,0.68018326,018-CKG,-0.335343058,177,238,415
2587,-1.350869376,0.68018326,018-CKH,-0.335343058,185,217,402
2588,-1.350869376,0.68018326,018-CKI,-0.335343058,144,203,347
2589,-1.350869376,0.68018326,018-CKJ,-0.335343058,203,283,486
2590,-1.350869376,0.68018326,018-CKK,-0.335343058,233,281,514
2591,-1.350869376,0.68018326,018-CKL,-0.335343058,210,255,465
2592,-1.350869376,0.68018326,018-CKM,-0.335343058,324,299,623
2593,-1.350869376,0.68018326,018-CKS,-0.335343058,181,230,411
2594,-1.350869376,0.68018326,018-CKT,-0.335343058,191,259,450
2595,-1.350869376,0.68018326,018-CKU,-0.335343058,235,290,525
2596,-1.350869376,0.68018326,018-CKV,-0.335343058,183,218,401
2597,-1.350869376,0.68018326,018-CKW,-0.335343058,130,287,417
2598,-1.350869376,0.68018326,018-CKX,-0.335343058,180,246,426
2599,-1.350869376,0.68018326,018-CKY,-0.335343058,178,263,441
2600,-1.350869376,0.68018326,018-CKZ,-0.335343058,203,223,426
2601,-1.350869376,0.68018326,018-CLA,-0.335343058,266,294,560
2602,-1.350869376,0.68018326,018-CLB,-0.335343058,134,200,334
2603,-1.350869376,0.68018326,018-CLH,-0.335343058,199,268,467
2604,-1.350869376,0.68018326,018-CLI,-0.335343058,145,278,423
2605,-1.350869376,0.68018326,018-CLJ,-0.335343058,154,230,384
2606,-1.350869376,0.68018326,018-CLK,-0.335343058,204,271,475
2607,-1.350869376,0.68018326,018-CLL,-0.335343058,181,272,453
2608,-1.350869376,0.68018326,018-CLM,-0.335343058,143,191,334
2609,-1.350869376,0.68018326,018-CLN,-0.335343058,219,245,464
2610,-1.350869376,0.68018326,018-CLO,-0.335343058,224,278,502
2611,-1.350869376,0.68018326,018-CLP,-0.335343058,180,205,385
2612,-1.350869376,0.68018326,018-CLQ,-0.335343058,133,208,341
2613,-1.350869376,0.68018326,018-CMY,-0.335343058,180,336,516
2614,-1.350869376,0.68018326,018-CMZ,-0.335343058,149,231,380
2615,-1.350869376,0.68018326,018-CNA,-0.335343058,187,270,457
2616,-1.350869376,0.68018326,018-CNB,-0.335343058,328,361,689
2617,-1.350869376,0.68018326,018-CNC,-0.335343058,199,347,546
2618,-1.350869376,0.68018326,018-CND,-0.335343058,167,249,416
2619,-1.350869376,0.68018326,018-CNE,-0.335343058,230,309,539
2620,-1.350869376,0.68018326,018-CNF,-0.335343058,176,166,342
2621,-1.350869376,0.68018326,018-CNI,-0.335343058,202,307,509
2622,-1.350869376,0.68018326,018-CNJ,-0.335343058,42,417,459
2623,-1.350869376,0.68018326,018-CNK,-0.335343058,65,363,428
2624,-1.350869376,0.68018326,018-CNM,-0.335343058,179,502,681
2625,-1.350869376,0.68018326,018-CNN,-0.335343058,42,291,333
2626,-1.350869376,0.68018326,018-CNO,-0.335343058,123,245,368
2627,-1.350869376,0.68018326,018-CNQ,-0.335343058,174,424,598
2628,-1.350869376,0.68018326,018-CNR,-0.335343058,166,385,551
2629,-1.350869376,0.68018326,018-CNS,-0.335343058,136,261,397
2630,-1.350869376,0.68018326,018-CNV,-0.335343058,217,435,652
2631,-1.350869376,0.68018326,018-CNW,-0.335343058,126,262,388
2632,-1.350869376,0.68018326,018-CNX,-0.335343058,134,293,427
2633,-1.350869376,0.68018326,018-COA,-0.335343058,248,206,454
2634,-1.350869376,0.68018326,018-COB,-0.335343058,290,181,471
2635,-1.350869376,0.68018326,018-COC,-0.335343058,261,259,520
2636,-1.350869376,0.68018326,018-COD,-0.335343058,236,237,473
2637,-1.350869376,0.68018326,018-COE,-0.335343058,218,197,415
2638,-1.350869376,0.68018326,018-COF,-0.335343058,272,214,486
2639,-1.350869376,0.68018326,018-COG,-0.335343058,251,163,414
2640,-1.350869376,0.68018326,018-COK,-0.335343058,231,214,445
2641,-1.350869376,0.68018326,018-COL,-0.335343058,249,260,509
2642,-1.350869376,0.68018326,018-COM,-0.335343058,134,131,265
2643,-1.350869376,0.68018326,018-CON,-0.335343058,261,228,489
2644,-1.350869376,0.68018326,018-COO,-0.335343058,265,269,534
2645,-1.350869376,0.68018326,018-COP,-0.335343058,219,294,513
2646,-1.350869376,0.68018326,018-COQ,-0.335343058,177,208,385
2647,-1.350869376,0.68018326,018-COU,-0.335343058,216,254,470
2648,-1.350869376,0.68018326,018-COV,-0.335343058,229,282,511
2649,-1.350869376,0.68018326,018-COW,-0.335343058,232,272,504
2650,-1.350869376,0.68018326,018-COX,-0.335343058,209,321,530
2651,-1.350869376,0.68018326,018-COY,-0.335343058,308,231,539
2652,-1.350869376,0.68018326,018-COZ,-0.335343058,269,304,573
2653,-1.350869376,0.68018326,018-CPD,-0.335343058,217,282,499
2654,-1.350869376,0.68018326,018-CPE,-0.335343058,206,234,440
2655,-1.350869376,0.68018326,018-CPF,-0.335343058,248,233,481
2656,-1.350869376,0.68018326,018-CPG,-0.335343058,194,253,447
2657,-1.350869376,0.68018326,018-CPH,-0.335343058,252,317,569
2658,-1.350869376,0.68018326,018-CPI,-0.335343058,213,181,394
2659,-1.350869376,0.68018326,018-CPM,-0.335343058,281,254,535
2660,-1.350869376,0.68018326,018-CPN,-0.335343058,331,312,643
2661,-1.350869376,0.68018326,018-CPO,-0.335343058,267,297,564
2662,-1.350869376,0.68018326,018-CPR,-0.335343058,246,256,502
2663,-1.350869376,0.68018326,018-CPS,-0.335343058,347,320,667
2664,-1.350869376,0.68018326,018-CPT,-0.335343058,240,295,535
2665,-1.350869376,0.68018326,018-CPW,-0.335343058,285,229,514
2666,-1.350869376,0.68018326,018-CPX,-0.335343058,312,317,629
2667,-1.350869376,0.68018326,018-CPY,-0.335343058,376,329,705
2668,-1.350869376,0.68018326,018-CQB,-0.335343058,346,310,656
2669,-1.350869376,0.68018326,018-CQC,-0.335343058,296,326,622
2670,-1.350869376,0.68018326,018-CQD,-0.335343058,269,266,535
2671,-1.350869376,0.68018326,018-CQG,-0.335343058,83,371,454
2672,-1.350869376,0.68018326,018-CQI,-0.335343058,145,260,405
2673,-1.350869376,0.68018326,018-CQK,-0.335343058,46,501,547
2674,-1.350869376,0.68018326,018-CQM,-0.335343058,81,399,480
2675,-1.350869376,0.68018326,018-CQO,-0.335343058,78,355,433
2676,-1.350869376,0.68018326,018-CQQ,-0.335343058,94,392,486
2677,-1.350869376,0.68018326,018-CQS,-0.335343058,112,234,346
2678,-1.350869376,0.68018326,018-CQU,-0.335343058,42,261,303
2679,-1.350869376,0.68018326,018-CQW,-0.335343058,9,435,444
2680,-1.350869376,0.68018326,018-CQY,-0.335343058,17,393,410
2681,-1.350869376,0.68018326,018-CRA,-0.335343058,97,444,541
2682,-1.350869376,0.68018326,018-CRC,-0.335343058,76,422,498
2683,-1.350869376,0.68018326,018-CRE,-0.335343058,148,355,503
2684,-1.350869376,0.68018326,018-CRG,-0.335343058,15,374,389
2685,-1.350869376,0.68018326,018-CRI,-0.335343058,43,409,452
2686,-1.350869376,0.68018326,018-CRK,-0.335343058,6,530,536
2687,-1.350869376,0.68018326,018-CRM,-0.335343058,23,454,477
2688,-1.350869376,0.68018326,018-CRO,-0.335343058,84,491,575
2689,-1.350869376,0.68018326,018-CRQ,-0.335343058,100,512,612
2690,-1.350869376,0.68018326,018-CRS,-0.335343058,122,464,586
2691,-1.350869376,0.68018326,018-CRU,-0.335343058,138,413,551
2692,-1.350869376,0.68018326,018-CRW,-0.335343058,159,314,473
2693,-1.350869376,0.68018326,018-CRY,-0.335343058,146,460,606
2694,-1.350869376,0.68018326,018-CRZ,-0.335343058,95,388,483
2695,-1.350869376,0.68018326,018-CSA,-0.335343058,189,397,586
2696,-1.350869376,0.68018326,018-CSB,-0.335343058,31,276,307
2697,-1.350869376,0.68018326,018-CQH,-0.335343058,50,359,409
2698,-1.350869376,0.68018326,018-CQJ,-0.335343058,76,400,476
2699,-1.350869376,0.68018326,018-CQL,-0.335343058,78,371,449
2700,-1.350869376,0.68018326,018-CQN,-0.335343058,62,412,474
2701,-1.350869376,0.68018326,018-CQP,-0.335343058,82,378,460
2702,-1.350869376,0.68018326,018-CQR,-0.335343058,33,246,279
2703,-1.350869376,0.68018326,018-CQT,-0.335343058,37,411,448
2704,-1.350869376,0.68018326,018-CQV,-0.335343058,8,495,503
2705,-1.350869376,0.68018326,018-CQX,-0.335343058,83,442,525
2706,-1.350869376,0.68018326,018-CQZ,-0.335343058,176,395,571
2707,-1.350869376,0.68018326,018-CRB,-0.335343058,135,379,514
2708,-1.350869376,0.68018326,018-CSC,-0.335343058,149,194,343
2709,-1.350869376,0.68018326,018-CSD,-0.335343058,256,267,523
2710,-1.350869376,0.68018326,018-CSE,-0.335343058,267,423,690
2711,-1.350869376,0.68018326,018-CSF,-0.335343058,254,331,585
2712,-1.350869376,0.68018326,018-CSG,-0.335343058,289,348,637
2713,-1.350869376,0.68018326,018-CSH,-0.335343058,166,259,425
2714,-1.350869376,0.68018326,018-CSI,-0.335343058,102,350,452
2715,-1.350869376,0.68018326,018-CSJ,-0.335343058,569,573,1142
2716,-1.350869376,0.68018326,018-CSK,-0.335343058,360,377,737
2717,-1.350869376,0.68018326,018-CSL,-0.335343058,282,359,641
2718,-1.350869376,0.68018326,018-CSM,-0.335343058,258,336,594
2719,-1.350869376,0.68018326,018-CSN,-0.335343058,296,326,622
2720,-1.350869376,0.68018326,018-CSO,-0.335343058,271,357,628
2721,-1.350869376,0.68018326,018-CSQ,-0.335343058,78,130,208
2722,-1.350869376,0.68018326,018-CSR,-0.335343058,239,454,693
2723,-1.350869376,0.68018326,018-CSS,-0.335343058,265,375,640
2724,-1.350869376,0.68018326,018-CST,-0.335343058,204,328,532
2725,-1.350869376,0.68018326,018-CSV,-0.335343058,287,380,667
2726,-1.350869376,0.68018326,018-CSW,-0.335343058,129,226,355
2727,-1.350869376,0.68018326,018-CSX,-0.335343058,277,375,652
2728,-1.350869376,0.68018326,018-CSZ,-0.335343058,226,227,453
2729,-1.350869376,0.68018326,018-CTA,-0.335343058,253,252,505
2730,-1.350869376,0.68018326,018-CTB,-0.335343058,276,294,570
2731,-1.350869376,0.68018326,018-CTD,-0.335343058,145,432,577
2732,-1.350869376,0.68018326,018-CTE,-0.335343058,193,443,636
2733,-1.350869376,0.68018326,018-CTF,-0.335343058,129,488,617
2734,-1.350869376,0.68018326,018-CTG,-0.335343058,34,489,523
2735,-1.350869376,0.68018326,018-CTH,-0.335343058,55,379,434
2736,-1.350869376,0.68018326,018-CTI,-0.335343058,58,409,467
2737,-1.350869376,0.68018326,018-CTM,-0.335343058,133,383,516
2738,-1.350869376,0.68018326,018-CTN,-0.335343058,194,406,600
2739,-1.350869376,0.68018326,018-CTO,-0.335343058,144,283,427
2740,-1.350869376,0.68018326,018-CTP,-0.335343058,133,323,456
2741,-1.350869376,0.68018326,018-CTQ,-0.335343058,135,373,508
2742,-1.350869376,0.68018326,018-CTR,-0.335343058,166,350,516
2743,-1.350869376,0.68018326,018-CTS,-0.335343058,139,266,405
2744,-1.350869376,0.68018326,018-CTW,-0.335343058,84,398,482
2745,-1.350869376,0.68018326,018-CTX,-0.335343058,189,305,494
2746,-1.350869376,0.68018326,018-CTY,-0.335343058,163,336,499
2747,-1.350869376,0.68018326,018-CTZ,-0.335343058,54,279,333
2748,-1.350869376,0.68018326,018-CUA,-0.335343058,56,316,372
2749,-1.350869376,0.68018326,018-CUB,-0.335343058,201,253,454
2750,-1.350869376,0.68018326,018-CUC,-0.335343058,51,292,343
2751,-1.350869376,0.68018326,018-CUF,-0.335343058,118,272,390
2752,-1.350869376,0.68018326,018-CUG,-0.335343058,84,469,553
2753,-1.350869376,0.68018326,018-CUH,-0.335343058,147,253,400
2754,-1.350869376,0.68018326,018-CUI,-0.335343058,28,434,462
2755,-1.350869376,0.68018326,018-CUJ,-0.335343058,94,479,573
2756,-1.350869376,0.68018326,018-CUK,-0.335343058,64,339,403
2757,-1.350869376,0.68018326,018-CUP,-0.335343058,283,217,500
2758,-1.350869376,0.68018326,018-CUQ,-0.335343058,211,233,444
2759,-1.350869376,0.68018326,018-CUR,-0.335343058,305,277,582
2760,-1.350869376,0.68018326,018-CUS,-0.335343058,269,249,518
2761,-1.350869376,0.68018326,018-CUT,-0.335343058,328,283,611
2762,-1.350869376,0.68018326,018-CUU,-0.335343058,286,263,549
2763,-1.350869376,0.68018326,018-CUV,-0.335343058,143,123,266
2764,-1.350869376,0.68018326,018-CUW,-0.335343058,135,296,431
2765,-1.350869376,0.68018326,018-CUX,-0.335343058,319,326,645
2766,-1.350869376,0.68018326,018-CUY,-0.335343058,59,146,205
2767,-1.350869376,0.68018326,018-CUZ,-0.335343058,277,326,603
2768,-1.350869376,0.68018326,018-CVA,-0.335343058,237,197,434
2769,-1.350869376,0.68018326,018-CVC,-0.335343058,278,273,551
2770,-1.350869376,0.68018326,018-CVD,-0.335343058,266,236,502
2771,-1.350869376,0.68018326,018-CVE,-0.335343058,334,268,602
2772,-1.350869376,0.68018326,018-CVF,-0.335343058,291,255,546
2773,-1.350869376,0.68018326,018-CVG,-0.335343058,283,242,525
2774,-1.350869376,0.68018326,018-CVH,-0.335343058,346,214,560
2775,-1.350869376,0.68018326,018-CVI,-0.335343058,260,189,449
2776,-1.350869376,0.68018326,018-CVJ,-0.335343058,274,155,429
2777,-1.350869376,0.68018326,018-CVK,-0.335343058,254,234,488
2778,-1.350869376,0.68018326,018-CVL,-0.335343058,288,224,512
2779,-1.350869376,0.68018326,018-CVM,-0.335343058,258,220,478
2780,-1.350869376,0.68018326,018-CVN,-0.335343058,281,236,517
2781,-1.350869376,0.68018326,018-CVO,-0.335343058,256,239,495
2782,-1.350869376,0.68018326,018-CVP,-0.335343058,226,167,393
2783,-1.350869376,0.68018326,018-CVT,-0.335343058,187,179,366
2784,-1.350869376,0.68018326,018-CVU,-0.335343058,346,266,612
2785,-1.350869376,0.68018326,018-CVV,-0.335343058,302,285,587
2786,-1.350869376,0.68018326,018-CVW,-0.335343058,289,205,494
2787,-1.350869376,0.68018326,018-CVX,-0.335343058,238,234,472
2788,-1.350869376,0.68018326,018-CVY,-0.335343058,509,344,853
2789,-1.350869376,0.68018326,018-CVZ,-0.335343058,277,221,498
2790,-1.350869376,0.68018326,018-CWA,-0.335343058,218,248,466
2791,-1.350869376,0.68018326,018-CWB,-0.335343058,234,205,439
2792,-1.350869376,0.68018326,018-CWC,-0.335343058,317,267,584
2793,-1.350869376,0.68018326,018-CVQ,-0.335343058,267,246,513
2794,-1.350869376,0.68018326,018-CVR,-0.335343058,238,268,506
2795,-1.350869376,0.68018326,018-CWF,-0.335343058,199,203,402
2796,-1.350869376,0.68018326,018-CWG,-0.335343058,312,292,604
2797,-1.350869376,0.68018326,018-CWH,-0.335343058,507,346,853
2798,-1.350869376,0.68018326,018-CWI,-0.335343058,304,255,559
2799,-1.350869376,0.68018326,018-CWJ,-0.335343058,373,312,685
2800,-1.350869376,0.68018326,018-CWK,-0.335343058,348,261,609
2801,-1.350869376,0.68018326,018-CWL,-0.335343058,352,299,651
2802,-1.350869376,0.68018326,018-CWM,-0.335343058,312,313,625
2803,-1.350869376,0.68018326,018-DEH,-0.335343058,392,282,674
2804,-1.350869376,0.68018326,018-CVS,-0.335343058,283,269,552
2805,-1.350869376,0.68018326,018-CWO,-0.335343058,49,461,510
2806,-1.350869376,0.68018326,018-CWP,-0.335343058,36,435,471
2807,-1.350869376,0.68018326,018-CWQ,-0.335343058,56,299,355
2808,-1.350869376,0.68018326,018-CWR,-0.335343058,142,317,459
2809,-1.350869376,0.68018326,018-CWS,-0.335343058,78,377,455
2810,-1.350869376,0.68018326,018-CWT,-0.335343058,108,323,431
2811,-1.350869376,0.68018326,018-CWU,-0.335343058,67,295,362
2812,-1.350869376,0.68018326,018-CWV,-0.335343058,141,291,432
2813,-1.350869376,0.68018326,018-CWW,-0.335343058,121,282,403
2814,-1.350869376,0.68018326,018-CWX,-0.335343058,201,235,436
2815,-1.350869376,0.68018326,018-CWY,-0.335343058,230,222,452
2816,-1.350869376,0.68018326,018-CWZ,-0.335343058,211,261,472
2817,-1.350869376,0.68018326,018-CXA,-0.335343058,177,326,503
2818,-1.350869376,0.68018326,018-CXB,-0.335343058,84,323,407
2819,-1.350869376,0.68018326,018-CXC,-0.335343058,179,225,404
2820,-1.350869376,0.68018326,018-CXD,-0.335343058,210,370,580
2821,-1.350869376,0.68018326,018-DCK,-0.335343058,150,144,294
2822,-1.350869376,0.68018326,018-DCL,-0.335343058,174,139,313
2823,-1.350869376,0.68018326,018-DCM,-0.335343058,427,284,711
2824,-1.350869376,0.68018326,018-DCN,-0.335343058,330,252,582
2825,-1.350869376,0.68018326,018-DCO,-0.335343058,273,209,482
2826,-1.350869376,0.68018326,018-DCP,-0.335343058,225,224,449
2827,-1.350869376,0.68018326,018-DEI,-0.335343058,8,650,658
2828,-1.350869376,0.68018326,018-DEJ,-0.335343058,14,567,581
2829,-1.350869376,0.68018326,018-DEK,-0.335343058,2,548,550
2830,-1.350869376,0.68018326,018-DEL,-0.335343058,8,515,523
2831,-1.350869376,0.68018326,018-DEM,-0.335343058,5,647,652
2832,-1.350869376,0.68018326,018-DEN,-0.335343058,9,250,259
2833,-1.350869376,0.68018326,018-DEW,-0.335343058,1,122,123
2834,-1.350869376,0.68018326,018-DEO,-0.335343058,7,515,522
2835,-1.350869376,0.68018326,018-DEP,-0.335343058,3,620,623
2836,-1.350869376,0.68018326,018-DEQ,-0.335343058,11,365,376
2837,-1.350869376,0.68018326,018-DER,-0.335343058,17,485,502
2838,-1.350869376,0.68018326,018-DEX,-0.335343058,34,277,311
2839,-1.350869376,0.68018326,018-DES,-0.335343058,9,419,428
2840,-1.350869376,0.68018326,018-DET,-0.335343058,5,473,478
2841,-1.350869376,0.68018326,018-DEU,-0.335343058,10,226,236
2842,-1.350869376,0.68018326,018-DEV,-0.335343058,12,796,808
2843,-1.350869376,0.68018326,018-CYE,-0.335343058,355,225,580
2844,-1.350869376,0.68018326,018-CYF,-0.335343058,188,181,369
2845,-1.350869376,0.68018326,018-CYG,-0.335343058,349,234,583
2846,-1.350869376,0.68018326,018-CYH,-0.335343058,280,218,498
2847,-1.350869376,0.68018326,018-CYI,-0.335343058,256,280,536
2848,-1.350869376,0.68018326,018-CYJ,-0.335343058,353,268,621
2849,-1.350869376,0.68018326,018-CYL,-0.335343058,303,246,549
2850,-1.350869376,0.68018326,018-CYM,-0.335343058,252,274,526
2851,-1.350869376,0.68018326,018-CYN,-0.335343058,194,243,437
2852,-1.350869376,0.68018326,018-CYO,-0.335343058,251,265,516
2853,-1.350869376,0.68018326,018-CYP,-0.335343058,368,328,696
2854,-1.350869376,0.68018326,018-CYQ,-0.335343058,200,159,359
2855,-1.350869376,0.68018326,018-CYR,-0.335343058,346,295,641
2856,-1.350869376,0.68018326,018-CYS,-0.335343058,217,197,414
2857,-1.350869376,0.68018326,018-CYT,-0.335343058,178,230,408
2858,-1.350869376,0.68018326,018-CYU,-0.335343058,134,183,317
2859,-1.350869376,0.68018326,018-CYV,-0.335343058,99,151,250
2860,-1.350869376,0.68018326,018-CYW,-0.335343058,82,177,259
2861,-1.350869376,0.68018326,018-CYX,-0.335343058,155,232,387
2862,-1.350869376,0.68018326,018-CYY,-0.335343058,402,331,733
2863,-1.350869376,0.68018326,018-CYZ,-0.335343058,447,328,775
2864,-1.350869376,0.68018326,018-CZA,-0.335343058,260,318,578
2865,-1.350869376,0.68018326,018-CZB,-0.335343058,257,200,457
2866,-1.350869376,0.68018326,018-CZC,-0.335343058,273,300,573
2867,-1.350869376,0.68018326,018-CZE,-0.335343058,387,231,618
2868,-1.350869376,0.68018326,018-CZF,-0.335343058,295,236,531
2869,-1.350869376,0.68018326,018-CZG,-0.335343058,256,258,514
2870,-1.350869376,0.68018326,018-CZH,-0.335343058,292,239,531
2871,-1.350869376,0.68018326,018-CZI,-0.335343058,307,228,535
2872,-1.350869376,0.68018326,018-CZJ,-0.335343058,207,264,471
2873,-1.350869376,0.68018326,018-CZM,-0.335343058,346,199,545
2874,-1.350869376,0.68018326,018-CZN,-0.335343058,458,360,818
2875,-1.350869376,0.68018326,018-CZO,-0.335343058,438,302,740
2876,-1.350869376,0.68018326,018-CZP,-0.335343058,265,222,487
2877,-1.350869376,0.68018326,018-CZQ,-0.335343058,308,237,545
2878,-1.350869376,0.68018326,018-DCW,-0.335343058,40,348,388
2879,-1.350869376,0.68018326,019-AAM,-0.335343058,449,254,703
2880,-1.350869376,0.68018326,019-AAN,-0.335343058,558,251,809
2881,-1.350869376,0.68018326,019-AAO,-0.335343058,385,131,516
2882,-1.350869376,0.68018326,019-ABQ,-0.335343058,458,176,634
2883,-1.350869376,0.68018326,019-ABR,-0.335343058,336,141,477
2884,-1.350869376,0.68018326,019-AAR,-0.335343058,514,318,832
2885,-1.350869376,0.68018326,019-AAS,-0.335343058,512,163,675
2886,-1.350869376,0.68018326,019-AAT,-0.335343058,395,116,511
2887,-1.350869376,0.68018326,019-AAA,-0.335343058,267,191,458
2888,-1.350869376,0.68018326,019-AAB,-0.335343058,299,199,498
2889,-1.350869376,0.68018326,019-AAC,-0.335343058,328,170,498
2890,-1.350869376,0.68018326,019-AAD,-0.335343058,248,191,439
2891,-1.350869376,0.68018326,019-AAE,-0.335343058,268,182,450
2892,-1.350869376,0.68018326,019-AAF,-0.335343058,269,205,474
2893,-1.350869376,0.68018326,019-AAG,-0.335343058,276,156,432
2894,-1.350869376,0.68018326,019-AAH,-0.335343058,254,241,495
2895,-1.350869376,0.68018326,019-AAI,-0.335343058,469,295,764
2896,-1.350869376,0.68018326,019-AAJ,-0.335343058,216,190,406
2897,-1.350869376,0.68018326,019-AAK,-0.335343058,458,265,723
2898,-1.350869376,0.68018326,019-AAL,-0.335343058,232,134,366
2899,-1.350869376,0.68018326,019-AAU,-0.335343058,302,173,475
2900,-1.350869376,0.68018326,019-AAV,-0.335343058,481,168,649
2901,-1.350869376,0.68018326,019-AAW,-0.335343058,522,214,736
2902,-1.350869376,0.68018326,019-AAX,-0.335343058,393,130,523
2903,-1.350869376,0.68018326,019-AAZ,-0.335343058,476,244,720
2904,-1.350869376,0.68018326,019-ABA,-0.335343058,344,119,463
2905,-1.350869376,0.68018326,019-ABC,-0.335343058,351,198,549
2906,-1.350869376,0.68018326,019-ABF,-0.335343058,319,158,477
2907,-1.350869376,0.68018326,019-ABG,-0.335343058,245,108,353
2908,-1.350869376,0.68018326,019-ABH,-0.335343058,663,214,877
2909,-1.350869376,0.68018326,019-ABJ,-0.335343058,459,218,677
2910,-1.350869376,0.68018326,019-ABL,-0.335343058,615,118,733
2911,-1.350869376,0.68018326,019-ABN,-0.335343058,306,116,422
2912,-1.350869376,0.68018326,019-ABP,-0.335343058,776,258,1034
2913,-1.350869376,0.68018326,019-ABD,-0.335343058,212,233,445
2914,-1.350869376,0.68018326,019-ABS,-0.335343058,610,198,808
2915,-1.350869376,0.68018326,019-ABX,-0.335343058,487,209,696
2916,-1.350869376,0.68018326,019-ABY,-0.335343058,514,207,721
2917,-1.350869376,0.68018326,019-ABT,-0.335343058,441,88,529
2918,-1.350869376,0.68018326,019-ABU,-0.335343058,416,182,598
2919,-1.350869376,0.68018326,019-ABK,-0.335343058,236,155,391
2920,-1.350869376,0.68018326,019-ABV,-0.335343058,757,213,970
2921,-1.350869376,0.68018326,019-ACA,-0.335343058,174,74,248
2922,-1.350869376,0.68018326,020-AAT,-0.335343058,381,216,597
2923,-1.350869376,0.68018326,020-AAA,-0.335343058,273,266,539
2924,-1.350869376,0.68018326,020-AAB,-0.335343058,404,293,697
2925,-1.350869376,0.68018326,020-AAD,-0.335343058,321,235,556
2926,-1.350869376,0.68018326,020-AAE,-0.335343058,239,329,568
2927,-1.350869376,0.68018326,020-AAF,-0.335343058,254,260,514
2928,-1.350869376,0.68018326,020-AAH,-0.335343058,126,156,282
2929,-1.350869376,0.68018326,020-AAI,-0.335343058,222,265,487
2930,-1.350869376,0.68018326,020-AAJ,-0.335343058,190,210,400
2931,-1.350869376,0.68018326,020-AAK,-0.335343058,131,188,319
2932,-1.350869376,0.68018326,020-AAL,-0.335343058,307,325,632
2933,-1.350869376,0.68018326,020-AAM,-0.335343058,173,193,366
2934,-1.350869376,0.68018326,020-AAN,-0.335343058,376,170,546
2935,-1.350869376,0.68018326,020-AAP,-0.335343058,135,209,344
2936,-1.350869376,0.68018326,020-AAQ,-0.335343058,140,170,310
2937,-1.350869376,0.68018326,020-AAR,-0.335343058,221,251,472
2938,-1.350869376,0.68018326,020-AAS,-0.335343058,183,146,329
2939,-1.350869376,0.68018326,020-AAU,-0.335343058,235,148,383
2940,-1.350869376,0.68018326,020-AAV,-0.335343058,364,250,614
2941,-1.350869376,0.68018326,020-AAW,-0.335343058,185,123,308
2942,-1.350869376,0.68018326,020-AAX,-0.335343058,220,160,380
2943,-1.350869376,0.68018326,020-AAZ,-0.335343058,308,188,496
2944,-1.350869376,0.68018326,020-ABA,-0.335343058,461,236,697
2945,-1.350869376,0.68018326,020-ABB,-0.335343058,197,190,387
2946,-1.350869376,0.68018326,020-ABC,-0.335343058,73,90,163
2947,-1.350869376,0.68018326,020-ABD,-0.335343058,284,204,488
2948,-1.350869376,0.68018326,020-ABE,-0.335343058,154,148,302
2949,-1.350869376,0.68018326,020-ABG,-0.335343058,209,163,372
2950,-1.350869376,0.68018326,020-ABH,-0.335343058,392,192,584
2951,-1.350869376,0.68018326,020-ABI,-0.335343058,205,192,397
2952,-1.350869376,0.68018326,020-ABJ,-0.335343058,237,192,429
2953,-1.350869376,0.68018326,020-ABK,-0.335343058,346,146,492
2954,-1.350869376,0.68018326,020-ABS,-0.335343058,69,97,166
2955,-1.350869376,0.68018326,020-ABL,-0.335343058,331,249,580
2956,-1.350869376,0.68018326,020-ABM,-0.335343058,398,295,693
2957,-1.350869376,0.68018326,020-ABN,-0.335343058,221,186,407
2958,-1.350869376,0.68018326,020-ABO,-0.335343058,224,173,397
2959,-1.350869376,0.68018326,020-ABP,-0.335343058,168,89,257
2960,-1.350869376,0.68018326,020-AAY,-0.335343058,189,172,361
2961,-1.350869376,0.68018326,020-ABQ,-0.335343058,275,232,507
2962,-1.350869376,0.68018326,020-ABR,-0.335343058,185,137,322
2963,-1.350869376,0.68018326,020-ABT,-0.335343058,401,265,666
2964,-1.350869376,0.68018326,021-ADK,-0.335343058,145,122,267
2965,-1.350869376,0.68018326,021-ADL,-0.335343058,121,108,229
2966,-1.350869376,0.68018326,021-ABI,-0.335343058,351,187,538
2967,-1.350869376,0.68018326,021-ABJ,-0.335343058,611,287,898
2968,-1.350869376,0.68018326,021-AFC,-0.335343058,416,180,596
2969,-1.350869376,0.68018326,021-ABN,-0.335343058,503,268,771
2970,-1.350869376,0.68018326,021-ABO,-0.335343058,491,233,724
2971,-1.350869376,0.68018326,021-ABP,-0.335343058,250,182,432
2972,-1.350869376,0.68018326,021-AEN,-0.335343058,437,276,713
2973,-1.350869376,0.68018326,021-ABQ,-0.335343058,287,156,443
2974,-1.350869376,0.68018326,021-ABR,-0.335343058,263,144,407
2975,-1.350869376,0.68018326,021-AAA,-0.335343058,382,409,791
2976,-1.350869376,0.68018326,021-AEC,-0.335343058,305,294,599
2977,-1.350869376,0.68018326,021-AEH,-0.335343058,451,559,1010
2978,-1.350869376,0.68018326,021-AEV,-0.335343058,281,316,597
2979,-1.350869376,0.68018326,021-ABS,-0.335343058,440,263,703
2980,-1.350869376,0.68018326,021-ABT,-0.335343058,739,330,1069
2981,-1.350869376,0.68018326,021-ABU,-0.335343058,588,320,908
2982,-1.350869376,0.68018326,021-ABV,-0.335343058,220,112,332
2983,-1.350869376,0.68018326,021-AEO,-0.335343058,762,485,1247
2984,-1.350869376,0.68018326,021-AEW,-0.335343058,596,339,935
2985,-1.350869376,0.68018326,021-AAB,-0.335343058,611,575,1186
2986,-1.350869376,0.68018326,021-AAC,-0.335343058,404,316,720
2987,-1.350869376,0.68018326,021-AAD,-0.335343058,273,213,486
2988,-1.350869376,0.68018326,021-AAE,-0.335343058,238,244,482
2989,-1.350869376,0.68018326,021-AAF,-0.335343058,302,285,587
2990,-1.350869376,0.68018326,021-AAG,-0.335343058,187,145,332
2991,-1.350869376,0.68018326,021-AAH,-0.335343058,367,330,697
2992,-1.350869376,0.68018326,021-AAI,-0.335343058,508,409,917
2993,-1.350869376,0.68018326,021-AAJ,-0.335343058,474,371,845
2994,-1.350869376,0.68018326,021-AAK,-0.335343058,299,279,578
2995,-1.350869376,0.68018326,021-AAL,-0.335343058,214,292,506
2996,-1.350869376,0.68018326,021-AES,-0.335343058,116,504,620
2997,-1.350869376,0.68018326,021-AET,-0.335343058,80,279,359
2998,-1.350869376,0.68018326,021-AFB,-0.335343058,362,259,621
2999,-1.350869376,0.68018326,021-AAM,-0.335343058,140,187,327
3000,-1.350869376,0.68018326,021-AAN,-0.335343058,199,226,425
3001,-1.350869376,0.68018326,021-AAO,-0.335343058,188,239,427
3002,-1.350869376,0.68018326,021-AAP,-0.335343058,324,214,538
3003,-1.350869376,0.68018326,021-AAQ,-0.335343058,739,561,1300
3004,-1.350869376,0.68018326,021-AAR,-0.335343058,280,355,635
3005,-1.350869376,0.68018326,021-AAS,-0.335343058,262,401,663
3006,-1.350869376,0.68018326,021-AAT,-0.335343058,276,391,667
3007,-1.350869376,0.68018326,021-AAU,-0.335343058,188,211,399
3008,-1.350869376,0.68018326,021-AAV,-0.335343058,531,407,938
3009,-1.350869376,0.68018326,021-AAW,-0.335343058,246,234,480
3010,-1.350869376,0.68018326,021-ABX,-0.335343058,233,154,387
3011,-1.350869376,0.68018326,021-ABY,-0.335343058,501,239,740
3012,-1.350869376,0.68018326,021-AAY,-0.335343058,378,193,571
3013,-1.350869376,0.68018326,021-AAZ,-0.335343058,364,203,567
3014,-1.350869376,0.68018326,021-ABA,-0.335343058,515,254,769
3015,-1.350869376,0.68018326,021-ABB,-0.335343058,540,274,814
3016,-1.350869376,0.68018326,021-ABH,-0.335343058,162,120,282
3017,-1.350869376,0.68018326,021-ABZ,-0.335343058,400,221,621
3018,-1.350869376,0.68018326,021-ACA,-0.335343058,760,381,1141
3019,-1.350869376,0.68018326,021-ACB,-0.335343058,496,277,773
3020,-1.350869376,0.68018326,021-ACC,-0.335343058,445,353,798
3021,-1.350869376,0.68018326,021-ACD,-0.335343058,736,317,1053
3022,-1.350869376,0.68018326,021-ACE,-0.335343058,400,183,583
3023,-1.350869376,0.68018326,021-ACF,-0.335343058,433,271,704
3024,-1.350869376,0.68018326,021-ACG,-0.335343058,589,407,996
3025,-1.350869376,0.68018326,021-AEA,-0.335343058,522,308,830
3026,-1.350869376,0.68018326,021-AEE,-0.335343058,679,472,1151
3027,-1.350869376,0.68018326,021-AEF,-0.335343058,578,357,935
3028,-1.350869376,0.68018326,021-AEI,-0.335343058,768,324,1092
3029,-1.350869376,0.68018326,021-AEJ,-0.335343058,502,404,906
3030,-1.350869376,0.68018326,021-AEU,-0.335343058,543,422,965
3031,-1.350869376,0.68018326,021-AEX,-0.335343058,432,292,724
3032,-1.350869376,0.68018326,021-ACH,-0.335343058,424,178,602
3033,-1.350869376,0.68018326,021-ACI,-0.335343058,453,239,692
3034,-1.350869376,0.68018326,021-ACJ,-0.335343058,410,199,609
3035,-1.350869376,0.68018326,021-ACK,-0.335343058,176,129,305
3036,-1.350869376,0.68018326,021-ACL,-0.335343058,417,235,652
3037,-1.350869376,0.68018326,021-ACM,-0.335343058,406,183,589
3038,-1.350869376,0.68018326,021-ACN,-0.335343058,460,253,713
3039,-1.350869376,0.68018326,021-ACO,-0.335343058,453,236,689
3040,-1.350869376,0.68018326,021-ACP,-0.335343058,606,344,950
3041,-1.350869376,0.68018326,021-ACQ,-0.335343058,321,192,513
3042,-1.350869376,0.68018326,021-ACR,-0.335343058,423,152,575
3043,-1.350869376,0.68018326,021-ACS,-0.335343058,509,192,701
3044,-1.350869376,0.68018326,021-ACT,-0.335343058,441,321,762
3045,-1.350869376,0.68018326,021-ACU,-0.335343058,540,258,798
3046,-1.350869376,0.68018326,021-AEG,-0.335343058,720,450,1170
3047,-1.350869376,0.68018326,021-AEP,-0.335343058,363,199,562
3048,-1.350869376,0.68018326,021-AEQ,-0.335343058,452,267,719
3049,-1.350869376,0.68018326,021-ADA,-0.335343058,128,48,176
3050,-1.350869376,0.68018326,021-ADB,-0.335343058,740,539,1279
3051,-1.350869376,0.68018326,021-ADC,-0.335343058,604,428,1032
3052,-1.350869376,0.68018326,021-ADD,-0.335343058,353,253,606
3053,-1.350869376,0.68018326,021-ADE,-0.335343058,571,302,873
3054,-1.350869376,0.68018326,021-ADF,-0.335343058,346,253,599
3055,-1.350869376,0.68018326,021-ADG,-0.335343058,481,265,746
3056,-1.350869376,0.68018326,021-ADH,-0.335343058,327,364,691
3057,-1.350869376,0.68018326,021-ADI,-0.335343058,536,437,973
3058,-1.350869376,0.68018326,021-ADZ,-0.335343058,666,334,1000
3059,-1.350869376,0.68018326,021-AEB,-0.335343058,306,324,630
3060,-1.350869376,0.68018326,021-AEM,-0.335343058,358,247,605
3061,-1.350869376,0.68018326,021-AER,-0.335343058,450,249,699
3062,-1.350869376,0.68018326,021-AEZ,-0.335343058,463,342,805
3063,-1.350869376,0.68018326,021-AFA,-0.335343058,743,486,1229
3064,-1.350869376,0.68018326,021-ADQ,-0.335343058,162,104,266
3065,-1.350869376,0.68018326,021-ADJ,-0.335343058,321,163,484
3066,-1.350869376,0.68018326,021-ADM,-0.335343058,371,171,542
3067,-1.350869376,0.68018326,021-ADN,-0.335343058,400,211,611
3068,-1.350869376,0.68018326,021-ACV,-0.335343058,332,239,571
3069,-1.350869376,0.68018326,021-ACW,-0.335343058,401,164,565
3070,-1.350869376,0.68018326,021-ACX,-0.335343058,556,322,878
3071,-1.350869376,0.68018326,021-ACY,-0.335343058,377,212,589
3072,-1.350869376,0.68018326,021-ACZ,-0.335343058,442,393,835
3073,-1.350869376,0.68018326,021-AEY,-0.335343058,731,382,1113
3074,-1.350869376,0.68018326,021-AEK,-0.335343058,350,281,631
3075,-1.350869376,0.68018326,021-AEL,-0.335343058,697,417,1114
3076,-1.350869376,0.68018326,021-ADO,-0.335343058,357,185,542
3077,-1.350869376,0.68018326,021-ADP,-0.335343058,255,135,390
3078,-1.350869376,0.68018326,021-ADR,-0.335343058,438,278,716
3079,-1.350869376,0.68018326,021-ADS,-0.335343058,426,262,688
3080,-1.350869376,0.68018326,021-ABW,-0.335343058,218,194,412
3081,-1.350869376,0.68018326,021-ABK,-0.335343058,704,375,1079
3082,-1.350869376,0.68018326,021-ABL,-0.335343058,336,174,510
3083,-1.350869376,0.68018326,021-ABM,-0.335343058,306,196,502
3084,-1.350869376,0.68018326,021-ADT,-0.335343058,239,143,382
3085,-1.350869376,0.68018326,021-ADU,-0.335343058,405,169,574
3086,-1.350869376,0.68018326,021-ADV,-0.335343058,465,218,683
3087,-1.350869376,0.68018326,021-ADW,-0.335343058,338,197,535
3088,-1.350869376,0.68018326,021-ADX,-0.335343058,357,257,614
3089,-1.350869376,0.68018326,021-ABC,-0.335343058,578,497,1075
3090,-1.350869376,0.68018326,021-ABD,-0.335343058,537,361,898
3091,-1.350869376,0.68018326,021-ABE,-0.335343058,376,236,612
3092,-1.350869376,0.68018326,021-ABF,-0.335343058,429,372,801
3093,-1.350869376,0.68018326,021-ABG,-0.335343058,470,294,764
3094,-1.350869376,0.68018326,021-AED,-0.335343058,335,230,565
3095,-1.350869376,0.68018326,022-ACF,-0.335343058,302,319,621
3096,-1.350869376,0.68018326,022-ACD,-0.335343058,456,419,875
3097,-1.350869376,0.68018326,022-ACC,-0.335343058,175,211,386
3098,-1.350869376,0.68018326,022-ACO,-0.335343058,147,203,350
3099,-1.350869376,0.68018326,022-ACP,-0.335343058,222,241,463
3100,-1.350869376,0.68018326,022-ACG,-0.335343058,308,302,610
3101,-1.350869376,0.68018326,022-ACH,-0.335343058,392,414,806
3102,-1.350869376,0.68018326,022-ACI,-0.335343058,393,354,747
3103,-1.350869376,0.68018326,022-AAA,-0.335343058,446,388,834
3104,-1.350869376,0.68018326,022-AAB,-0.335343058,274,382,656
3105,-1.350869376,0.68018326,022-AAC,-0.335343058,338,291,629
3106,-1.350869376,0.68018326,022-AAI,-0.335343058,272,273,545
3107,-1.350869376,0.68018326,022-AAJ,-0.335343058,432,358,790
3108,-1.350869376,0.68018326,022-AAE,-0.335343058,286,405,691
3109,-1.350869376,0.68018326,022-ACK,-0.335343058,466,330,796
3110,-1.350869376,0.68018326,022-ACL,-0.335343058,349,315,664
3111,-1.350869376,0.68018326,022-ACM,-0.335343058,378,309,687
3112,-1.350869376,0.68018326,022-ACN,-0.335343058,167,121,288
3113,-1.350869376,0.68018326,022-ACQ,-0.335343058,352,351,703
3114,-1.350869376,0.68018326,022-ACR,-0.335343058,203,293,496
3115,-1.350869376,0.68018326,022-ACS,-0.335343058,295,427,722
3116,-1.350869376,0.68018326,022-ACT,-0.335343058,212,275,487
3117,-1.350869376,0.68018326,022-ACW,-0.335343058,288,242,530
3118,-1.350869376,0.68018326,022-ACX,-0.335343058,531,342,873
3119,-1.350869376,0.68018326,022-AEN,-0.335343058,301,222,523
3120,-1.350869376,0.68018326,022-ADA,-0.335343058,317,365,682
3121,-1.350869376,0.68018326,022-ADF,-0.335343058,307,513,820
3122,-1.350869376,0.68018326,022-ADO,-0.335343058,443,433,876
3123,-1.350869376,0.68018326,022-ADB,-0.335343058,494,484,978
3124,-1.350869376,0.68018326,022-ADM,-0.335343058,408,307,715
3125,-1.350869376,0.68018326,022-ADE,-0.335343058,236,355,591
3126,-1.350869376,0.68018326,022-ADN,-0.335343058,103,112,215
3127,-1.350869376,0.68018326,022-ADC,-0.335343058,344,405,749
3128,-1.350869376,0.68018326,022-ADD,-0.335343058,311,360,671
3129,-1.350869376,0.68018326,022-ADH,-0.335343058,352,449,801
3130,-1.350869376,0.68018326,022-ADJ,-0.335343058,276,345,621
3131,-1.350869376,0.68018326,022-ADX,-0.335343058,235,139,374
3132,-1.350869376,0.68018326,022-ADY,-0.335343058,227,630,857
3133,-1.350869376,0.68018326,022-ADZ,-0.335343058,126,555,681
3134,-1.350869376,0.68018326,022-AEA,-0.335343058,246,425,671
3135,-1.350869376,0.68018326,022-AEB,-0.335343058,205,624,829
3136,-1.350869376,0.68018326,022-AEC,-0.335343058,267,511,778
3137,-1.350869376,0.68018326,022-AED,-0.335343058,230,608,838
3138,-1.350869376,0.68018326,022-AEE,-0.335343058,223,549,772
3139,-1.350869376,0.68018326,022-AEF,-0.335343058,261,616,877
3140,-1.350869376,0.68018326,022-AEG,-0.335343058,173,554,727
3141,-1.350869376,0.68018326,022-AEH,-0.335343058,241,616,857
3142,-1.350869376,0.68018326,022-AEI,-0.335343058,154,448,602
3143,-1.350869376,0.68018326,022-AEJ,-0.335343058,140,460,600
3144,-1.350869376,0.68018326,022-AEK,-0.335343058,153,551,704
3145,-1.350869376,0.68018326,022-AEL,-0.335343058,218,473,691
3146,-1.350869376,0.68018326,022-AEM,-0.335343058,344,624,968
3147,-1.350869376,0.68018326,022-ABV,-0.335343058,261,244,505
3148,-1.350869376,0.68018326,022-ABX,-0.335343058,164,248,412
3149,-1.350869376,0.68018326,022-ABY,-0.335343058,259,347,606
3150,-1.350869376,0.68018326,022-ACA,-0.335343058,240,307,547
3151,-1.350869376,0.68018326,022-ACB,-0.335343058,219,287,506
3152,-1.350869376,0.68018326,022-ADT,-0.335343058,349,409,758
3153,-1.350869376,0.68018326,022-ADU,-0.335343058,237,295,532
3154,-1.350869376,0.68018326,022-ADW,-0.335343058,228,264,492
3155,-1.350869376,0.68018326,022-ADV,-0.335343058,198,223,421
3156,-1.350869376,0.68018326,022-ADS,-0.335343058,258,226,484
3157,-1.350869376,0.68018326,023-ABL,-0.335343058,291,130,421
3158,-1.350869376,0.68018326,023-ABM,-0.335343058,337,174,511
3159,-1.350869376,0.68018326,023-ABN,-0.335343058,184,116,300
3160,-1.350869376,0.68018326,023-ACR,-0.335343058,178,145,323
3161,-1.350869376,0.68018326,023-ACS,-0.335343058,202,175,377
3162,-1.350869376,0.68018326,023-ACT,-0.335343058,179,161,340
3163,-1.350869376,0.68018326,023-ACU,-0.335343058,166,118,284
3164,-1.350869376,0.68018326,023-ABO,-0.335343058,242,136,378
3165,-1.350869376,0.68018326,023-ABP,-0.335343058,361,242,603
3166,-1.350869376,0.68018326,023-ABQ,-0.335343058,338,253,591
3167,-1.350869376,0.68018326,023-ABR,-0.335343058,387,271,658
3168,-1.350869376,0.68018326,023-ABT,-0.335343058,473,235,708
3169,-1.350869376,0.68018326,023-ABU,-0.335343058,421,214,635
3170,-1.350869376,0.68018326,023-ABV,-0.335343058,544,291,835
3171,-1.350869376,0.68018326,023-ABW,-0.335343058,426,196,622
3172,-1.350869376,0.68018326,023-ABX,-0.335343058,618,262,880
3173,-1.350869376,0.68018326,023-ABY,-0.335343058,337,129,466
3174,-1.350869376,0.68018326,023-ABZ,-0.335343058,206,84,290
3175,-1.350869376,0.68018326,023-ADI,-0.335343058,381,260,641
3176,-1.350869376,0.68018326,023-ACE,-0.335343058,163,89,252
3177,-1.350869376,0.68018326,023-ACB,-0.335343058,497,295,792
3178,-1.350869376,0.68018326,023-ACC,-0.335343058,405,276,681
3179,-1.350869376,0.68018326,023-AEJ,-0.335343058,296,355,651
3180,-1.350869376,0.68018326,023-AEK,-0.335343058,332,416,748
3181,-1.350869376,0.68018326,023-AEL,-0.335343058,190,322,512
3182,-1.350869376,0.68018326,023-AEQ,-0.335343058,160,518,678
3183,-1.350869376,0.68018326,023-AEP,-0.335343058,209,211,420
3184,-1.350869376,0.68018326,023-AER,-0.335343058,278,558,836
3185,-1.350869376,0.68018326,023-ACF,-0.335343058,527,244,771
3186,-1.350869376,0.68018326,023-ACG,-0.335343058,432,195,627
3187,-1.350869376,0.68018326,023-ACH,-0.335343058,234,124,358
3188,-1.350869376,0.68018326,023-ACI,-0.335343058,242,207,449
3189,-1.350869376,0.68018326,023-ACJ,-0.335343058,361,169,530
3190,-1.350869376,0.68018326,023-ACK,-0.335343058,391,171,562
3191,-1.350869376,0.68018326,023-ACL,-0.335343058,346,234,580
3192,-1.350869376,0.68018326,023-ACM,-0.335343058,336,254,590
3193,-1.350869376,0.68018326,023-AAA,-0.335343058,363,393,756
3194,-1.350869376,0.68018326,023-AAB,-0.335343058,205,183,388
3195,-1.350869376,0.68018326,023-AAC,-0.335343058,339,314,653
3196,-1.350869376,0.68018326,023-AAD,-0.335343058,279,199,478
3197,-1.350869376,0.68018326,023-AAE,-0.335343058,233,174,407
3198,-1.350869376,0.68018326,023-AAF,-0.335343058,424,275,699
3199,-1.350869376,0.68018326,023-AAG,-0.335343058,224,228,452
3200,-1.350869376,0.68018326,023-AAH,-0.335343058,446,266,712
3201,-1.350869376,0.68018326,023-AAI,-0.335343058,220,161,381
3202,-1.350869376,0.68018326,023-AAJ,-0.335343058,284,277,561
3203,-1.350869376,0.68018326,023-AES,-0.335343058,431,229,660
3204,-1.350869376,0.68018326,023-AAL,-0.335343058,386,287,673
3205,-1.350869376,0.68018326,023-AAM,-0.335343058,280,225,505
3206,-1.350869376,0.68018326,023-AAN,-0.335343058,315,280,595
3207,-1.350869376,0.68018326,023-AAO,-0.335343058,339,280,619
3208,-1.350869376,0.68018326,023-AEY,-0.335343058,331,300,631
3209,-1.350869376,0.68018326,023-AAP,-0.335343058,227,173,400
3210,-1.350869376,0.68018326,023-AAQ,-0.335343058,345,163,508
3211,-1.350869376,0.68018326,023-AAR,-0.335343058,412,177,589
3212,-1.350869376,0.68018326,023-AAS,-0.335343058,227,225,452
3213,-1.350869376,0.68018326,023-AAT,-0.335343058,244,218,462
3214,-1.350869376,0.68018326,023-AET,-0.335343058,131,169,300
3215,-1.350869376,0.68018326,023-AEU,-0.335343058,234,149,383
3216,-1.350869376,0.68018326,023-AAU,-0.335343058,198,228,426
3217,-1.350869376,0.68018326,023-AAV,-0.335343058,260,218,478
3218,-1.350869376,0.68018326,023-AAW,-0.335343058,282,268,550
3219,-1.350869376,0.68018326,023-AAX,-0.335343058,282,292,574
3220,-1.350869376,0.68018326,023-AAY,-0.335343058,215,289,504
3221,-1.350869376,0.68018326,023-AAZ,-0.335343058,164,244,408
3222,-1.350869376,0.68018326,023-ABA,-0.335343058,287,313,600
3223,-1.350869376,0.68018326,023-ABB,-0.335343058,281,310,591
3224,-1.350869376,0.68018326,023-ACN,-0.335343058,504,213,717
3225,-1.350869376,0.68018326,023-ACO,-0.335343058,643,285,928
3226,-1.350869376,0.68018326,023-ACP,-0.335343058,343,204,547
3227,-1.350869376,0.68018326,023-ACQ,-0.335343058,482,199,681
3228,-1.350869376,0.68018326,023-ACA,-0.335343058,339,203,542
3229,-1.350869376,0.68018326,023-ACV,-0.335343058,457,256,713
3230,-1.350869376,0.68018326,023-AEA,-0.335343058,316,194,510
3231,-1.350869376,0.68018326,023-ABC,-0.335343058,329,238,567
3232,-1.350869376,0.68018326,023-ABD,-0.335343058,416,272,688
3233,-1.350869376,0.68018326,023-ABE,-0.335343058,351,221,572
3234,-1.350869376,0.68018326,023-ABF,-0.335343058,294,185,479
3235,-1.350869376,0.68018326,023-ABG,-0.335343058,298,222,520
3236,-1.350869376,0.68018326,023-ABH,-0.335343058,587,504,1091
3237,-1.350869376,0.68018326,023-ABI,-0.335343058,275,165,440
3238,-1.350869376,0.68018326,023-ABJ,-0.335343058,380,202,582
3239,-1.350869376,0.68018326,023-ABK,-0.335343058,249,244,493
3240,-1.350869376,0.68018326,023-AEM,-0.335343058,236,209,445
3241,-1.350869376,0.68018326,023-AEV,-0.335343058,557,598,1155
3242,-1.350869376,0.68018326,023-AEW,-0.335343058,454,434,888
3243,-1.350869376,0.68018326,023-AEX,-0.335343058,331,289,620
3244,-1.350869376,0.68018326,023-ACW,-0.335343058,388,221,609
3245,-1.350869376,0.68018326,023-ACX,-0.335343058,239,128,367
3246,-1.350869376,0.68018326,023-ACY,-0.335343058,392,201,593
3247,-1.350869376,0.68018326,023-ACZ,-0.335343058,390,185,575
3248,-1.350869376,0.68018326,023-ADA,-0.335343058,379,217,596
3249,-1.350869376,0.68018326,023-ADB,-0.335343058,235,159,394
3250,-1.350869376,0.68018326,023-ADC,-0.335343058,130,86,216
3251,-1.350869376,0.68018326,023-ADD,-0.335343058,181,149,330
3252,-1.350869376,0.68018326,023-ADE,-0.335343058,280,160,440
3253,-1.350869376,0.68018326,023-ADF,-0.335343058,394,233,627
3254,-1.350869376,0.68018326,023-ADG,-0.335343058,301,178,479
3255,-1.350869376,0.68018326,023-ADH,-0.335343058,451,251,702
3256,-1.350869376,0.68018326,023-ACD,-0.335343058,113,127,240
3257,-1.350869376,0.68018326,023-ABS,-0.335343058,105,104,209
3258,-1.350869376,0.68018326,023-AEC,-0.335343058,121,94,215
3259,-1.350869376,0.68018326,023-ADK,-0.335343058,376,346,722
3260,-1.350869376,0.68018326,023-ADL,-0.335343058,417,207,624
3261,-1.350869376,0.68018326,023-ADM,-0.335343058,550,318,868
3262,-1.350869376,0.68018326,023-ADN,-0.335343058,475,259,734
3263,-1.350869376,0.68018326,023-ADO,-0.335343058,408,248,656
3264,-1.350869376,0.68018326,023-ADP,-0.335343058,513,344,857
3265,-1.350869376,0.68018326,023-ADQ,-0.335343058,379,321,700
3266,-1.350869376,0.68018326,023-ADR,-0.335343058,246,163,409
3267,-1.350869376,0.68018326,023-ADS,-0.335343058,592,279,871
3268,-1.350869376,0.68018326,023-ADT,-0.335343058,386,209,595
3269,-1.350869376,0.68018326,023-ADU,-0.335343058,372,298,670
3270,-1.350869376,0.68018326,023-ADV,-0.335343058,379,263,642
3271,-1.350869376,0.68018326,023-ADW,-0.335343058,363,203,566
3272,-1.350869376,0.68018326,023-ADX,-0.335343058,406,291,697
3273,-1.350869376,0.68018326,023-ADY,-0.335343058,391,294,685
3274,-1.350869376,0.68018326,023-ADZ,-0.335343058,378,224,602
3275,-1.350869376,0.68018326,023-AEN,-0.335343058,516,237,753
3276,-1.350869376,0.68018326,023-AEO,-0.335343058,343,259,602
3277,-1.350869376,0.68018326,023-AED,-0.335343058,391,229,620
3278,-1.350869376,0.68018326,023-AEE,-0.335343058,381,294,675
3279,-1.350869376,0.68018326,023-AEF,-0.335343058,212,110,322
3280,-1.350869376,0.68018326,023-AEG,-0.335343058,377,166,543
3281,-1.350869376,0.68018326,023-AEH,-0.335343058,231,122,353
3282,-1.350869376,0.68018326,024-ABE,-0.335343058,144,134,278
3283,-1.350869376,0.68018326,024-AAS,-0.335343058,299,142,441
3284,-1.350869376,0.68018326,024-AAT,-0.335343058,118,54,172
3285,-1.350869376,0.68018326,024-AAU,-0.335343058,232,145,377
3286,-1.350869376,0.68018326,024-AAX,-0.335343058,193,86,279
3287,-1.350869376,0.68018326,024-AAY,-0.335343058,270,157,427
3288,-1.350869376,0.68018326,024-AAZ,-0.335343058,222,191,413
3289,-1.350869376,0.68018326,024-ABB,-0.335343058,349,147,496
3290,-1.350869376,0.68018326,024-ABC,-0.335343058,253,149,402
3291,-1.350869376,0.68018326,024-ABG,-0.335343058,280,155,435
3292,-1.350869376,0.68018326,024-ABH,-0.335343058,383,180,563
3293,-1.350869376,0.68018326,024-ABI,-0.335343058,245,143,388
3294,-1.350869376,0.68018326,024-ABJ,-0.335343058,261,165,426
3295,-1.350869376,0.68018326,024-ABK,-0.335343058,441,221,662
3296,-1.350869376,0.68018326,024-AAA,-0.335343058,216,210,426
3297,-1.350869376,0.68018326,024-AAB,-0.335343058,253,263,516
3298,-1.350869376,0.68018326,024-AAE,-0.335343058,165,132,297
3299,-1.350869376,0.68018326,024-AAG,-0.335343058,257,162,419
3300,-1.350869376,0.68018326,024-AAH,-0.335343058,222,176,398
3301,-1.350869376,0.68018326,024-AAK,-0.335343058,379,232,611
3302,-1.350869376,0.68018326,024-AAM,-0.335343058,449,228,677
3303,-1.350869376,0.68018326,024-AAN,-0.335343058,394,230,624
3304,-1.350869376,0.68018326,024-AAO,-0.335343058,276,189,465
3305,-1.350869376,0.68018326,024-AAP,-0.335343058,207,166,373
3306,-1.350869376,0.68018326,024-AAQ,-0.335343058,125,140,265
3307,-1.350869376,0.68018326,024-ABM,-0.335343058,469,204,673
3308,-1.350869376,0.68018326,025-AAA,-0.335343058,244,457,701
3309,-1.350869376,0.68018326,025-AAB,-0.335343058,216,271,487
3310,-1.350869376,0.68018326,025-AAC,-0.335343058,279,432,711
3311,-1.350869376,0.68018326,025-AAD,-0.335343058,329,569,898
3312,-1.350869376,0.68018326,025-AAE,-0.335343058,174,301,475
3313,-1.350869376,0.68018326,025-AAF,-0.335343058,210,304,514
3314,-1.350869376,0.68018326,025-AAG,-0.335343058,310,527,837
3315,-1.350869376,0.68018326,025-AAH,-0.335343058,210,409,619
3316,-1.350869376,0.68018326,025-AAI,-0.335343058,223,376,599
3317,-1.350869376,0.68018326,025-AAJ,-0.335343058,167,379,546
3318,-1.350869376,0.68018326,025-AAK,-0.335343058,263,394,657
3319,-1.350869376,0.68018326,025-AAL,-0.335343058,209,510,719
3320,-1.350869376,0.68018326,025-AYJ,-0.335343058,263,246,509
3321,-1.350869376,0.68018326,025-AYK,-0.335343058,205,95,300
3322,-1.350869376,0.68018326,025-AYL,-0.335343058,328,359,687
3323,-1.350869376,0.68018326,025-AYM,-0.335343058,229,267,496
3324,-1.350869376,0.68018326,025-AYN,-0.335343058,253,228,481
3325,-1.350869376,0.68018326,025-AYO,-0.335343058,350,274,624
3326,-1.350869376,0.68018326,025-AYP,-0.335343058,286,323,609
3327,-1.350869376,0.68018326,025-AYR,-0.335343058,587,335,922
3328,-1.350869376,0.68018326,025-AYS,-0.335343058,320,190,510
3329,-1.350869376,0.68018326,025-AZU,-0.335343058,533,368,901
3330,-1.350869376,0.68018326,025-AZV,-0.335343058,464,299,763
3331,-1.350869376,0.68018326,025-AZW,-0.335343058,289,177,466
3332,-1.350869376,0.68018326,025-AZX,-0.335343058,152,91,243
3333,-1.350869376,0.68018326,025-BFQ,-0.335343058,330,213,543
3334,-1.350869376,0.68018326,025-BFS,-0.335343058,395,207,602
3335,-1.350869376,0.68018326,025-AYT,-0.335343058,225,254,479
3336,-1.350869376,0.68018326,025-AYU,-0.335343058,223,487,710
3337,-1.350869376,0.68018326,025-AYV,-0.335343058,132,292,424
3338,-1.350869376,0.68018326,025-AAN,-0.335343058,236,540,776
3339,-1.350869376,0.68018326,025-AAO,-0.335343058,185,420,605
3340,-1.350869376,0.68018326,025-AAP,-0.335343058,242,598,840
3341,-1.350869376,0.68018326,025-AAQ,-0.335343058,99,480,579
3342,-1.350869376,0.68018326,025-AAR,-0.335343058,178,533,711
3343,-1.350869376,0.68018326,025-AAS,-0.335343058,203,517,720
3344,-1.350869376,0.68018326,025-AAT,-0.335343058,277,595,872
3345,-1.350869376,0.68018326,025-AAU,-0.335343058,194,542,736
3346,-1.350869376,0.68018326,025-AAV,-0.335343058,174,429,603
3347,-1.350869376,0.68018326,025-AAW,-0.335343058,18,536,554
3348,-1.350869376,0.68018326,025-AAX,-0.335343058,60,610,670
3349,-1.350869376,0.68018326,025-AAY,-0.335343058,120,763,883
3350,-1.350869376,0.68018326,025-AAZ,-0.335343058,126,586,712
3351,-1.350869376,0.68018326,025-ABA,-0.335343058,29,466,495
3352,-1.350869376,0.68018326,025-ABB,-0.335343058,32,341,373
3353,-1.350869376,0.68018326,025-ABC,-0.335343058,29,592,621
3354,-1.350869376,0.68018326,025-ABD,-0.335343058,18,511,529
3355,-1.350869376,0.68018326,025-ABE,-0.335343058,25,513,538
3356,-1.350869376,0.68018326,025-ABF,-0.335343058,8,527,535
3357,-1.350869376,0.68018326,025-ABG,-0.335343058,8,501,509
3358,-1.350869376,0.68018326,025-ABH,-0.335343058,15,510,525
3359,-1.350869376,0.68018326,025-ABI,-0.335343058,32,518,550
3360,-1.350869376,0.68018326,025-ABJ,-0.335343058,50,715,765
3361,-1.350869376,0.68018326,025-ABK,-0.335343058,19,708,727
3362,-1.350869376,0.68018326,025-ABL,-0.335343058,45,571,616
3363,-1.350869376,0.68018326,025-ABM,-0.335343058,14,515,529
3364,-1.350869376,0.68018326,025-ABN,-0.335343058,19,453,472
3365,-1.350869376,0.68018326,025-ABO,-0.335343058,17,451,468
3366,-1.350869376,0.68018326,025-ABP,-0.335343058,18,535,553
3367,-1.350869376,0.68018326,025-ABQ,-0.335343058,4,459,463
3368,-1.350869376,0.68018326,025-ABR,-0.335343058,13,534,547
3369,-1.350869376,0.68018326,025-ABS,-0.335343058,8,543,551
3370,-1.350869376,0.68018326,025-BIZ,-0.335343058,7,328,335
3371,-1.350869376,0.68018326,025-ABT,-0.335343058,176,783,959
3372,-1.350869376,0.68018326,025-ABU,-0.335343058,97,393,490
3373,-1.350869376,0.68018326,025-ABV,-0.335343058,194,454,648
3374,-1.350869376,0.68018326,025-ABW,-0.335343058,218,549,767
3375,-1.350869376,0.68018326,025-BJF,-0.335343058,139,322,461
3376,-1.350869376,0.68018326,025-ABX,-0.335343058,195,443,638
3377,-1.350869376,0.68018326,025-ABY,-0.335343058,136,321,457
3378,-1.350869376,0.68018326,025-ABZ,-0.335343058,115,263,378
3379,-1.350869376,0.68018326,025-ACA,-0.335343058,49,128,177
3380,-1.350869376,0.68018326,025-ACB,-0.335343058,69,463,532
3381,-1.350869376,0.68018326,025-ACC,-0.335343058,85,233,318
3382,-1.350869376,0.68018326,025-ACD,-0.335343058,482,528,1010
3383,-1.350869376,0.68018326,025-ACE,-0.335343058,258,516,774
3384,-1.350869376,0.68018326,025-ACN,-0.335343058,130,296,426
3385,-1.350869376,0.68018326,025-ACO,-0.335343058,220,298,518
3386,-1.350869376,0.68018326,025-ACP,-0.335343058,303,465,768
3387,-1.350869376,0.68018326,025-ACQ,-0.335343058,265,356,621
3388,-1.350869376,0.68018326,025-ACR,-0.335343058,320,362,682
3389,-1.350869376,0.68018326,025-ACS,-0.335343058,88,528,616
3390,-1.350869376,0.68018326,025-ACT,-0.335343058,51,570,621
3391,-1.350869376,0.68018326,025-ACU,-0.335343058,91,585,676
3392,-1.350869376,0.68018326,025-ACV,-0.335343058,115,557,672
3393,-1.350869376,0.68018326,025-ACW,-0.335343058,15,257,272
3394,-1.350869376,0.68018326,025-ACX,-0.335343058,17,559,576
3395,-1.350869376,0.68018326,025-ACY,-0.335343058,14,496,510
3396,-1.350869376,0.68018326,025-ACZ,-0.335343058,16,642,658
3397,-1.350869376,0.68018326,025-ADA,-0.335343058,153,372,525
3398,-1.350869376,0.68018326,025-ADB,-0.335343058,156,693,849
3399,-1.350869376,0.68018326,025-ADC,-0.335343058,94,577,671
3400,-1.350869376,0.68018326,025-ADD,-0.335343058,87,411,498
3401,-1.350869376,0.68018326,025-BEQ,-0.335343058,101,486,587
3402,-1.350869376,0.68018326,025-BER,-0.335343058,152,604,756
3403,-1.350869376,0.68018326,025-BJG,-0.335343058,158,296,454
3404,-1.350869376,0.68018326,025-ADE,-0.335343058,199,656,855
3405,-1.350869376,0.68018326,025-ADF,-0.335343058,287,417,704
3406,-1.350869376,0.68018326,025-ADG,-0.335343058,115,580,695
3407,-1.350869376,0.68018326,025-ADH,-0.335343058,145,440,585
3408,-1.350869376,0.68018326,025-ADI,-0.335343058,208,745,953
3409,-1.350869376,0.68018326,025-ADJ,-0.335343058,147,482,629
3410,-1.350869376,0.68018326,025-ADK,-0.335343058,156,421,577
3411,-1.350869376,0.68018326,025-ADL,-0.335343058,42,368,410
3412,-1.350869376,0.68018326,025-ADM,-0.335343058,16,356,372
3413,-1.350869376,0.68018326,025-ADN,-0.335343058,5,492,497
3414,-1.350869376,0.68018326,025-ADO,-0.335343058,6,478,484
3415,-1.350869376,0.68018326,025-ADP,-0.335343058,4,518,522
3416,-1.350869376,0.68018326,025-BEU,-0.335343058,6,541,547
3417,-1.350869376,0.68018326,025-ADQ,-0.335343058,122,644,766
3418,-1.350869376,0.68018326,025-ADR,-0.335343058,151,590,741
3419,-1.350869376,0.68018326,025-ADS,-0.335343058,145,734,879
3420,-1.350869376,0.68018326,025-ADT,-0.335343058,105,414,519
3421,-1.350869376,0.68018326,025-ADU,-0.335343058,119,561,680
3422,-1.350869376,0.68018326,025-ADV,-0.335343058,113,525,638
3423,-1.350869376,0.68018326,025-ADW,-0.335343058,229,448,677
3424,-1.350869376,0.68018326,025-ADX,-0.335343058,259,529,788
3425,-1.350869376,0.68018326,025-ADY,-0.335343058,244,531,775
3426,-1.350869376,0.68018326,025-ADZ,-0.335343058,319,587,906
3427,-1.350869376,0.68018326,025-AEA,-0.335343058,209,459,668
3428,-1.350869376,0.68018326,025-AEB,-0.335343058,202,593,795
3429,-1.350869376,0.68018326,025-AEC,-0.335343058,257,485,742
3430,-1.350869376,0.68018326,025-AED,-0.335343058,174,670,844
3431,-1.350869376,0.68018326,025-AEE,-0.335343058,154,287,441
3432,-1.350869376,0.68018326,025-AEF,-0.335343058,74,481,555
3433,-1.350869376,0.68018326,025-AEG,-0.335343058,157,637,794
3434,-1.350869376,0.68018326,025-BES,-0.335343058,235,508,743
3435,-1.350869376,0.68018326,025-BJH,-0.335343058,77,350,427
3436,-1.350869376,0.68018326,025-AEH,-0.335343058,316,447,763
3437,-1.350869376,0.68018326,025-AEI,-0.335343058,360,645,1005
3438,-1.350869376,0.68018326,025-AEJ,-0.335343058,292,537,829
3439,-1.350869376,0.68018326,025-AEK,-0.335343058,123,485,608
3440,-1.350869376,0.68018326,025-AEL,-0.335343058,313,564,877
3441,-1.350869376,0.68018326,025-AEM,-0.335343058,261,487,748
3442,-1.350869376,0.68018326,025-AEN,-0.335343058,322,512,834
3443,-1.350869376,0.68018326,025-AEO,-0.335343058,230,416,646
3444,-1.350869376,0.68018326,025-AEP,-0.335343058,297,550,847
3445,-1.350869376,0.68018326,025-AEQ,-0.335343058,260,353,613
3446,-1.350869376,0.68018326,025-AER,-0.335343058,269,320,589
3447,-1.350869376,0.68018326,025-AES,-0.335343058,285,412,697
3448,-1.350869376,0.68018326,025-AET,-0.335343058,245,454,699
3449,-1.350869376,0.68018326,025-AEU,-0.335343058,189,188,377
3450,-1.350869376,0.68018326,025-AEV,-0.335343058,112,564,676
3451,-1.350869376,0.68018326,025-AEW,-0.335343058,127,646,773
3452,-1.350869376,0.68018326,025-AEX,-0.335343058,229,558,787
3453,-1.350869376,0.68018326,025-AEY,-0.335343058,222,626,848
3454,-1.350869376,0.68018326,025-AEZ,-0.335343058,120,409,529
3455,-1.350869376,0.68018326,025-AFA,-0.335343058,166,472,638
3456,-1.350869376,0.68018326,025-AFB,-0.335343058,167,391,558
3457,-1.350869376,0.68018326,025-AFC,-0.335343058,53,517,570
3458,-1.350869376,0.68018326,025-AFD,-0.335343058,190,345,535
3459,-1.350869376,0.68018326,025-AFE,-0.335343058,49,744,793
3460,-1.350869376,0.68018326,025-AFF,-0.335343058,50,736,786
3461,-1.350869376,0.68018326,025-AFG,-0.335343058,21,796,817
3462,-1.350869376,0.68018326,025-AFH,-0.335343058,10,687,697
3463,-1.350869376,0.68018326,025-AFI,-0.335343058,13,702,715
3464,-1.350869376,0.68018326,025-AFJ,-0.335343058,33,601,634
3465,-1.350869376,0.68018326,025-AFK,-0.335343058,12,421,433
3466,-1.350869376,0.68018326,025-BET,-0.335343058,46,632,678
3467,-1.350869376,0.68018326,025-AFL,-0.335343058,33,539,572
3468,-1.350869376,0.68018326,025-AFM,-0.335343058,2,62,64
3469,-1.350869376,0.68018326,025-AFN,-0.335343058,29,393,422
3470,-1.350869376,0.68018326,025-AFO,-0.335343058,86,508,594
3471,-1.350869376,0.68018326,025-AFP,-0.335343058,36,391,427
3472,-1.350869376,0.68018326,025-AFQ,-0.335343058,65,489,554
3473,-1.350869376,0.68018326,025-AFR,-0.335343058,55,478,533
3474,-1.350869376,0.68018326,025-AFS,-0.335343058,273,427,700
3475,-1.350869376,0.68018326,025-AFT,-0.335343058,143,436,579
3476,-1.350869376,0.68018326,025-AFU,-0.335343058,120,573,693
3477,-1.350869376,0.68018326,025-AFV,-0.335343058,386,426,812
3478,-1.350869376,0.68018326,025-AFW,-0.335343058,38,698,736
3479,-1.350869376,0.68018326,025-AFX,-0.335343058,30,549,579
3480,-1.350869376,0.68018326,025-AFY,-0.335343058,65,573,638
3481,-1.350869376,0.68018326,025-AFZ,-0.335343058,190,520,710
3482,-1.350869376,0.68018326,025-AGA,-0.335343058,50,678,728
3483,-1.350869376,0.68018326,025-AGB,-0.335343058,135,480,615
3484,-1.350869376,0.68018326,025-BCP,-0.335343058,81,351,432
3485,-1.350869376,0.68018326,025-AGC,-0.335343058,130,329,459
3486,-1.350869376,0.68018326,025-AGD,-0.335343058,68,227,295
3487,-1.350869376,0.68018326,025-AGE,-0.335343058,285,253,538
3488,-1.350869376,0.68018326,025-AGF,-0.335343058,317,290,607
3489,-1.350869376,0.68018326,025-AGG,-0.335343058,238,321,559
3490,-1.350869376,0.68018326,025-AGH,-0.335343058,160,331,491
3491,-1.350869376,0.68018326,025-AGI,-0.335343058,200,258,458
3492,-1.350869376,0.68018326,025-AGJ,-0.335343058,201,362,563
3493,-1.350869376,0.68018326,025-AGK,-0.335343058,182,335,517
3494,-1.350869376,0.68018326,025-AGL,-0.335343058,175,253,428
3495,-1.350869376,0.68018326,025-AGM,-0.335343058,77,610,687
3496,-1.350869376,0.68018326,025-AGN,-0.335343058,169,380,549
3497,-1.350869376,0.68018326,025-AGO,-0.335343058,141,300,441
3498,-1.350869376,0.68018326,025-AGP,-0.335343058,69,207,276
3499,-1.350869376,0.68018326,025-AGQ,-0.335343058,129,266,395
3500,-1.350869376,0.68018326,025-AGR,-0.335343058,358,520,878
3501,-1.350869376,0.68018326,025-AGS,-0.335343058,212,347,559
3502,-1.350869376,0.68018326,025-AGT,-0.335343058,191,452,643
3503,-1.350869376,0.68018326,025-AGU,-0.335343058,246,381,627
3504,-1.350869376,0.68018326,025-AGV,-0.335343058,170,454,624
3505,-1.350869376,0.68018326,025-AGW,-0.335343058,143,469,612
3506,-1.350869376,0.68018326,025-AGX,-0.335343058,191,528,719
3507,-1.350869376,0.68018326,025-AGY,-0.335343058,190,581,771
3508,-1.350869376,0.68018326,025-AGZ,-0.335343058,153,545,698
3509,-1.350869376,0.68018326,025-AHA,-0.335343058,198,498,696
3510,-1.350869376,0.68018326,025-AHB,-0.335343058,191,542,733
3511,-1.350869376,0.68018326,025-AHC,-0.335343058,86,367,453
3512,-1.350869376,0.68018326,025-AHD,-0.335343058,165,571,736
3513,-1.350869376,0.68018326,025-AHE,-0.335343058,142,502,644
3514,-1.350869376,0.68018326,025-AHF,-0.335343058,79,291,370
3515,-1.350869376,0.68018326,025-AHG,-0.335343058,213,452,665
3516,-1.350869376,0.68018326,025-AHH,-0.335343058,131,309,440
3517,-1.350869376,0.68018326,025-AHI,-0.335343058,254,658,912
3518,-1.350869376,0.68018326,025-AHJ,-0.335343058,41,583,624
3519,-1.350869376,0.68018326,025-AHK,-0.335343058,13,802,815
3520,-1.350869376,0.68018326,025-AHL,-0.335343058,8,713,721
3521,-1.350869376,0.68018326,025-AHM,-0.335343058,37,579,616
3522,-1.350869376,0.68018326,025-AHN,-0.335343058,371,342,713
3523,-1.350869376,0.68018326,025-AHO,-0.335343058,325,511,836
3524,-1.350869376,0.68018326,025-AHP,-0.335343058,225,432,657
3525,-1.350869376,0.68018326,025-AHQ,-0.335343058,278,263,541
3526,-1.350869376,0.68018326,025-AHR,-0.335343058,274,426,700
3527,-1.350869376,0.68018326,025-AHS,-0.335343058,130,389,519
3528,-1.350869376,0.68018326,025-AHT,-0.335343058,83,246,329
3529,-1.350869376,0.68018326,025-AHU,-0.335343058,210,296,506
3530,-1.350869376,0.68018326,025-AHV,-0.335343058,268,315,583
3531,-1.350869376,0.68018326,025-BCG,-0.335343058,379,339,718
3532,-1.350869376,0.68018326,025-AHW,-0.335343058,261,429,690
3533,-1.350869376,0.68018326,025-AHX,-0.335343058,59,339,398
3534,-1.350869376,0.68018326,025-AHY,-0.335343058,195,358,553
3535,-1.350869376,0.68018326,025-AHZ,-0.335343058,301,854,1155
3536,-1.350869376,0.68018326,025-AIA,-0.335343058,112,444,556
3537,-1.350869376,0.68018326,025-AIB,-0.335343058,127,494,621
3538,-1.350869376,0.68018326,025-AIC,-0.335343058,187,648,835
3539,-1.350869376,0.68018326,025-AID,-0.335343058,156,766,922
3540,-1.350869376,0.68018326,025-AIE,-0.335343058,131,294,425
3541,-1.350869376,0.68018326,025-AIF,-0.335343058,326,810,1136
3542,-1.350869376,0.68018326,025-AIG,-0.335343058,251,467,718
3543,-1.350869376,0.68018326,025-AIH,-0.335343058,200,514,714
3544,-1.350869376,0.68018326,025-AII,-0.335343058,327,621,948
3545,-1.350869376,0.68018326,025-AIJ,-0.335343058,82,538,620
3546,-1.350869376,0.68018326,025-AIK,-0.335343058,24,221,245
3547,-1.350869376,0.68018326,025-AIL,-0.335343058,170,336,506
3548,-1.350869376,0.68018326,025-AIM,-0.335343058,72,460,532
3549,-1.350869376,0.68018326,025-AIN,-0.335343058,184,381,565
3550,-1.350869376,0.68018326,025-AIO,-0.335343058,254,364,618
3551,-1.350869376,0.68018326,025-AIP,-0.335343058,223,316,539
3552,-1.350869376,0.68018326,025-AIQ,-0.335343058,191,413,604
3553,-1.350869376,0.68018326,025-AIR,-0.335343058,232,397,629
3554,-1.350869376,0.68018326,025-AIS,-0.335343058,167,391,558
3555,-1.350869376,0.68018326,025-AIT,-0.335343058,64,671,735
3556,-1.350869376,0.68018326,025-AIU,-0.335343058,60,583,643
3557,-1.350869376,0.68018326,025-AIV,-0.335343058,39,571,610
3558,-1.350869376,0.68018326,025-AIW,-0.335343058,61,568,629
3559,-1.350869376,0.68018326,025-AIX,-0.335343058,15,318,333
3560,-1.350869376,0.68018326,025-AIY,-0.335343058,133,419,552
3561,-1.350869376,0.68018326,025-AIZ,-0.335343058,68,438,506
3562,-1.350869376,0.68018326,025-AJA,-0.335343058,18,618,636
3563,-1.350869376,0.68018326,025-AJE,-0.335343058,148,469,617
3564,-1.350869376,0.68018326,025-AJF,-0.335343058,104,387,491
3565,-1.350869376,0.68018326,025-AJG,-0.335343058,164,901,1065
3566,-1.350869376,0.68018326,025-AJH,-0.335343058,169,398,567
3567,-1.350869376,0.68018326,025-AJI,-0.335343058,146,417,563
3568,-1.350869376,0.68018326,025-AJJ,-0.335343058,163,406,569
3569,-1.350869376,0.68018326,025-AJK,-0.335343058,170,262,432
3570,-1.350869376,0.68018326,025-AJL,-0.335343058,64,1022,1086
3571,-1.350869376,0.68018326,025-AJM,-0.335343058,233,503,736
3572,-1.350869376,0.68018326,025-AJN,-0.335343058,229,528,757
3573,-1.350869376,0.68018326,025-AJO,-0.335343058,204,413,617
3574,-1.350869376,0.68018326,025-BCS,-0.335343058,79,279,358
3575,-1.350869376,0.68018326,025-BDI,-0.335343058,124,406,530
3576,-1.350869376,0.68018326,025-AJP,-0.335343058,167,628,795
3577,-1.350869376,0.68018326,025-AJQ,-0.335343058,261,663,924
3578,-1.350869376,0.68018326,025-AJR,-0.335343058,234,456,690
3579,-1.350869376,0.68018326,025-AJS,-0.335343058,361,620,981
3580,-1.350869376,0.68018326,025-AJT,-0.335343058,535,749,1284
3581,-1.350869376,0.68018326,025-AJU,-0.335343058,460,510,970
3582,-1.350869376,0.68018326,025-AJV,-0.335343058,366,562,928
3583,-1.350869376,0.68018326,025-BJI,-0.335343058,105,381,486
3584,-1.350869376,0.68018326,025-AJY,-0.335343058,144,553,697
3585,-1.350869376,0.68018326,025-AJZ,-0.335343058,62,561,623
3586,-1.350869376,0.68018326,025-AKA,-0.335343058,160,478,638
3587,-1.350869376,0.68018326,025-AKB,-0.335343058,138,535,673
3588,-1.350869376,0.68018326,025-AKC,-0.335343058,120,488,608
3589,-1.350869376,0.68018326,025-AKD,-0.335343058,81,390,471
3590,-1.350869376,0.68018326,025-AKE,-0.335343058,31,410,441
3591,-1.350869376,0.68018326,025-AKF,-0.335343058,45,357,402
3592,-1.350869376,0.68018326,025-AKG,-0.335343058,70,657,727
3593,-1.350869376,0.68018326,025-AKH,-0.335343058,76,674,750
3594,-1.350869376,0.68018326,025-AKI,-0.335343058,71,226,297
3595,-1.350869376,0.68018326,025-AKJ,-0.335343058,58,679,737
3596,-1.350869376,0.68018326,025-AKK,-0.335343058,263,351,614
3597,-1.350869376,0.68018326,025-AKL,-0.335343058,339,338,677
3598,-1.350869376,0.68018326,025-AKM,-0.335343058,96,423,519
3599,-1.350869376,0.68018326,025-AKN,-0.335343058,418,308,726
3600,-1.350869376,0.68018326,025-AKO,-0.335343058,156,303,459
3601,-1.350869376,0.68018326,025-BCV,-0.335343058,428,557,985
3602,-1.350869376,0.68018326,025-BJJ,-0.335343058,177,191,368
3603,-1.350869376,0.68018326,025-AKP,-0.335343058,16,565,581
3604,-1.350869376,0.68018326,025-AKQ,-0.335343058,35,732,767
3605,-1.350869376,0.68018326,025-AKR,-0.335343058,141,537,678
3606,-1.350869376,0.68018326,025-BBX,-0.335343058,215,370,585
3607,-1.350869376,0.68018326,025-BFF,-0.335343058,138,336,474
3608,-1.350869376,0.68018326,025-AKS,-0.335343058,60,711,771
3609,-1.350869376,0.68018326,025-AKT,-0.335343058,78,465,543
3610,-1.350869376,0.68018326,025-AKU,-0.335343058,56,751,807
3611,-1.350869376,0.68018326,025-AKV,-0.335343058,40,677,717
3612,-1.350869376,0.68018326,025-AKW,-0.335343058,296,490,786
3613,-1.350869376,0.68018326,025-AKX,-0.335343058,214,539,753
3614,-1.350869376,0.68018326,025-AKY,-0.335343058,268,346,614
3615,-1.350869376,0.68018326,025-AKZ,-0.335343058,76,515,591
3616,-1.350869376,0.68018326,025-ALA,-0.335343058,50,568,618
3617,-1.350869376,0.68018326,025-ALB,-0.335343058,154,453,607
3618,-1.350869376,0.68018326,025-ALC,-0.335343058,57,399,456
3619,-1.350869376,0.68018326,025-BCW,-0.335343058,73,271,344
3620,-1.350869376,0.68018326,025-ALD,-0.335343058,244,294,538
3621,-1.350869376,0.68018326,025-ALE,-0.335343058,306,272,578
3622,-1.350869376,0.68018326,025-ALF,-0.335343058,299,312,611
3623,-1.350869376,0.68018326,025-ALG,-0.335343058,259,493,752
3624,-1.350869376,0.68018326,025-ALH,-0.335343058,247,324,571
3625,-1.350869376,0.68018326,025-ALI,-0.335343058,91,398,489
3626,-1.350869376,0.68018326,025-ALJ,-0.335343058,146,498,644
3627,-1.350869376,0.68018326,025-ALK,-0.335343058,84,294,378
3628,-1.350869376,0.68018326,025-ALL,-0.335343058,248,462,710
3629,-1.350869376,0.68018326,025-ALM,-0.335343058,168,583,751
3630,-1.350869376,0.68018326,025-ALN,-0.335343058,195,399,594
3631,-1.350869376,0.68018326,025-ALO,-0.335343058,221,483,704
3632,-1.350869376,0.68018326,025-ALP,-0.335343058,222,388,610
3633,-1.350869376,0.68018326,025-ALQ,-0.335343058,196,391,587
3634,-1.350869376,0.68018326,025-ALR,-0.335343058,159,483,642
3635,-1.350869376,0.68018326,025-ALS,-0.335343058,70,431,501
3636,-1.350869376,0.68018326,025-ALT,-0.335343058,46,580,626
3637,-1.350869376,0.68018326,025-ALU,-0.335343058,47,637,684
3638,-1.350869376,0.68018326,025-ALV,-0.335343058,57,517,574
3639,-1.350869376,0.68018326,025-ALW,-0.335343058,70,618,688
3640,-1.350869376,0.68018326,025-ALX,-0.335343058,37,470,507
3641,-1.350869376,0.68018326,025-ALY,-0.335343058,53,609,662
3642,-1.350869376,0.68018326,025-ALZ,-0.335343058,30,1074,1104
3643,-1.350869376,0.68018326,025-AMF,-0.335343058,224,387,611
3644,-1.350869376,0.68018326,025-AMG,-0.335343058,226,355,581
3645,-1.350869376,0.68018326,025-AMH,-0.335343058,203,341,544
3646,-1.350869376,0.68018326,025-AMI,-0.335343058,480,526,1006
3647,-1.350869376,0.68018326,025-AMJ,-0.335343058,196,358,554
3648,-1.350869376,0.68018326,025-AMK,-0.335343058,306,352,658
3649,-1.350869376,0.68018326,025-BJK,-0.335343058,154,176,330
3650,-1.350869376,0.68018326,025-AMN,-0.335343058,179,314,493
3651,-1.350869376,0.68018326,025-AMO,-0.335343058,406,496,902
3652,-1.350869376,0.68018326,025-AMP,-0.335343058,340,316,656
3653,-1.350869376,0.68018326,025-AMQ,-0.335343058,210,327,537
3654,-1.350869376,0.68018326,025-AMR,-0.335343058,321,366,687
3655,-1.350869376,0.68018326,025-AMS,-0.335343058,314,368,682
3656,-1.350869376,0.68018326,025-AMT,-0.335343058,257,377,634
3657,-1.350869376,0.68018326,025-AMU,-0.335343058,390,346,736
3658,-1.350869376,0.68018326,025-BEG,-0.335343058,304,258,562
3659,-1.350869376,0.68018326,025-BJL,-0.335343058,200,336,536
3660,-1.350869376,0.68018326,025-BJM,-0.335343058,273,381,654
3661,-1.350869376,0.68018326,025-AMV,-0.335343058,271,350,621
3662,-1.350869376,0.68018326,025-AMW,-0.335343058,336,408,744
3663,-1.350869376,0.68018326,025-AMX,-0.335343058,302,370,672
3664,-1.350869376,0.68018326,025-AMY,-0.335343058,235,487,722
3665,-1.350869376,0.68018326,025-AMZ,-0.335343058,182,263,445
3666,-1.350869376,0.68018326,025-ANA,-0.335343058,250,402,652
3667,-1.350869376,0.68018326,025-ANB,-0.335343058,276,445,721
3668,-1.350869376,0.68018326,025-ANC,-0.335343058,378,480,858
3669,-1.350869376,0.68018326,025-AND,-0.335343058,516,464,980
3670,-1.350869376,0.68018326,025-ANE,-0.335343058,371,406,777
3671,-1.350869376,0.68018326,025-ANF,-0.335343058,440,535,975
3672,-1.350869376,0.68018326,025-ANG,-0.335343058,455,309,764
3673,-1.350869376,0.68018326,025-ANH,-0.335343058,206,146,352
3674,-1.350869376,0.68018326,025-ANI,-0.335343058,151,302,453
3675,-1.350869376,0.68018326,025-ANJ,-0.335343058,114,563,677
3676,-1.350869376,0.68018326,025-ANK,-0.335343058,148,536,684
3677,-1.350869376,0.68018326,025-ANL,-0.335343058,309,415,724
3678,-1.350869376,0.68018326,025-ANM,-0.335343058,301,375,676
3679,-1.350869376,0.68018326,025-ANN,-0.335343058,275,588,863
3680,-1.350869376,0.68018326,025-ANO,-0.335343058,250,445,695
3681,-1.350869376,0.68018326,025-ANP,-0.335343058,315,424,739
3682,-1.350869376,0.68018326,025-ANQ,-0.335343058,245,385,630
3683,-1.350869376,0.68018326,025-ANV,-0.335343058,485,470,955
3684,-1.350869376,0.68018326,025-ANW,-0.335343058,350,424,774
3685,-1.350869376,0.68018326,025-ANX,-0.335343058,375,373,748
3686,-1.350869376,0.68018326,025-ANY,-0.335343058,242,312,554
3687,-1.350869376,0.68018326,025-ANZ,-0.335343058,149,210,359
3688,-1.350869376,0.68018326,025-AOA,-0.335343058,259,414,673
3689,-1.350869376,0.68018326,025-AOB,-0.335343058,291,262,553
3690,-1.350869376,0.68018326,025-AOC,-0.335343058,175,353,528
3691,-1.350869376,0.68018326,025-AOD,-0.335343058,145,177,322
3692,-1.350869376,0.68018326,025-AOE,-0.335343058,328,328,656
3693,-1.350869376,0.68018326,025-AOF,-0.335343058,383,347,730
3694,-1.350869376,0.68018326,025-AOG,-0.335343058,326,467,793
3695,-1.350869376,0.68018326,025-AOH,-0.335343058,194,349,543
3696,-1.350869376,0.68018326,025-AOI,-0.335343058,234,260,494
3697,-1.350869376,0.68018326,025-AOJ,-0.335343058,323,401,724
3698,-1.350869376,0.68018326,025-AOK,-0.335343058,416,452,868
3699,-1.350869376,0.68018326,025-BBY,-0.335343058,166,385,551
3700,-1.350869376,0.68018326,025-BCY,-0.335343058,216,370,586
3701,-1.350869376,0.68018326,025-AOL,-0.335343058,265,300,565
3702,-1.350869376,0.68018326,025-AOM,-0.335343058,312,249,561
3703,-1.350869376,0.68018326,025-AON,-0.335343058,346,397,743
3704,-1.350869376,0.68018326,025-AOO,-0.335343058,220,223,443
3705,-1.350869376,0.68018326,025-AOP,-0.335343058,364,421,785
3706,-1.350869376,0.68018326,025-AOQ,-0.335343058,276,372,648
3707,-1.350869376,0.68018326,025-AOR,-0.335343058,440,401,841
3708,-1.350869376,0.68018326,025-BDF,-0.335343058,145,304,449
3709,-1.350869376,0.68018326,025-AOS,-0.335343058,177,480,657
3710,-1.350869376,0.68018326,025-AOT,-0.335343058,107,468,575
3711,-1.350869376,0.68018326,025-AOU,-0.335343058,151,261,412
3712,-1.350869376,0.68018326,025-AOV,-0.335343058,265,432,697
3713,-1.350869376,0.68018326,025-AOW,-0.335343058,269,396,665
3714,-1.350869376,0.68018326,025-BDL,-0.335343058,359,458,817
3715,-1.350869376,0.68018326,025-BFY,-0.335343058,233,287,520
3716,-1.350869376,0.68018326,025-AOX,-0.335343058,339,364,703
3717,-1.350869376,0.68018326,025-AOY,-0.335343058,298,341,639
3718,-1.350869376,0.68018326,025-AOZ,-0.335343058,238,367,605
3719,-1.350869376,0.68018326,025-APA,-0.335343058,119,205,324
3720,-1.350869376,0.68018326,025-APB,-0.335343058,222,315,537
3721,-1.350869376,0.68018326,025-APC,-0.335343058,102,109,211
3722,-1.350869376,0.68018326,025-APD,-0.335343058,323,397,720
3723,-1.350869376,0.68018326,025-APE,-0.335343058,178,232,410
3724,-1.350869376,0.68018326,025-APF,-0.335343058,275,374,649
3725,-1.350869376,0.68018326,025-APH,-0.335343058,84,481,565
3726,-1.350869376,0.68018326,025-API,-0.335343058,50,494,544
3727,-1.350869376,0.68018326,025-APJ,-0.335343058,90,478,568
3728,-1.350869376,0.68018326,025-APK,-0.335343058,107,361,468
3729,-1.350869376,0.68018326,025-APL,-0.335343058,306,377,683
3730,-1.350869376,0.68018326,025-APM,-0.335343058,238,289,527
3731,-1.350869376,0.68018326,025-APN,-0.335343058,340,447,787
3732,-1.350869376,0.68018326,025-APO,-0.335343058,465,364,829
3733,-1.350869376,0.68018326,025-APP,-0.335343058,339,337,676
3734,-1.350869376,0.68018326,025-APQ,-0.335343058,326,311,637
3735,-1.350869376,0.68018326,025-928,-0.335343058,268,326,594
3736,-1.350869376,0.68018326,025-BJN,-0.335343058,124,176,300
3737,-1.350869376,0.68018326,025-BJO,-0.335343058,482,585,1067
3738,-1.350869376,0.68018326,025-BJX,-0.335343058,344,281,625
3739,-1.350869376,0.68018326,025-APU,-0.335343058,307,295,602
3740,-1.350869376,0.68018326,025-APV,-0.335343058,359,337,696
3741,-1.350869376,0.68018326,025-APW,-0.335343058,305,398,703
3742,-1.350869376,0.68018326,025-APX,-0.335343058,383,423,806
3743,-1.350869376,0.68018326,025-APY,-0.335343058,198,402,600
3744,-1.350869376,0.68018326,025-APZ,-0.335343058,326,370,696
3745,-1.350869376,0.68018326,025-AQA,-0.335343058,257,308,565
3746,-1.350869376,0.68018326,025-AQB,-0.335343058,213,300,513
3747,-1.350869376,0.68018326,025-AQC,-0.335343058,238,284,522
3748,-1.350869376,0.68018326,025-AQD,-0.335343058,375,419,794
3749,-1.350869376,0.68018326,025-AQE,-0.335343058,72,132,204
3750,-1.350869376,0.68018326,025-AQF,-0.335343058,264,456,720
3751,-1.350869376,0.68018326,025-AQL,-0.335343058,395,337,732
3752,-1.350869376,0.68018326,025-AQM,-0.335343058,345,282,627
3753,-1.350869376,0.68018326,025-AQN,-0.335343058,403,352,755
3754,-1.350869376,0.68018326,025-AQO,-0.335343058,325,326,651
3755,-1.350869376,0.68018326,025-AQP,-0.335343058,545,529,1074
3756,-1.350869376,0.68018326,025-AQQ,-0.335343058,491,424,915
3757,-1.350869376,0.68018326,025-AQR,-0.335343058,240,250,490
3758,-1.350869376,0.68018326,025-AQS,-0.335343058,213,281,494
3759,-1.350869376,0.68018326,025-AQT,-0.335343058,362,384,746
3760,-1.350869376,0.68018326,025-AQU,-0.335343058,398,497,895
3761,-1.350869376,0.68018326,025-AQV,-0.335343058,248,365,613
3762,-1.350869376,0.68018326,025-AQW,-0.335343058,332,462,794
3763,-1.350869376,0.68018326,025-AQX,-0.335343058,665,636,1301
3764,-1.350869376,0.68018326,025-BCA,-0.335343058,637,880,1517
3765,-1.350869376,0.68018326,025-AQY,-0.335343058,348,361,709
3766,-1.350869376,0.68018326,025-AQZ,-0.335343058,308,302,610
3767,-1.350869376,0.68018326,025-ARA,-0.335343058,378,396,774
3768,-1.350869376,0.68018326,025-ARB,-0.335343058,229,297,526
3769,-1.350869376,0.68018326,025-ARC,-0.335343058,187,320,507
3770,-1.350869376,0.68018326,025-ARD,-0.335343058,230,386,616
3771,-1.350869376,0.68018326,025-ARE,-0.335343058,279,358,637
3772,-1.350869376,0.68018326,025-ARF,-0.335343058,356,445,801
3773,-1.350869376,0.68018326,025-BFZ,-0.335343058,423,385,808
3774,-1.350869376,0.68018326,025-BGA,-0.335343058,493,398,891
3775,-1.350869376,0.68018326,025-BGN,-0.335343058,256,325,581
3776,-1.350869376,0.68018326,025-BGO,-0.335343058,302,392,694
3777,-1.350869376,0.68018326,025-BGP,-0.335343058,384,362,746
3778,-1.350869376,0.68018326,025-BGQ,-0.335343058,214,202,416
3779,-1.350869376,0.68018326,025-BGR,-0.335343058,257,427,684
3780,-1.350869376,0.68018326,025-BGS,-0.335343058,249,320,569
3781,-1.350869376,0.68018326,025-BGT,-0.335343058,213,217,430
3782,-1.350869376,0.68018326,025-BGB,-0.335343058,320,303,623
3783,-1.350869376,0.68018326,025-BGU,-0.335343058,208,257,465
3784,-1.350869376,0.68018326,025-BGV,-0.335343058,375,407,782
3785,-1.350869376,0.68018326,025-BGW,-0.335343058,428,431,859
3786,-1.350869376,0.68018326,025-BGX,-0.335343058,140,281,421
3787,-1.350869376,0.68018326,025-BGY,-0.335343058,427,483,910
3788,-1.350869376,0.68018326,025-BGZ,-0.335343058,223,292,515
3789,-1.350869376,0.68018326,025-BGC,-0.335343058,282,362,644
3790,-1.350869376,0.68018326,025-BHA,-0.335343058,229,307,536
3791,-1.350869376,0.68018326,025-BHB,-0.335343058,212,256,468
3792,-1.350869376,0.68018326,025-BHC,-0.335343058,467,504,971
3793,-1.350869376,0.68018326,025-BHD,-0.335343058,503,410,913
3794,-1.350869376,0.68018326,025-BHE,-0.335343058,444,474,918
3795,-1.350869376,0.68018326,025-BGD,-0.335343058,225,327,552
3796,-1.350869376,0.68018326,025-BHF,-0.335343058,332,250,582
3797,-1.350869376,0.68018326,025-BHG,-0.335343058,323,462,785
3798,-1.350869376,0.68018326,025-BHH,-0.335343058,340,418,758
3799,-1.350869376,0.68018326,025-BHI,-0.335343058,178,327,505
3800,-1.350869376,0.68018326,025-BJP,-0.335343058,312,197,509
3801,-1.350869376,0.68018326,025-BJY,-0.335343058,372,356,728
3802,-1.350869376,0.68018326,025-BJQ,-0.335343058,323,395,718
3803,-1.350869376,0.68018326,025-BGE,-0.335343058,134,389,523
3804,-1.350869376,0.68018326,025-BHJ,-0.335343058,354,475,829
3805,-1.350869376,0.68018326,025-BHK,-0.335343058,423,316,739
3806,-1.350869376,0.68018326,025-BHL,-0.335343058,397,385,782
3807,-1.350869376,0.68018326,025-BGF,-0.335343058,364,390,754
3808,-1.350869376,0.68018326,025-BHM,-0.335343058,241,267,508
3809,-1.350869376,0.68018326,025-BHN,-0.335343058,188,225,413
3810,-1.350869376,0.68018326,025-BHO,-0.335343058,358,409,767
3811,-1.350869376,0.68018326,025-BHP,-0.335343058,243,332,575
3812,-1.350869376,0.68018326,025-BHQ,-0.335343058,397,534,931
3813,-1.350869376,0.68018326,025-BJR,-0.335343058,156,266,422
3814,-1.350869376,0.68018326,025-BGG,-0.335343058,201,628,829
3815,-1.350869376,0.68018326,025-BHR,-0.335343058,205,363,568
3816,-1.350869376,0.68018326,025-BHS,-0.335343058,339,495,834
3817,-1.350869376,0.68018326,025-BHT,-0.335343058,186,436,622
3818,-1.350869376,0.68018326,025-BJS,-0.335343058,78,560,638
3819,-1.350869376,0.68018326,025-BGH,-0.335343058,304,425,729
3820,-1.350869376,0.68018326,025-BHU,-0.335343058,330,451,781
3821,-1.350869376,0.68018326,025-BHV,-0.335343058,248,200,448
3822,-1.350869376,0.68018326,025-BHW,-0.335343058,454,539,993
3823,-1.350869376,0.68018326,025-BHX,-0.335343058,877,775,1652
3824,-1.350869376,0.68018326,025-BHY,-0.335343058,630,777,1407
3825,-1.350869376,0.68018326,025-BHZ,-0.335343058,429,459,888
3826,-1.350869376,0.68018326,025-BIA,-0.335343058,438,419,857
3827,-1.350869376,0.68018326,025-BGI,-0.335343058,91,437,528
3828,-1.350869376,0.68018326,025-BIB,-0.335343058,314,561,875
3829,-1.350869376,0.68018326,025-BIC,-0.335343058,65,1058,1123
3830,-1.350869376,0.68018326,025-BID,-0.335343058,52,465,517
3831,-1.350869376,0.68018326,025-BIE,-0.335343058,79,530,609
3832,-1.350869376,0.68018326,025-BIF,-0.335343058,31,833,864
3833,-1.350869376,0.68018326,025-BIG,-0.335343058,42,899,941
3834,-1.350869376,0.68018326,025-BGJ,-0.335343058,478,646,1124
3835,-1.350869376,0.68018326,025-BIH,-0.335343058,314,596,910
3836,-1.350869376,0.68018326,025-BII,-0.335343058,189,607,796
3837,-1.350869376,0.68018326,025-BIJ,-0.335343058,254,487,741
3838,-1.350869376,0.68018326,025-BIK,-0.335343058,405,566,971
3839,-1.350869376,0.68018326,025-BIL,-0.335343058,244,294,538
3840,-1.350869376,0.68018326,025-BIM,-0.335343058,90,390,480
3841,-1.350869376,0.68018326,025-BIN,-0.335343058,218,206,424
3842,-1.350869376,0.68018326,025-BGK,-0.335343058,197,684,881
3843,-1.350869376,0.68018326,025-BIO,-0.335343058,309,529,838
3844,-1.350869376,0.68018326,025-BIP,-0.335343058,367,529,896
3845,-1.350869376,0.68018326,025-BIQ,-0.335343058,377,426,803
3846,-1.350869376,0.68018326,025-BGL,-0.335343058,257,493,750
3847,-1.350869376,0.68018326,025-BIR,-0.335343058,318,574,892
3848,-1.350869376,0.68018326,025-BIS,-0.335343058,178,341,519
3849,-1.350869376,0.68018326,025-BIT,-0.335343058,353,647,1000
3850,-1.350869376,0.68018326,025-BIU,-0.335343058,256,383,639
3851,-1.350869376,0.68018326,025-BIV,-0.335343058,461,630,1091
3852,-1.350869376,0.68018326,025-BIW,-0.335343058,436,520,956
3853,-1.350869376,0.68018326,025-BGM,-0.335343058,289,321,610
3854,-1.350869376,0.68018326,025-BIX,-0.335343058,260,265,525
3855,-1.350869376,0.68018326,025-BIY,-0.335343058,226,368,594
3856,-1.350869376,0.68018326,025-BJT,-0.335343058,399,416,815
3857,-1.350869376,0.68018326,025-BJU,-0.335343058,206,264,470
3858,-1.350869376,0.68018326,025-ARG,-0.335343058,794,587,1381
3859,-1.350869376,0.68018326,025-ARH,-0.335343058,292,168,460
3860,-1.350869376,0.68018326,025-ARI,-0.335343058,528,332,860
3861,-1.350869376,0.68018326,025-ARJ,-0.335343058,387,274,661
3862,-1.350869376,0.68018326,025-ARK,-0.335343058,621,329,950
3863,-1.350869376,0.68018326,025-BCJ,-0.335343058,267,308,575
3864,-1.350869376,0.68018326,025-BCK,-0.335343058,425,292,717
3865,-1.350869376,0.68018326,025-ARL,-0.335343058,329,249,578
3866,-1.350869376,0.68018326,025-ARM,-0.335343058,240,201,441
3867,-1.350869376,0.68018326,025-ARN,-0.335343058,187,220,407
3868,-1.350869376,0.68018326,025-ARO,-0.335343058,350,325,675
3869,-1.350869376,0.68018326,025-ARP,-0.335343058,409,358,767
3870,-1.350869376,0.68018326,025-BDD,-0.335343058,331,230,561
3871,-1.350869376,0.68018326,025-BDO,-0.335343058,392,231,623
3872,-1.350869376,0.68018326,025-BDP,-0.335343058,317,304,621
3873,-1.350869376,0.68018326,025-BJZ,-0.335343058,606,356,962
3874,-1.350869376,0.68018326,025-ARQ,-0.335343058,268,124,392
3875,-1.350869376,0.68018326,025-BDE,-0.335343058,659,390,1049
3876,-1.350869376,0.68018326,025-BDQ,-0.335343058,460,257,717
3877,-1.350869376,0.68018326,025-BDR,-0.335343058,550,390,940
3878,-1.350869376,0.68018326,025-ARR,-0.335343058,451,398,849
3879,-1.350869376,0.68018326,025-ARS,-0.335343058,332,211,543
3880,-1.350869376,0.68018326,025-ART,-0.335343058,299,296,595
3881,-1.350869376,0.68018326,025-ARU,-0.335343058,459,422,881
3882,-1.350869376,0.68018326,025-ARV,-0.335343058,428,276,704
3883,-1.350869376,0.68018326,025-BCE,-0.335343058,544,417,961
3884,-1.350869376,0.68018326,025-YYY,-0.335343058,139,606,745
3885,-1.350869376,0.68018326,025-AYW,-0.335343058,378,335,713
3886,-1.350869376,0.68018326,025-AYX,-0.335343058,258,242,500
3887,-1.350869376,0.68018326,025-AYY,-0.335343058,319,263,582
3888,-1.350869376,0.68018326,025-AYZ,-0.335343058,333,271,604
3889,-1.350869376,0.68018326,025-AZA,-0.335343058,281,264,545
3890,-1.350869376,0.68018326,025-AZB,-0.335343058,29,86,115
3891,-1.350869376,0.68018326,025-ARW,-0.335343058,289,309,598
3892,-1.350869376,0.68018326,025-ARX,-0.335343058,346,304,650
3893,-1.350869376,0.68018326,025-ARY,-0.335343058,228,270,498
3894,-1.350869376,0.68018326,025-ARZ,-0.335343058,243,292,535
3895,-1.350869376,0.68018326,025-ASA,-0.335343058,387,410,797
3896,-1.350869376,0.68018326,025-ASB,-0.335343058,233,331,564
3897,-1.350869376,0.68018326,025-BDV,-0.335343058,94,98,192
3898,-1.350869376,0.68018326,025-BDW,-0.335343058,404,408,812
3899,-1.350869376,0.68018326,025-ASC,-0.335343058,331,319,650
3900,-1.350869376,0.68018326,025-ASD,-0.335343058,227,298,525
3901,-1.350869376,0.68018326,025-ASE,-0.335343058,361,299,660
3902,-1.350869376,0.68018326,025-ASF,-0.335343058,224,215,439
3903,-1.350869376,0.68018326,025-ASG,-0.335343058,340,298,638
3904,-1.350869376,0.68018326,025-BDB,-0.335343058,353,259,612
3905,-1.350869376,0.68018326,025-BDX,-0.335343058,181,170,351
3906,-1.350869376,0.68018326,025-BDY,-0.335343058,461,607,1068
3907,-1.350869376,0.68018326,025-BFN,-0.335343058,113,143,256
3908,-1.350869376,0.68018326,025-ASH,-0.335343058,249,379,628
3909,-1.350869376,0.68018326,025-ASI,-0.335343058,312,252,564
3910,-1.350869376,0.68018326,025-ASJ,-0.335343058,347,381,728
3911,-1.350869376,0.68018326,025-ASK,-0.335343058,430,360,790
3912,-1.350869376,0.68018326,025-ASL,-0.335343058,384,318,702
3913,-1.350869376,0.68018326,025-ASM,-0.335343058,250,327,577
3914,-1.350869376,0.68018326,025-BDZ,-0.335343058,316,396,712
3915,-1.350869376,0.68018326,025-ASN,-0.335343058,257,288,545
3916,-1.350869376,0.68018326,025-ASO,-0.335343058,281,346,627
3917,-1.350869376,0.68018326,025-ASP,-0.335343058,277,182,459
3918,-1.350869376,0.68018326,025-ASQ,-0.335343058,388,316,704
3919,-1.350869376,0.68018326,025-ASR,-0.335343058,141,127,268
3920,-1.350869376,0.68018326,025-ASS,-0.335343058,342,303,645
3921,-1.350869376,0.68018326,025-AST,-0.335343058,410,382,792
3922,-1.350869376,0.68018326,025-BEA,-0.335343058,289,258,547
3923,-1.350869376,0.68018326,025-ASU,-0.335343058,321,529,850
3924,-1.350869376,0.68018326,025-ASV,-0.335343058,295,497,792
3925,-1.350869376,0.68018326,025-ASW,-0.335343058,248,421,669
3926,-1.350869376,0.68018326,025-ASX,-0.335343058,193,476,669
3927,-1.350869376,0.68018326,025-ASY,-0.335343058,144,442,586
3928,-1.350869376,0.68018326,025-BFO,-0.335343058,227,433,660
3929,-1.350869376,0.68018326,025-ASZ,-0.335343058,343,287,630
3930,-1.350869376,0.68018326,025-ATA,-0.335343058,192,148,340
3931,-1.350869376,0.68018326,025-ATB,-0.335343058,352,219,571
3932,-1.350869376,0.68018326,025-ATC,-0.335343058,198,230,428
3933,-1.350869376,0.68018326,025-BDS,-0.335343058,791,495,1286
3934,-1.350869376,0.68018326,025-BJA,-0.335343058,458,347,805
3935,-1.350869376,0.68018326,025-ATD,-0.335343058,336,291,627
3936,-1.350869376,0.68018326,025-ATE,-0.335343058,487,365,852
3937,-1.350869376,0.68018326,025-ATF,-0.335343058,361,273,634
3938,-1.350869376,0.68018326,025-BDT,-0.335343058,451,286,737
3939,-1.350869376,0.68018326,025-BDU,-0.335343058,683,356,1039
3940,-1.350869376,0.68018326,025-ATG,-0.335343058,765,396,1161
3941,-1.350869376,0.68018326,025-ATH,-0.335343058,621,347,968
3942,-1.350869376,0.68018326,025-ATI,-0.335343058,687,395,1082
3943,-1.350869376,0.68018326,025-ATJ,-0.335343058,506,282,788
3944,-1.350869376,0.68018326,025-ATK,-0.335343058,440,200,640
3945,-1.350869376,0.68018326,025-BJB,-0.335343058,511,227,738
3946,-1.350869376,0.68018326,025-BJC,-0.335343058,357,263,620
3947,-1.350869376,0.68018326,025-ATM,-0.335343058,395,315,710
3948,-1.350869376,0.68018326,025-ATN,-0.335343058,360,212,572
3949,-1.350869376,0.68018326,025-ATO,-0.335343058,410,384,794
3950,-1.350869376,0.68018326,025-ATP,-0.335343058,487,395,882
3951,-1.350869376,0.68018326,025-ATQ,-0.335343058,350,242,592
3952,-1.350869376,0.68018326,025-BJV,-0.335343058,192,178,370
3953,-1.350869376,0.68018326,025-AZY,-0.335343058,460,477,937
3954,-1.350869376,0.68018326,025-AZZ,-0.335343058,467,317,784
3955,-1.350869376,0.68018326,025-BAA,-0.335343058,280,165,445
3956,-1.350869376,0.68018326,025-BFR,-0.335343058,379,291,670
3957,-1.350869376,0.68018326,025-AZE,-0.335343058,483,294,777
3958,-1.350869376,0.68018326,025-AZF,-0.335343058,284,169,453
3959,-1.350869376,0.68018326,025-AZG,-0.335343058,265,219,484
3960,-1.350869376,0.68018326,025-AZH,-0.335343058,310,260,570
3961,-1.350869376,0.68018326,025-ATR,-0.335343058,261,172,433
3962,-1.350869376,0.68018326,025-ATS,-0.335343058,384,306,690
3963,-1.350869376,0.68018326,025-ATT,-0.335343058,359,298,657
3964,-1.350869376,0.68018326,025-ATU,-0.335343058,250,249,499
3965,-1.350869376,0.68018326,025-BEB,-0.335343058,215,279,494
3966,-1.350869376,0.68018326,025-ATV,-0.335343058,423,357,780
3967,-1.350869376,0.68018326,025-ATW,-0.335343058,440,374,814
3968,-1.350869376,0.68018326,025-ATX,-0.335343058,353,279,632
3969,-1.350869376,0.68018326,025-ATY,-0.335343058,504,395,899
3970,-1.350869376,0.68018326,025-BJD,-0.335343058,367,335,702
3971,-1.350869376,0.68018326,025-ATZ,-0.335343058,306,291,597
3972,-1.350869376,0.68018326,025-AUA,-0.335343058,343,289,632
3973,-1.350869376,0.68018326,025-AUB,-0.335343058,245,235,480
3974,-1.350869376,0.68018326,025-AUC,-0.335343058,428,345,773
3975,-1.350869376,0.68018326,025-AUD,-0.335343058,550,417,967
3976,-1.350869376,0.68018326,025-AUE,-0.335343058,456,451,907
3977,-1.350869376,0.68018326,025-AUF,-0.335343058,544,397,941
3978,-1.350869376,0.68018326,025-Aug,-0.335343058,450,360,810
3979,-1.350869376,0.68018326,025-BDC,-0.335343058,533,454,987
3980,-1.350869376,0.68018326,025-BEC,-0.335343058,585,382,967
3981,-1.350869376,0.68018326,025-BJE,-0.335343058,277,243,520
3982,-1.350869376,0.68018326,025-AZM,-0.335343058,387,198,585
3983,-1.350869376,0.68018326,025-AZN,-0.335343058,289,171,460
3984,-1.350869376,0.68018326,025-AZO,-0.335343058,382,185,567
3985,-1.350869376,0.68018326,025-AZP,-0.335343058,544,218,762
3986,-1.350869376,0.68018326,025-AZR,-0.335343058,551,305,856
3987,-1.350869376,0.68018326,025-AZS,-0.335343058,452,217,669
3988,-1.350869376,0.68018326,025-AZT,-0.335343058,468,250,718
3989,-1.350869376,0.68018326,025-BEM,-0.335343058,558,794,1352
3990,-1.350869376,0.68018326,025-BFT,-0.335343058,595,363,958
3991,-1.350869376,0.68018326,025-BFU,-0.335343058,493,574,1067
3992,-1.350869376,0.68018326,025-BAB,-0.335343058,437,192,629
3993,-1.350869376,0.68018326,025-BAC,-0.335343058,437,198,635
3994,-1.350869376,0.68018326,025-BAD,-0.335343058,417,343,760
3995,-1.350869376,0.68018326,025-BAE,-0.335343058,352,437,789
3996,-1.350869376,0.68018326,025-BAF,-0.335343058,228,149,377
3997,-1.350869376,0.68018326,025-BAG,-0.335343058,192,207,399
3998,-1.350869376,0.68018326,025-BAH,-0.335343058,292,316,608
3999,-1.350869376,0.68018326,025-BAI,-0.335343058,292,354,646
4000,-1.350869376,0.68018326,025-BJW,-0.335343058,156,209,365
4001,-1.350869376,0.68018326,025-AZC,-0.335343058,178,213,391
4002,-1.350869376,0.68018326,025-BAJ,-0.335343058,168,340,508
4003,-1.350869376,0.68018326,025-BAK,-0.335343058,154,320,474
4004,-1.350869376,0.68018326,025-AYQ,-0.335343058,416,441,857
4005,-1.350869376,0.68018326,025-BAT,-0.335343058,303,213,516
4006,-1.350869376,0.68018326,025-BAU,-0.335343058,443,243,686
4007,-1.350869376,0.68018326,025-BCF,-0.335343058,406,292,698
4008,-1.350869376,0.68018326,025-BFV,-0.335343058,499,286,785
4009,-1.350869376,0.68018326,025-BFW,-0.335343058,268,129,397
4010,-1.350869376,0.68018326,025-BFX,-0.335343058,576,394,970
4011,-1.350869376,0.68018326,025-BAL,-0.335343058,433,262,695
4012,-1.350869376,0.68018326,025-BAM,-0.335343058,385,315,700
4013,-1.350869376,0.68018326,025-BAN,-0.335343058,342,270,612
4014,-1.350869376,0.68018326,025-BAO,-0.335343058,260,190,450
4015,-1.350869376,0.68018326,025-AZJ,-0.335343058,308,285,593
4016,-1.350869376,0.68018326,025-AZK,-0.335343058,425,337,762
4017,-1.350869376,0.68018326,025-AZL,-0.335343058,259,198,457
4018,-1.350869376,0.68018326,025-BAP,-0.335343058,359,290,649
4019,-1.350869376,0.68018326,025-BAQ,-0.335343058,443,296,739
4020,-1.350869376,0.68018326,025-BAR,-0.335343058,159,186,345
4021,-1.350869376,0.68018326,025-BAS,-0.335343058,498,408,906
4022,-1.350869376,0.68018326,025-BAV,-0.335343058,170,103,273
4023,-1.350869376,0.68018326,025-BAW,-0.335343058,243,129,372
4024,-1.350869376,0.68018326,025-BAX,-0.335343058,355,151,506
4025,-1.350869376,0.68018326,025-BAZ,-0.335343058,312,179,491
4026,-1.350869376,0.68018326,025-BBA,-0.335343058,437,236,673
4027,-1.350869376,0.68018326,025-BBB,-0.335343058,479,359,838
4028,-1.350869376,0.68018326,025-BBC,-0.335343058,448,255,703
4029,-1.350869376,0.68018326,025-BBD,-0.335343058,373,163,536
4030,-1.350869376,0.68018326,025-BBE,-0.335343058,232,170,402
4031,-1.350869376,0.68018326,025-BBF,-0.335343058,390,252,642
4032,-1.350869376,0.68018326,025-BBG,-0.335343058,433,369,802
4033,-1.350869376,0.68018326,025-BBH,-0.335343058,407,264,671
4034,-1.350869376,0.68018326,025-BBI,-0.335343058,341,302,643
4035,-1.350869376,0.68018326,025-BBJ,-0.335343058,378,317,695
4036,-1.350869376,0.68018326,025-BBK,-0.335343058,293,354,647
4037,-1.350869376,0.68018326,025-BBL,-0.335343058,326,295,621
4038,-1.350869376,0.68018326,025-BBM,-0.335343058,217,338,555
4039,-1.350869376,0.68018326,025-BBN,-0.335343058,319,324,643
4040,-1.350869376,0.68018326,025-BBO,-0.335343058,125,136,261
4041,-1.350869376,0.68018326,025-BBP,-0.335343058,225,124,349
4042,-1.350869376,0.68018326,025-BCC,-0.335343058,268,202,470
4043,-1.350869376,0.68018326,025-BKA,-0.335343058,288,226,514
4044,-1.350869376,0.68018326,025-AUH,-0.335343058,261,386,647
4045,-1.350869376,0.68018326,025-AUI,-0.335343058,434,408,842
4046,-1.350869376,0.68018326,025-AUJ,-0.335343058,244,478,722
4047,-1.350869376,0.68018326,025-AUK,-0.335343058,374,358,732
4048,-1.350869376,0.68018326,025-AUL,-0.335343058,227,225,452
4049,-1.350869376,0.68018326,025-BEJ,-0.335343058,293,380,673
4050,-1.350869376,0.68018326,025-AUM,-0.335343058,581,530,1111
4051,-1.350869376,0.68018326,025-AUN,-0.335343058,205,164,369
4052,-1.350869376,0.68018326,025-AUO,-0.335343058,236,265,501
4053,-1.350869376,0.68018326,025-AUP,-0.335343058,236,239,475
4054,-1.350869376,0.68018326,025-AUQ,-0.335343058,182,157,339
4055,-1.350869376,0.68018326,025-AUR,-0.335343058,428,445,873
4056,-1.350869376,0.68018326,025-BEK,-0.335343058,156,162,318
4057,-1.350869376,0.68018326,025-AUS,-0.335343058,131,179,310
4058,-1.350869376,0.68018326,025-AUT,-0.335343058,407,358,765
4059,-1.350869376,0.68018326,025-AUU,-0.335343058,452,504,956
4060,-1.350869376,0.68018326,025-AUW,-0.335343058,156,331,487
4061,-1.350869376,0.68018326,025-AUX,-0.335343058,158,440,598
4062,-1.350869376,0.68018326,025-AUY,-0.335343058,264,375,639
4063,-1.350869376,0.68018326,025-AUZ,-0.335343058,329,298,627
4064,-1.350869376,0.68018326,025-BCD,-0.335343058,96,293,389
4065,-1.350869376,0.68018326,025-BEL,-0.335343058,314,258,572
4066,-1.350869376,0.68018326,025-BBQ,-0.335343058,150,215,365
4067,-1.350869376,0.68018326,025-BBR,-0.335343058,333,289,622
4068,-1.350869376,0.68018326,025-BBS,-0.335343058,260,354,614
4069,-1.350869376,0.68018326,025-BBT,-0.335343058,70,33,103
4070,-1.350869376,0.68018326,025-BBU,-0.335343058,218,306,524
4071,-1.350869376,0.68018326,025-AVA,-0.335343058,407,459,866
4072,-1.350869376,0.68018326,025-AVB,-0.335343058,292,409,701
4073,-1.350869376,0.68018326,025-AVC,-0.335343058,283,254,537
4074,-1.350869376,0.68018326,025-AVD,-0.335343058,245,294,539
4075,-1.350869376,0.68018326,025-AVE,-0.335343058,364,383,747
4076,-1.350869376,0.68018326,025-AVF,-0.335343058,348,259,607
4077,-1.350869376,0.68018326,025-AVG,-0.335343058,330,294,624
4078,-1.350869376,0.68018326,025-AVH,-0.335343058,336,214,550
4079,-1.350869376,0.68018326,025-AVI,-0.335343058,333,338,671
4080,-1.350869376,0.68018326,025-AVJ,-0.335343058,309,285,594
4081,-1.350869376,0.68018326,025-AVK,-0.335343058,253,344,597
4082,-1.350869376,0.68018326,025-AVL,-0.335343058,387,292,679
4083,-1.350869376,0.68018326,025-AVM,-0.335343058,266,285,551
4084,-1.350869376,0.68018326,025-AVN,-0.335343058,354,425,779
4085,-1.350869376,0.68018326,025-AVO,-0.335343058,384,373,757
4086,-1.350869376,0.68018326,025-AVP,-0.335343058,285,280,565
4087,-1.350869376,0.68018326,025-AVQ,-0.335343058,289,326,615
4088,-1.350869376,0.68018326,025-AVR,-0.335343058,365,411,776
4089,-1.350869376,0.68018326,025-AVS,-0.335343058,323,392,715
4090,-1.350869376,0.68018326,025-AVT,-0.335343058,318,288,606
4091,-1.350869376,0.68018326,025-AVU,-0.335343058,421,302,723
4092,-1.350869376,0.68018326,025-AVV,-0.335343058,350,387,737
4093,-1.350869376,0.68018326,025-AVW,-0.335343058,444,316,760
4094,-1.350869376,0.68018326,025-AVX,-0.335343058,365,312,677
4095,-1.350869376,0.68018326,025-AVY,-0.335343058,312,286,598
4096,-1.350869376,0.68018326,025-AVZ,-0.335343058,232,199,431
4097,-1.350869376,0.68018326,025-AWA,-0.335343058,391,315,706
4098,-1.350869376,0.68018326,025-AWB,-0.335343058,425,307,732
4099,-1.350869376,0.68018326,025-AWC,-0.335343058,401,391,792
4100,-1.350869376,0.68018326,025-AWD,-0.335343058,359,264,623
4101,-1.350869376,0.68018326,025-AWE,-0.335343058,290,263,553
4102,-1.350869376,0.68018326,025-AWF,-0.335343058,327,252,579
4103,-1.350869376,0.68018326,025-AWG,-0.335343058,398,246,644
4104,-1.350869376,0.68018326,025-AWH,-0.335343058,409,293,702
4105,-1.350869376,0.68018326,025-AZQ,-0.335343058,36,257,293
4106,-1.350869376,0.68018326,025-AZD,-0.335343058,180,134,314
4107,-1.350869376,0.68018326,025-BBV,-0.335343058,273,209,482
4108,-1.350869376,0.68018326,025-AWI,-0.335343058,320,382,702
4109,-1.350869376,0.68018326,025-AWJ,-0.335343058,420,348,768
4110,-1.350869376,0.68018326,025-AWK,-0.335343058,382,258,640
4111,-1.350869376,0.68018326,025-AWL,-0.335343058,244,209,453
4112,-1.350869376,0.68018326,025-AWM,-0.335343058,373,329,702
4113,-1.350869376,0.68018326,025-AWN,-0.335343058,462,308,770
4114,-1.350869376,0.68018326,025-AWO,-0.335343058,264,185,449
4115,-1.350869376,0.68018326,025-AWP,-0.335343058,327,260,587
4116,-1.350869376,0.68018326,025-AWQ,-0.335343058,316,230,546
4117,-1.350869376,0.68018326,025-AWR,-0.335343058,440,334,774
4118,-1.350869376,0.68018326,025-AWS,-0.335343058,428,264,692
4119,-1.350869376,0.68018326,025-BDA,-0.335343058,299,214,513
4120,-1.350869376,0.68018326,025-BFP,-0.335343058,289,190,479
4121,-1.350869376,0.68018326,025-AWT,-0.335343058,335,259,594
4122,-1.350869376,0.68018326,025-AWU,-0.335343058,323,251,574
4123,-1.350869376,0.68018326,025-AWV,-0.335343058,277,329,606
4124,-1.350869376,0.68018326,025-AWW,-0.335343058,339,416,755
4125,-1.350869376,0.68018326,025-AWX,-0.335343058,183,210,393
4126,-1.350869376,0.68018326,025-AWY,-0.335343058,471,297,768
4127,-1.350869376,0.68018326,025-AWZ,-0.335343058,295,249,544
4128,-1.350869376,0.68018326,025-AXA,-0.335343058,362,303,665
4129,-1.350869376,0.68018326,025-AXB,-0.335343058,436,330,766
4130,-1.350869376,0.68018326,025-AXC,-0.335343058,272,329,601
4131,-1.350869376,0.68018326,025-AXD,-0.335343058,190,362,552
4132,-1.350869376,0.68018326,025-AXE,-0.335343058,366,290,656
4133,-1.350869376,0.68018326,025-AXF,-0.335343058,298,288,586
4134,-1.350869376,0.68018326,025-AXG,-0.335343058,418,316,734
4135,-1.350869376,0.68018326,025-AXH,-0.335343058,71,336,407
4136,-1.350869376,0.68018326,025-AXI,-0.335343058,168,348,516
4137,-1.350869376,0.68018326,025-AXJ,-0.335343058,348,335,683
4138,-1.350869376,0.68018326,025-AXK,-0.335343058,254,325,579
4139,-1.350869376,0.68018326,025-AXL,-0.335343058,232,277,509
4140,-1.350869376,0.68018326,025-AXM,-0.335343058,117,329,446
4141,-1.350869376,0.68018326,025-AXN,-0.335343058,214,196,410
4142,-1.350869376,0.68018326,025-AXO,-0.335343058,244,249,493
4143,-1.350869376,0.68018326,025-AXP,-0.335343058,190,280,470
4144,-1.350869376,0.68018326,025-AXQ,-0.335343058,218,353,571
4145,-1.350869376,0.68018326,025-AXR,-0.335343058,203,434,637
4146,-1.350869376,0.68018326,025-AXS,-0.335343058,256,461,717
4147,-1.350869376,0.68018326,025-AXT,-0.335343058,186,526,712
4148,-1.350869376,0.68018326,025-AXU,-0.335343058,301,413,714
4149,-1.350869376,0.68018326,025-AXV,-0.335343058,322,358,680
4150,-1.350869376,0.68018326,025-AXW,-0.335343058,380,348,728
4151,-1.350869376,0.68018326,025-AXX,-0.335343058,218,196,414
4152,-1.350869376,0.68018326,025-AXY,-0.335343058,266,477,743
4153,-1.350869376,0.68018326,025-AXZ,-0.335343058,222,409,631
4154,-1.350869376,0.68018326,025-AYA,-0.335343058,241,457,698
4155,-1.350869376,0.68018326,025-AYB,-0.335343058,279,367,646
4156,-1.350869376,0.68018326,025-AYC,-0.335343058,349,399,748
4157,-1.350869376,0.68018326,025-AYD,-0.335343058,257,323,580
4158,-1.350869376,0.68018326,025-AYE,-0.335343058,216,203,419
4159,-1.350869376,0.68018326,025-AYF,-0.335343058,234,338,572
4160,-1.350869376,0.68018326,025-AYG,-0.335343058,282,429,711
4161,-1.350869376,0.68018326,025-AYH,-0.335343058,266,230,496
4162,-1.350869376,0.68018326,025-AYI,-0.335343058,197,153,350
4163,-1.350869376,0.68018326,026-AAA,-0.335343058,317,344,661
4164,-1.350869376,0.68018326,026-AAO,-0.335343058,500,262,762
4165,-1.350869376,0.68018326,026-AAQ,-0.335343058,462,238,700
4166,-1.350869376,0.68018326,026-AAP,-0.335343058,522,229,751
4167,-1.350869376,0.68018326,026-AAC,-0.335343058,277,205,482
4168,-1.350869376,0.68018326,026-AAD,-0.335343058,385,219,604
4169,-1.350869376,0.68018326,026-ABH,-0.335343058,344,389,733
4170,-1.350869376,0.68018326,026-ABJ,-0.335343058,166,186,352
4171,-1.350869376,0.68018326,026-ABI,-0.335343058,221,292,513
4172,-1.350869376,0.68018326,026-AAK,-0.335343058,454,362,816
4173,-1.350869376,0.68018326,026-AAS,-0.335343058,238,265,503
4174,-1.350869376,0.68018326,026-AAL,-0.335343058,250,119,369
4175,-1.350869376,0.68018326,026-AAM,-0.335343058,396,398,794
4176,-1.350869376,0.68018326,026-AAN,-0.335343058,569,217,786
4177,-1.350869376,0.68018326,026-AAR,-0.335343058,294,203,497
4178,-1.350869376,0.68018326,026-AAV,-0.335343058,131,161,292
4179,-1.350869376,0.68018326,026-AAB,-0.335343058,120,165,285
4180,-1.350869376,0.68018326,026-AAE,-0.335343058,682,295,977
4181,-1.350869376,0.68018326,026-AAU,-0.335343058,466,461,927
4182,-1.350869376,0.68018326,026-AAW,-0.335343058,239,267,506
4183,-1.350869376,0.68018326,026-AAX,-0.335343058,328,365,693
4184,-1.350869376,0.68018326,026-AAY,-0.335343058,543,578,1121
4185,-1.350869376,0.68018326,026-AAZ,-0.335343058,305,310,615
4186,-1.350869376,0.68018326,026-ABA,-0.335343058,375,384,759
4187,-1.350869376,0.68018326,026-ABE,-0.335343058,145,211,356
4188,-1.350869376,0.68018326,026-ABB,-0.335343058,196,220,416
4189,-1.350869376,0.68018326,026-ABD,-0.335343058,225,303,528
4190,-1.350869376,0.68018326,026-ABC,-0.335343058,223,252,475
4191,-1.350869376,0.68018326,026-AAJ,-0.335343058,401,393,794
4192,-1.350869376,0.68018326,026-AAI,-0.335343058,284,251,535
4193,-1.350869376,0.68018326,026-AAF,-0.335343058,407,324,731
4194,-1.350869376,0.68018326,026-AAH,-0.335343058,288,330,618
4195,-1.350869376,0.68018326,026-AAG,-0.335343058,406,316,722
4196,-1.350869376,0.68018326,026-ABF,-0.335343058,316,209,525
4197,-1.350869376,0.68018326,026-ABG,-0.335343058,217,177,394
4198,-1.350869376,0.68018326,027-AAF,-0.335343058,267,134,401
4199,-1.350869376,0.68018326,027-AAG,-0.335343058,367,186,553
4200,-1.350869376,0.68018326,027-ABF,-0.335343058,233,224,457
4201,-1.350869376,0.68018326,027-ABC,-0.335343058,278,197,475
4202,-1.350869376,0.68018326,027-AAI,-0.335343058,270,172,442
4203,-1.350869376,0.68018326,027-AAJ,-0.335343058,245,111,356
4204,-1.350869376,0.68018326,027-AAK,-0.335343058,314,140,454
4205,-1.350869376,0.68018326,027-AAA,-0.335343058,241,143,384
4206,-1.350869376,0.68018326,027-AAE,-0.335343058,274,160,434
4207,-1.350869376,0.68018326,027-AAB,-0.335343058,151,105,256
4208,-1.350869376,0.68018326,027-AAC,-0.335343058,145,94,239
4209,-1.350869376,0.68018326,027-AAD,-0.335343058,92,77,169
4210,-1.350869376,0.68018326,027-AAL,-0.335343058,248,108,356
4211,-1.350869376,0.68018326,027-AAN,-0.335343058,244,135,379
4212,-1.350869376,0.68018326,027-AAO,-0.335343058,246,188,434
4213,-1.350869376,0.68018326,027-AAP,-0.335343058,266,154,420
4214,-1.350869376,0.68018326,027-AAQ,-0.335343058,378,165,543
4215,-1.350869376,0.68018326,027-AAR,-0.335343058,229,102,331
4216,-1.350869376,0.68018326,027-AAS,-0.335343058,244,150,394
4217,-1.350869376,0.68018326,027-AAT,-0.335343058,116,110,226
4218,-1.350869376,0.68018326,027-AAU,-0.335343058,154,54,208
4219,-1.350869376,0.68018326,027-AAV,-0.335343058,273,74,347
4220,-1.350869376,0.68018326,027-AAW,-0.335343058,261,165,426
4221,-1.350869376,0.68018326,027-AAX,-0.335343058,171,150,321
4222,-1.350869376,0.68018326,027-AAY,-0.335343058,174,96,270
4223,-1.350869376,0.68018326,027-AAM,-0.335343058,232,157,389
4224,-1.350869376,0.68018326,027-AAZ,-0.335343058,329,211,540
4225,-1.350869376,0.68018326,027-ABA,-0.335343058,248,141,389
4226,-1.350869376,0.68018326,027-ABB,-0.335343058,348,177,525
4227,-1.350869376,0.68018326,027-ABD,-0.335343058,162,76,238
4228,-1.350869376,0.68018326,027-ABE,-0.335343058,110,115,225
4229,-1.350869376,0.68018326,027-ABG,-0.335343058,234,116,350
4230,-1.350869376,0.68018326,027-ABH,-0.335343058,346,198,544
4231,-1.350869376,0.68018326,027-ABI,-0.335343058,137,70,207
4232,-1.350869376,0.68018326,027-ABJ,-0.335343058,220,122,342
4233,-1.350869376,0.68018326,028-AAA,-0.335343058,445,305,750
4234,-1.350869376,0.68018326,028-AAB,-0.335343058,385,234,619
4235,-1.350869376,0.68018326,028-AAC,-0.335343058,379,234,613
4236,-1.350869376,0.68018326,028-AAD,-0.335343058,355,262,617
4237,-1.350869376,0.68018326,028-ADP,-0.335343058,346,247,593
4238,-1.350869376,0.68018326,028-ADQ,-0.335343058,404,267,671
4239,-1.350869376,0.68018326,028-AAE,-0.335343058,196,468,664
4240,-1.350869376,0.68018326,028-AAF,-0.335343058,246,172,418
4241,-1.350869376,0.68018326,028-AAG,-0.335343058,416,341,757
4242,-1.350869376,0.68018326,028-AAH,-0.335343058,438,238,676
4243,-1.350869376,0.68018326,028-AAI,-0.335343058,254,281,535
4244,-1.350869376,0.68018326,028-AAJ,-0.335343058,326,218,544
4245,-1.350869376,0.68018326,028-AAK,-0.335343058,235,189,424
4246,-1.350869376,0.68018326,028-AAL,-0.335343058,277,198,475
4247,-1.350869376,0.68018326,028-AAM,-0.335343058,346,313,659
4248,-1.350869376,0.68018326,028-AAN,-0.335343058,367,259,626
4249,-1.350869376,0.68018326,028-AAO,-0.335343058,335,303,638
4250,-1.350869376,0.68018326,028-AAP,-0.335343058,325,272,597
4251,-1.350869376,0.68018326,028-AAT,-0.335343058,236,203,439
4252,-1.350869376,0.68018326,028-AAU,-0.335343058,151,157,308
4253,-1.350869376,0.68018326,028-AAQ,-0.335343058,312,190,502
4254,-1.350869376,0.68018326,028-AAR,-0.335343058,213,167,380
4255,-1.350869376,0.68018326,028-AAS,-0.335343058,354,175,529
4256,-1.350869376,0.68018326,028-AAZ,-0.335343058,258,238,496
4257,-1.350869376,0.68018326,028-ABA,-0.335343058,296,227,523
4258,-1.350869376,0.68018326,028-ABB,-0.335343058,217,153,370
4259,-1.350869376,0.68018326,028-ABC,-0.335343058,284,258,542
4260,-1.350869376,0.68018326,028-ABD,-0.335343058,425,372,797
4261,-1.350869376,0.68018326,028-AAV,-0.335343058,345,209,554
4262,-1.350869376,0.68018326,028-AAW,-0.335343058,349,249,598
4263,-1.350869376,0.68018326,028-AAX,-0.335343058,311,229,540
4264,-1.350869376,0.68018326,028-AAY,-0.335343058,334,254,588
4265,-1.350869376,0.68018326,028-ADS,-0.335343058,390,248,638
4266,-1.350869376,0.68018326,028-ABE,-0.335343058,307,214,521
4267,-1.350869376,0.68018326,028-ABF,-0.335343058,246,192,438
4268,-1.350869376,0.68018326,028-ABG,-0.335343058,303,239,542
4269,-1.350869376,0.68018326,028-ABH,-0.335343058,260,195,455
4270,-1.350869376,0.68018326,028-ABI,-0.335343058,226,195,421
4271,-1.350869376,0.68018326,028-ABJ,-0.335343058,227,184,411
4272,-1.350869376,0.68018326,028-ABK,-0.335343058,217,155,372
4273,-1.350869376,0.68018326,028-ABL,-0.335343058,366,277,643
4274,-1.350869376,0.68018326,028-ABM,-0.335343058,368,288,656
4275,-1.350869376,0.68018326,028-ABN,-0.335343058,216,173,389
4276,-1.350869376,0.68018326,028-ABO,-0.335343058,320,271,591
4277,-1.350869376,0.68018326,028-ABP,-0.335343058,270,192,462
4278,-1.350869376,0.68018326,028-ABQ,-0.335343058,285,183,468
4279,-1.350869376,0.68018326,028-ABS,-0.335343058,69,97,166
4280,-1.350869376,0.68018326,028-ABT,-0.335343058,327,172,499
4281,-1.350869376,0.68018326,028-ABU,-0.335343058,431,263,694
4282,-1.350869376,0.68018326,028-ABV,-0.335343058,201,148,349
4283,-1.350869376,0.68018326,028-ABW,-0.335343058,391,267,658
4284,-1.350869376,0.68018326,028-ABX,-0.335343058,297,213,510
4285,-1.350869376,0.68018326,028-ABY,-0.335343058,424,239,663
4286,-1.350869376,0.68018326,028-ADR,-0.335343058,369,299,668
4287,-1.350869376,0.68018326,028-ABZ,-0.335343058,476,217,693
4288,-1.350869376,0.68018326,028-ACA,-0.335343058,236,119,355
4289,-1.350869376,0.68018326,028-ACE,-0.335343058,386,278,664
4290,-1.350869376,0.68018326,028-ACF,-0.335343058,331,259,590
4291,-1.350869376,0.68018326,028-ACB,-0.335343058,204,86,290
4292,-1.350869376,0.68018326,028-ACC,-0.335343058,209,88,297
4293,-1.350869376,0.68018326,028-ACD,-0.335343058,175,104,279
4294,-1.350869376,0.68018326,028-ACG,-0.335343058,347,217,564
4295,-1.350869376,0.68018326,028-ACH,-0.335343058,301,200,501
4296,-1.350869376,0.68018326,028-ACI,-0.335343058,374,212,586
4297,-1.350869376,0.68018326,028-ACJ,-0.335343058,545,331,876
4298,-1.350869376,0.68018326,028-ACK,-0.335343058,376,214,590
4299,-1.350869376,0.68018326,028-ACL,-0.335343058,298,193,491
4300,-1.350869376,0.68018326,028-ACM,-0.335343058,267,219,486
4301,-1.350869376,0.68018326,028-ACN,-0.335343058,334,186,520
4302,-1.350869376,0.68018326,028-ACO,-0.335343058,263,202,465
4303,-1.350869376,0.68018326,028-ACP,-0.335343058,227,174,401
4304,-1.350869376,0.68018326,028-ACQ,-0.335343058,388,252,640
4305,-1.350869376,0.68018326,028-ACR,-0.335343058,374,269,643
4306,-1.350869376,0.68018326,028-ACS,-0.335343058,263,237,500
4307,-1.350869376,0.68018326,028-ACT,-0.335343058,350,252,602
4308,-1.350869376,0.68018326,028-ACU,-0.335343058,317,185,502
4309,-1.350869376,0.68018326,028-ACV,-0.335343058,305,147,452
4310,-1.350869376,0.68018326,028-ACW,-0.335343058,367,205,572
4311,-1.350869376,0.68018326,028-ADF,-0.335343058,511,297,808
4312,-1.350869376,0.68018326,028-ADG,-0.335343058,321,310,631
4313,-1.350869376,0.68018326,028-ADH,-0.335343058,327,278,605
4314,-1.350869376,0.68018326,028-ADI,-0.335343058,288,214,502
4315,-1.350869376,0.68018326,028-ADO,-0.335343058,64,29,93
4316,-1.350869376,0.68018326,028-ACX,-0.335343058,261,222,483
4317,-1.350869376,0.68018326,028-ACY,-0.335343058,224,195,419
4318,-1.350869376,0.68018326,028-ACZ,-0.335343058,299,242,541
4319,-1.350869376,0.68018326,028-ADA,-0.335343058,231,134,365
4320,-1.350869376,0.68018326,028-ADB,-0.335343058,239,211,450
4321,-1.350869376,0.68018326,028-ADC,-0.335343058,237,176,413
4322,-1.350869376,0.68018326,028-ADD,-0.335343058,237,215,452
4323,-1.350869376,0.68018326,028-ADE,-0.335343058,248,191,439
4324,-1.350869376,0.68018326,028-ADJ,-0.335343058,296,208,504
4325,-1.350869376,0.68018326,028-ADK,-0.335343058,228,175,403
4326,-1.350869376,0.68018326,028-ADL,-0.335343058,138,168,306
4327,-1.350869376,0.68018326,028-ADM,-0.335343058,281,232,513
4328,-1.350869376,0.68018326,028-ADN,-0.335343058,283,321,604
4329,-1.350869376,0.68018326,029-AGM,-0.335343058,460,379,839
4330,-1.350869376,0.68018326,029-AGJ,-0.335343058,361,351,712
4331,-1.350869376,0.68018326,029-AGL,-0.335343058,381,292,673
4332,-1.350869376,0.68018326,029-AGK,-0.335343058,339,167,506
4333,-1.350869376,0.68018326,029-AAJ,-0.335343058,369,206,575
4334,-1.350869376,0.68018326,029-AAR,-0.335343058,511,254,765
4335,-1.350869376,0.68018326,029-AAT,-0.335343058,403,207,610
4336,-1.350869376,0.68018326,029-ABF,-0.335343058,397,225,622
4337,-1.350869376,0.68018326,029-AAP,-0.335343058,376,241,617
4338,-1.350869376,0.68018326,029-AAB,-0.335343058,436,248,684
4339,-1.350869376,0.68018326,029-AAO,-0.335343058,515,361,876
4340,-1.350869376,0.68018326,029-ABA,-0.335343058,276,232,508
4341,-1.350869376,0.68018326,029-AGT,-0.335343058,376,187,563
4342,-1.350869376,0.68018326,029-AAL,-0.335343058,462,218,680
4343,-1.350869376,0.68018326,029-AJB,-0.335343058,387,218,605
4344,-1.350869376,0.68018326,029-AAQ,-0.335343058,417,180,597
4345,-1.350869376,0.68018326,029-ACO,-0.335343058,422,236,658
4346,-1.350869376,0.68018326,029-AAF,-0.335343058,456,243,699
4347,-1.350869376,0.68018326,029-AAE,-0.335343058,487,244,731
4348,-1.350869376,0.68018326,029-AAI,-0.335343058,366,224,590
4349,-1.350869376,0.68018326,029-AAU,-0.335343058,348,219,567
4350,-1.350869376,0.68018326,029-AAN,-0.335343058,569,388,957
4351,-1.350869376,0.68018326,029-AAM,-0.335343058,507,283,790
4352,-1.350869376,0.68018326,029-AAK,-0.335343058,538,220,758
4353,-1.350869376,0.68018326,029-AAH,-0.335343058,331,173,504
4354,-1.350869376,0.68018326,029-AAA,-0.335343058,426,192,618
4355,-1.350869376,0.68018326,029-AJC,-0.335343058,255,147,402
4356,-1.350869376,0.68018326,029-AAV,-0.335343058,342,179,521
4357,-1.350869376,0.68018326,029-AGQ,-0.335343058,336,192,528
4358,-1.350869376,0.68018326,029-ABB,-0.335343058,372,207,579
4359,-1.350869376,0.68018326,029-AAZ,-0.335343058,374,204,578
4360,-1.350869376,0.68018326,029-ABH,-0.335343058,527,264,791
4361,-1.350869376,0.68018326,029-AAY,-0.335343058,421,193,614
4362,-1.350869376,0.68018326,029-ABD,-0.335343058,321,188,509
4363,-1.350869376,0.68018326,029-AGS,-0.335343058,358,217,575
4364,-1.350869376,0.68018326,029-AAC,-0.335343058,344,180,524
4365,-1.350869376,0.68018326,029-ABG,-0.335343058,268,122,390
4366,-1.350869376,0.68018326,029-ACD,-0.335343058,399,180,579
4367,-1.350869376,0.68018326,029-AAD,-0.335343058,180,48,228
4368,-1.350869376,0.68018326,029-ABS,-0.335343058,531,316,847
4369,-1.350869376,0.68018326,029-AAX,-0.335343058,344,125,469
4370,-1.350869376,0.68018326,029-ABE,-0.335343058,226,155,381
4371,-1.350869376,0.68018326,029-AIZ,-0.335343058,461,214,675
4372,-1.350869376,0.68018326,029-ABC,-0.335343058,528,220,748
4373,-1.350869376,0.68018326,029-AGR,-0.335343058,687,323,1010
4374,-1.350869376,0.68018326,029-AAW,-0.335343058,439,208,647
4375,-1.350869376,0.68018326,029-ACP,-0.335343058,340,228,568
4376,-1.350869376,0.68018326,029-ACQ,-0.335343058,633,268,901
4377,-1.350869376,0.68018326,029-AAG,-0.335343058,415,182,597
4378,-1.350869376,0.68018326,029-AAS,-0.335343058,375,253,628
4379,-1.350869376,0.68018326,029-ACS,-0.335343058,421,197,618
4380,-1.350869376,0.68018326,029-ACW,-0.335343058,365,235,600
4381,-1.350869376,0.68018326,029-ACX,-0.335343058,271,165,436
4382,-1.350869376,0.68018326,029-ACV,-0.335343058,267,215,482
4383,-1.350869376,0.68018326,029-ACU,-0.335343058,575,262,837
4384,-1.350869376,0.68018326,029-ACT,-0.335343058,594,187,781
4385,-1.350869376,0.68018326,029-ACR,-0.335343058,521,192,713
4386,-1.350869376,0.68018326,029-AHE,-0.335343058,290,91,381
4387,-1.350869376,0.68018326,029-AGX,-0.335343058,480,194,674
4388,-1.350869376,0.68018326,029-AGW,-0.335343058,636,194,830
4389,-1.350869376,0.68018326,029-AGZ,-0.335343058,342,248,590
4390,-1.350869376,0.68018326,029-AGY,-0.335343058,229,268,497
4391,-1.350869376,0.68018326,029-AHB,-0.335343058,182,197,379
4392,-1.350869376,0.68018326,029-AHA,-0.335343058,266,172,438
4393,-1.350869376,0.68018326,029-ADM,-0.335343058,266,147,413
4394,-1.350869376,0.68018326,029-ADQ,-0.335343058,260,198,458
4395,-1.350869376,0.68018326,029-AEA,-0.335343058,278,253,531
4396,-1.350869376,0.68018326,029-ADY,-0.335343058,209,199,408
4397,-1.350869376,0.68018326,029-AEC,-0.335343058,328,264,592
4398,-1.350869376,0.68018326,029-ADJ,-0.335343058,227,208,435
4399,-1.350869376,0.68018326,029-ADU,-0.335343058,232,244,476
4400,-1.350869376,0.68018326,029-ADW,-0.335343058,416,239,655
4401,-1.350869376,0.68018326,029-AIX,-0.335343058,402,216,618
4402,-1.350869376,0.68018326,029-ADL,-0.335343058,335,289,624
4403,-1.350869376,0.68018326,029-ADP,-0.335343058,393,305,698
4404,-1.350869376,0.68018326,029-ADZ,-0.335343058,239,250,489
4405,-1.350869376,0.68018326,029-AED,-0.335343058,322,214,536
4406,-1.350869376,0.68018326,029-ADF,-0.335343058,180,206,386
4407,-1.350869376,0.68018326,029-ADG,-0.335343058,197,242,439
4408,-1.350869376,0.68018326,029-ADT,-0.335343058,310,359,669
4409,-1.350869376,0.68018326,029-ADS,-0.335343058,224,243,467
4410,-1.350869376,0.68018326,029-ADV,-0.335343058,183,268,451
4411,-1.350869376,0.68018326,029-ADX,-0.335343058,172,202,374
4412,-1.350869376,0.68018326,029-ADK,-0.335343058,295,677,972
4413,-1.350869376,0.68018326,029-ADH,-0.335343058,303,191,494
4414,-1.350869376,0.68018326,029-ADI,-0.335343058,707,368,1075
4415,-1.350869376,0.68018326,029-ADN,-0.335343058,159,246,405
4416,-1.350869376,0.68018326,029-ADO,-0.335343058,392,157,549
4417,-1.350869376,0.68018326,029-ADR,-0.335343058,396,237,633
4418,-1.350869376,0.68018326,029-AEB,-0.335343058,258,222,480
4419,-1.350869376,0.68018326,029-AHX,-0.335343058,190,173,363
4420,-1.350869376,0.68018326,029-AHY,-0.335343058,271,184,455
4421,-1.350869376,0.68018326,029-AHD,-0.335343058,194,208,402
4422,-1.350869376,0.68018326,029-AHF,-0.335343058,294,229,523
4423,-1.350869376,0.68018326,029-AHG,-0.335343058,239,253,492
4424,-1.350869376,0.68018326,029-AHQ,-0.335343058,299,307,606
4425,-1.350869376,0.68018326,029-AHR,-0.335343058,280,214,494
4426,-1.350869376,0.68018326,029-AHS,-0.335343058,252,223,475
4427,-1.350869376,0.68018326,029-AHU,-0.335343058,428,233,661
4428,-1.350869376,0.68018326,029-AHV,-0.335343058,262,205,467
4429,-1.350869376,0.68018326,029-AHW,-0.335343058,249,195,444
4430,-1.350869376,0.68018326,029-AIA,-0.335343058,328,216,544
4431,-1.350869376,0.68018326,029-AHZ,-0.335343058,299,200,499
4432,-1.350869376,0.68018326,029-AIC,-0.335343058,196,256,452
4433,-1.350869376,0.68018326,029-AIF,-0.335343058,358,243,601
4434,-1.350869376,0.68018326,029-AJA,-0.335343058,179,203,382
4435,-1.350869376,0.68018326,029-AIH,-0.335343058,31,314,345
4436,-1.350869376,0.68018326,029-AIE,-0.335343058,313,226,539
4437,-1.350869376,0.68018326,029-AII,-0.335343058,128,321,449
4438,-1.350869376,0.68018326,029-AID,-0.335343058,299,255,554
4439,-1.350869376,0.68018326,029-AIG,-0.335343058,335,255,590
4440,-1.350869376,0.68018326,029-ST ,-0.335343058,369,213,582
4441,-1.350869376,0.68018326,029-AFD,-0.335343058,433,193,626
4442,-1.350869376,0.68018326,029-AFH,-0.335343058,196,104,300
4443,-1.350869376,0.68018326,029-AFL,-0.335343058,342,188,530
4444,-1.350869376,0.68018326,029-AFQ,-0.335343058,267,151,418
4445,-1.350869376,0.68018326,029-AFN,-0.335343058,63,176,239
4446,-1.350869376,0.68018326,029-AFM,-0.335343058,28,911,939
4447,-1.350869376,0.68018326,029-AFS,-0.335343058,140,489,629
4448,-1.350869376,0.68018326,029-AFI,-0.335343058,418,182,600
4449,-1.350869376,0.68018326,029-AFB,-0.335343058,362,124,486
4450,-1.350869376,0.68018326,029-AFA,-0.335343058,303,160,463
4451,-1.350869376,0.68018326,029-AEY,-0.335343058,106,51,157
4452,-1.350869376,0.68018326,029-AJD,-0.335343058,368,130,498
4453,-1.350869376,0.68018326,029-AIW,-0.335343058,500,91,591
4454,-1.350869376,0.68018326,029-AFF,-0.335343058,414,122,536
4455,-1.350869376,0.68018326,029-AFE,-0.335343058,419,121,540
4456,-1.350869376,0.68018326,029-AFJ,-0.335343058,316,64,380
4457,-1.350869376,0.68018326,029-AFK,-0.335343058,342,208,550
4458,-1.350869376,0.68018326,029-AFG,-0.335343058,219,115,334
4459,-1.350869376,0.68018326,029-AFP,-0.335343058,252,111,363
4460,-1.350869376,0.68018326,029-AFO,-0.335343058,408,168,576
4461,-1.350869376,0.68018326,029-AFR,-0.335343058,144,114,258
4462,-1.350869376,0.68018326,029-AFC,-0.335343058,478,231,709
4463,-1.350869376,0.68018326,029-AEZ,-0.335343058,452,173,625
4464,-1.350869376,0.68018326,029-AIN,-0.335343058,69,631,700
4465,-1.350869376,0.68018326,029-AIK,-0.335343058,38,545,583
4466,-1.350869376,0.68018326,029-AIQ,-0.335343058,53,537,590
4467,-1.350869376,0.68018326,029-AIR,-0.335343058,82,537,619
4468,-1.350869376,0.68018326,029-AIL,-0.335343058,235,183,418
4469,-1.350869376,0.68018326,029-AIO,-0.335343058,164,280,444
4470,-1.350869376,0.68018326,029-AIP,-0.335343058,225,62,287
4471,-1.350869376,0.68018326,029-AIM,-0.335343058,338,108,446
4472,-1.350869376,0.68018326,029-AHJ,-0.335343058,275,109,384
4473,-1.350869376,0.68018326,029-AHH,-0.335343058,426,130,556
4474,-1.350869376,0.68018326,029-AHK,-0.335343058,405,141,546
4475,-1.350869376,0.68018326,029-AHI,-0.335343058,349,112,461
4476,-1.350869376,0.68018326,030-ABA,-0.335343058,384,209,593
4477,-1.350869376,0.68018326,030-ABB,-0.335343058,220,115,335
4478,-1.350869376,0.68018326,030-ABM,-0.335343058,150,206,356
4479,-1.350869376,0.68018326,030-ABO,-0.335343058,260,272,532
4480,-1.350869376,0.68018326,030-AAA,-0.335343058,225,338,563
4481,-1.350869376,0.68018326,030-AAD,-0.335343058,133,191,324
4482,-1.350869376,0.68018326,030-AAG,-0.335343058,140,192,332
4483,-1.350869376,0.68018326,030-AAJ,-0.335343058,200,230,430
4484,-1.350869376,0.68018326,030-AAP,-0.335343058,333,269,602
4485,-1.350869376,0.68018326,030-AAN,-0.335343058,293,320,613
4486,-1.350869376,0.68018326,030-AAX,-0.335343058,258,238,496
4487,-1.350869376,0.68018326,030-AAW,-0.335343058,317,330,647
4488,-1.350869376,0.68018326,030-ABC,-0.335343058,437,257,694
4489,-1.350869376,0.68018326,030-ABG,-0.335343058,327,202,529
4490,-1.350869376,0.68018326,030-ABE,-0.335343058,357,360,717
4491,-1.350869376,0.68018326,030-ABH,-0.335343058,232,160,392
4492,-1.350869376,0.68018326,030-ABI,-0.335343058,251,179,430
4493,-1.350869376,0.68018326,030-ACG,-0.335343058,308,252,560
4494,-1.350869376,0.68018326,030-ACB,-0.335343058,157,129,286
4495,-1.350869376,0.68018326,030-ABL,-0.335343058,279,277,556
4496,-1.350869376,0.68018326,030-ABK,-0.335343058,270,284,554
4497,-1.350869376,0.68018326,030-ABQ,-0.335343058,264,164,428
4498,-1.350869376,0.68018326,030-ABR,-0.335343058,131,112,243
4499,-1.350869376,0.68018326,030-ABS,-0.335343058,283,183,466
4500,-1.350869376,0.68018326,030-ABU,-0.335343058,291,188,479
4501,-1.350869376,0.68018326,030-ACD,-0.335343058,59,72,131
4502,-1.350869376,0.68018326,030-ACA,-0.335343058,335,242,577
4503,-1.350869376,0.68018326,030-ACR,-0.335343058,403,261,664
4504,-1.350869376,0.68018326,030-ACI,-0.335343058,185,249,434
4505,-1.350869376,0.68018326,030-ACE,-0.335343058,429,296,725
4506,-1.350869376,0.68018326,030-ABX,-0.335343058,305,163,468
4507,-1.350869376,0.68018326,030-ACF,-0.335343058,97,108,205
4508,-1.350869376,0.68018326,030-ACK,-0.335343058,241,232,473
4509,-1.350869376,0.68018326,030-ACO,-0.335343058,297,170,467
4510,-1.350869376,0.68018326,030-ACP,-0.335343058,346,175,521
4511,-1.350869376,0.68018326,031-BKA,-0.335343058,186,170,356
4512,-1.350869376,0.68018326,031-AYP,-0.335343058,275,333,608
4513,-1.350869376,0.68018326,031-AYQ,-0.335343058,325,311,636
4514,-1.350869376,0.68018326,031-AYR,-0.335343058,268,270,538
4515,-1.350869376,0.68018326,031-AYS,-0.335343058,350,329,679
4516,-1.350869376,0.68018326,031-AYU,-0.335343058,530,316,846
4517,-1.350869376,0.68018326,031-AYV,-0.335343058,258,111,369
4518,-1.350869376,0.68018326,031-AYW,-0.335343058,274,117,391
4519,-1.350869376,0.68018326,031-AYX,-0.335343058,507,268,775
4520,-1.350869376,0.68018326,031-AYY,-0.335343058,383,228,611
4521,-1.350869376,0.68018326,031-AYZ,-0.335343058,307,173,480
4522,-1.350869376,0.68018326,031-AZA,-0.335343058,349,118,467
4523,-1.350869376,0.68018326,031-AZB,-0.335343058,289,183,472
4524,-1.350869376,0.68018326,031-AZC,-0.335343058,353,97,450
4525,-1.350869376,0.68018326,031-AZD,-0.335343058,452,227,679
4526,-1.350869376,0.68018326,031-AZE,-0.335343058,708,310,1018
4527,-1.350869376,0.68018326,031-AZF,-0.335343058,493,299,792
4528,-1.350869376,0.68018326,031-AZG,-0.335343058,290,157,447
4529,-1.350869376,0.68018326,031-AZH,-0.335343058,285,199,484
4530,-1.350869376,0.68018326,031-AZI,-0.335343058,363,183,546
4531,-1.350869376,0.68018326,031-AZJ,-0.335343058,277,166,443
4532,-1.350869376,0.68018326,031-AZK,-0.335343058,306,135,441
4533,-1.350869376,0.68018326,031-AZL,-0.335343058,323,199,522
4534,-1.350869376,0.68018326,031-AZM,-0.335343058,534,203,737
4535,-1.350869376,0.68018326,031-AZN,-0.335343058,349,155,504
4536,-1.350869376,0.68018326,031-AZO,-0.335343058,189,185,374
4537,-1.350869376,0.68018326,031-AZP,-0.335343058,290,219,509
4538,-1.350869376,0.68018326,031-AZQ,-0.335343058,487,309,796
4539,-1.350869376,0.68018326,031-AZR,-0.335343058,373,164,537
4540,-1.350869376,0.68018326,031-AZS,-0.335343058,392,222,614
4541,-1.350869376,0.68018326,031-AZT,-0.335343058,244,154,398
4542,-1.350869376,0.68018326,031-AZU,-0.335343058,324,203,527
4543,-1.350869376,0.68018326,031-AZV,-0.335343058,316,189,505
4544,-1.350869376,0.68018326,031-AZW,-0.335343058,221,123,344
4545,-1.350869376,0.68018326,031-AZX,-0.335343058,249,173,422
4546,-1.350869376,0.68018326,031-AZY,-0.335343058,192,148,340
4547,-1.350869376,0.68018326,031-AZZ,-0.335343058,363,173,536
4548,-1.350869376,0.68018326,031-BAA,-0.335343058,364,221,585
4549,-1.350869376,0.68018326,031-BAB,-0.335343058,573,281,854
4550,-1.350869376,0.68018326,031-BAC,-0.335343058,374,204,578
4551,-1.350869376,0.68018326,031-BAD,-0.335343058,266,177,443
4552,-1.350869376,0.68018326,031-BAE,-0.335343058,364,202,566
4553,-1.350869376,0.68018326,031-BAF,-0.335343058,417,238,655
4554,-1.350869376,0.68018326,031-BAG,-0.335343058,408,187,595
4555,-1.350869376,0.68018326,031-BAH,-0.335343058,556,287,843
4556,-1.350869376,0.68018326,031-BAI,-0.335343058,426,242,668
4557,-1.350869376,0.68018326,031-BAJ,-0.335343058,327,227,554
4558,-1.350869376,0.68018326,031-BAK,-0.335343058,314,199,513
4559,-1.350869376,0.68018326,031-BAL,-0.335343058,296,154,450
4560,-1.350869376,0.68018326,031-BAM,-0.335343058,245,122,367
4561,-1.350869376,0.68018326,031-BAO,-0.335343058,345,214,559
4562,-1.350869376,0.68018326,031-BAQ,-0.335343058,298,117,415
4563,-1.350869376,0.68018326,031-BAS,-0.335343058,207,108,315
4564,-1.350869376,0.68018326,031-BAT,-0.335343058,197,137,334
4565,-1.350869376,0.68018326,031-AAA,-0.335343058,338,208,546
4566,-1.350869376,0.68018326,031-AAB,-0.335343058,366,263,629
4567,-1.350869376,0.68018326,031-AAC,-0.335343058,111,124,235
4568,-1.350869376,0.68018326,031-AAD,-0.335343058,336,220,556
4569,-1.350869376,0.68018326,031-AAE,-0.335343058,316,197,513
4570,-1.350869376,0.68018326,031-AAF,-0.335343058,115,321,436
4571,-1.350869376,0.68018326,031-AAG,-0.335343058,384,318,702
4572,-1.350869376,0.68018326,031-AAH,-0.335343058,189,184,373
4573,-1.350869376,0.68018326,031-AAI,-0.335343058,207,173,380
4574,-1.350869376,0.68018326,031-AAJ,-0.335343058,182,169,351
4575,-1.350869376,0.68018326,031-AAK,-0.335343058,117,170,287
4576,-1.350869376,0.68018326,031-AAL,-0.335343058,233,234,467
4577,-1.350869376,0.68018326,031-AAM,-0.335343058,483,436,919
4578,-1.350869376,0.68018326,031-AAN,-0.335343058,284,300,584
4579,-1.350869376,0.68018326,031-AAP,-0.335343058,160,166,326
4580,-1.350869376,0.68018326,031-AAQ,-0.335343058,186,121,307
4581,-1.350869376,0.68018326,031-AAR,-0.335343058,207,133,340
4582,-1.350869376,0.68018326,031-AAS,-0.335343058,188,132,320
4583,-1.350869376,0.68018326,031-AAT,-0.335343058,193,177,370
4584,-1.350869376,0.68018326,031-AAU,-0.335343058,208,138,346
4585,-1.350869376,0.68018326,031-AAV,-0.335343058,179,113,292
4586,-1.350869376,0.68018326,031-AAW,-0.335343058,103,106,209
4587,-1.350869376,0.68018326,031-AAX,-0.335343058,168,103,271
4588,-1.350869376,0.68018326,031-AAY,-0.335343058,235,132,367
4589,-1.350869376,0.68018326,031-AAZ,-0.335343058,173,157,330
4590,-1.350869376,0.68018326,031-ABA,-0.335343058,210,155,365
4591,-1.350869376,0.68018326,031-ABB,-0.335343058,132,79,211
4592,-1.350869376,0.68018326,031-ABC,-0.335343058,209,202,411
4593,-1.350869376,0.68018326,031-ABD,-0.335343058,157,194,351
4594,-1.350869376,0.68018326,031-ABE,-0.335343058,141,253,394
4595,-1.350869376,0.68018326,031-ABF,-0.335343058,151,192,343
4596,-1.350869376,0.68018326,031-ABG,-0.335343058,192,154,346
4597,-1.350869376,0.68018326,031-ABH,-0.335343058,210,236,446
4598,-1.350869376,0.68018326,031-ABI,-0.335343058,228,248,476
4599,-1.350869376,0.68018326,031-ABJ,-0.335343058,96,97,193
4600,-1.350869376,0.68018326,031-ABK,-0.335343058,326,436,762
4601,-1.350869376,0.68018326,031-ABL,-0.335343058,203,218,421
4602,-1.350869376,0.68018326,031-ABM,-0.335343058,213,200,413
4603,-1.350869376,0.68018326,031-ABN,-0.335343058,420,370,790
4604,-1.350869376,0.68018326,031-ABO,-0.335343058,209,200,409
4605,-1.350869376,0.68018326,031-ABP,-0.335343058,135,211,346
4606,-1.350869376,0.68018326,031-ABQ,-0.335343058,56,46,102
4607,-1.350869376,0.68018326,031-ABR,-0.335343058,457,395,852
4608,-1.350869376,0.68018326,031-ABS,-0.335343058,229,215,444
4609,-1.350869376,0.68018326,031-ABT,-0.335343058,292,202,494
4610,-1.350869376,0.68018326,031-ABU,-0.335343058,205,156,361
4611,-1.350869376,0.68018326,031-ABV,-0.335343058,103,188,291
4612,-1.350869376,0.68018326,031-AGY,-0.335343058,146,160,306
4613,-1.350869376,0.68018326,031-AGZ,-0.335343058,69,390,459
4614,-1.350869376,0.68018326,031-AHA,-0.335343058,67,447,514
4615,-1.350869376,0.68018326,031-AHB,-0.335343058,12,339,351
4616,-1.350869376,0.68018326,031-AHC,-0.335343058,14,303,317
4617,-1.350869376,0.68018326,031-AHD,-0.335343058,12,226,238
4618,-1.350869376,0.68018326,031-AHE,-0.335343058,89,319,408
4619,-1.350869376,0.68018326,031-AHF,-0.335343058,93,441,534
4620,-1.350869376,0.68018326,031-AHG,-0.335343058,50,283,333
4621,-1.350869376,0.68018326,031-AHH,-0.335343058,41,322,363
4622,-1.350869376,0.68018326,031-AHI,-0.335343058,79,267,346
4623,-1.350869376,0.68018326,031-AHJ,-0.335343058,42,195,237
4624,-1.350869376,0.68018326,031-AHK,-0.335343058,65,285,350
4625,-1.350869376,0.68018326,031-AHL,-0.335343058,65,291,356
4626,-1.350869376,0.68018326,031-AHO,-0.335343058,80,159,239
4627,-1.350869376,0.68018326,031-AHP,-0.335343058,120,435,555
4628,-1.350869376,0.68018326,031-AHQ,-0.335343058,28,344,372
4629,-1.350869376,0.68018326,031-AHR,-0.335343058,24,170,194
4630,-1.350869376,0.68018326,031-AHS,-0.335343058,34,248,282
4631,-1.350869376,0.68018326,031-AHT,-0.335343058,99,390,489
4632,-1.350869376,0.68018326,031-AHU,-0.335343058,45,212,257
4633,-1.350869376,0.68018326,031-AHV,-0.335343058,178,354,532
4634,-1.350869376,0.68018326,031-AHW,-0.335343058,33,252,285
4635,-1.350869376,0.68018326,031-AHX,-0.335343058,27,188,215
4636,-1.350869376,0.68018326,031-AHY,-0.335343058,75,399,474
4637,-1.350869376,0.68018326,031-AIA,-0.335343058,2,330,332
4638,-1.350869376,0.68018326,031-AIB,-0.335343058,107,374,481
4639,-1.350869376,0.68018326,031-AIC,-0.335343058,3,461,464
4640,-1.350869376,0.68018326,031-AID,-0.335343058,13,464,477
4641,-1.350869376,0.68018326,031-AIE,-0.335343058,1,324,325
4642,-1.350869376,0.68018326,031-AIF,-0.335343058,6,322,328
4643,-1.350869376,0.68018326,031-AIG,-0.335343058,4,303,307
4644,-1.350869376,0.68018326,031-AIH,-0.335343058,2,318,320
4645,-1.350869376,0.68018326,031-AII,-0.335343058,21,260,281
4646,-1.350869376,0.68018326,031-AIJ,-0.335343058,35,441,476
4647,-1.350869376,0.68018326,031-AIK,-0.335343058,5,260,265
4648,-1.350869376,0.68018326,031-AIL,-0.335343058,2,415,417
4649,-1.350869376,0.68018326,031-AIM,-0.335343058,25,306,331
4650,-1.350869376,0.68018326,031-AIN,-0.335343058,76,452,528
4651,-1.350869376,0.68018326,031-AIO,-0.335343058,65,446,511
4652,-1.350869376,0.68018326,031-AIP,-0.335343058,15,433,448
4653,-1.350869376,0.68018326,031-AIS,-0.335343058,101,345,446
4654,-1.350869376,0.68018326,031-AIT,-0.335343058,11,506,517
4655,-1.350869376,0.68018326,031-AIU,-0.335343058,143,242,385
4656,-1.350869376,0.68018326,031-AIV,-0.335343058,88,555,643
4657,-1.350869376,0.68018326,031-AIW,-0.335343058,7,476,483
4658,-1.350869376,0.68018326,031-AIX,-0.335343058,92,741,833
4659,-1.350869376,0.68018326,031-AIY,-0.335343058,135,315,450
4660,-1.350869376,0.68018326,031-AIZ,-0.335343058,124,370,494
4661,-1.350869376,0.68018326,031-AJA,-0.335343058,131,337,468
4662,-1.350869376,0.68018326,031-AJB,-0.335343058,91,288,379
4663,-1.350869376,0.68018326,031-AJC,-0.335343058,88,370,458
4664,-1.350869376,0.68018326,031-AJD,-0.335343058,103,343,446
4665,-1.350869376,0.68018326,031-AJE,-0.335343058,39,439,478
4666,-1.350869376,0.68018326,031-AJF,-0.335343058,59,307,366
4667,-1.350869376,0.68018326,031-AJG,-0.335343058,100,353,453
4668,-1.350869376,0.68018326,031-AJH,-0.335343058,72,433,505
4669,-1.350869376,0.68018326,031-AJN,-0.335343058,107,682,789
4670,-1.350869376,0.68018326,031-AJO,-0.335343058,69,344,413
4671,-1.350869376,0.68018326,031-AJP,-0.335343058,6,766,772
4672,-1.350869376,0.68018326,031-AJQ,-0.335343058,14,631,645
4673,-1.350869376,0.68018326,031-AJR,-0.335343058,98,582,680
4674,-1.350869376,0.68018326,031-AJS,-0.335343058,122,343,465
4675,-1.350869376,0.68018326,031-AJT,-0.335343058,81,418,499
4676,-1.350869376,0.68018326,031-AJU,-0.335343058,60,340,400
4677,-1.350869376,0.68018326,031-AJV,-0.335343058,135,584,719
4678,-1.350869376,0.68018326,031-AJW,-0.335343058,77,346,423
4679,-1.350869376,0.68018326,031-AJX,-0.335343058,149,324,473
4680,-1.350869376,0.68018326,031-AJY,-0.335343058,2,266,268
4681,-1.350869376,0.68018326,031-AJZ,-0.335343058,6,366,372
4682,-1.350869376,0.68018326,031-AKA,-0.335343058,57,357,414
4683,-1.350869376,0.68018326,031-AKB,-0.335343058,60,363,423
4684,-1.350869376,0.68018326,031-AKJ,-0.335343058,54,539,593
4685,-1.350869376,0.68018326,031-AKK,-0.335343058,8,649,657
4686,-1.350869376,0.68018326,031-AKL,-0.335343058,20,312,332
4687,-1.350869376,0.68018326,031-AKM,-0.335343058,1,157,158
4688,-1.350869376,0.68018326,031-AKN,-0.335343058,21,193,214
4689,-1.350869376,0.68018326,031-AKO,-0.335343058,40,523,563
4690,-1.350869376,0.68018326,031-AKP,-0.335343058,3,370,373
4691,-1.350869376,0.68018326,031-AKS,-0.335343058,3,261,264
4692,-1.350869376,0.68018326,031-AKT,-0.335343058,5,351,356
4693,-1.350869376,0.68018326,031-AKU,-0.335343058,11,362,373
4694,-1.350869376,0.68018326,031-AKW,-0.335343058,393,231,624
4695,-1.350869376,0.68018326,031-AKX,-0.335343058,275,143,418
4696,-1.350869376,0.68018326,031-AKY,-0.335343058,228,148,376
4697,-1.350869376,0.68018326,031-AKZ,-0.335343058,283,146,429
4698,-1.350869376,0.68018326,031-ALA,-0.335343058,214,269,483
4699,-1.350869376,0.68018326,031-ALB,-0.335343058,75,110,185
4700,-1.350869376,0.68018326,031-ABY,-0.335343058,86,323,409
4701,-1.350869376,0.68018326,031-ACA,-0.335343058,8,191,199
4702,-1.350869376,0.68018326,031-ACB,-0.335343058,15,310,325
4703,-1.350869376,0.68018326,031-ACC,-0.335343058,145,394,539
4704,-1.350869376,0.68018326,031-ACD,-0.335343058,16,591,607
4705,-1.350869376,0.68018326,031-ACE,-0.335343058,18,359,377
4706,-1.350869376,0.68018326,031-ACF,-0.335343058,57,383,440
4707,-1.350869376,0.68018326,031-ACG,-0.335343058,71,331,402
4708,-1.350869376,0.68018326,031-ACH,-0.335343058,94,312,406
4709,-1.350869376,0.68018326,031-ACI,-0.335343058,95,184,279
4710,-1.350869376,0.68018326,031-ACJ,-0.335343058,193,305,498
4711,-1.350869376,0.68018326,031-ACK,-0.335343058,159,158,317
4712,-1.350869376,0.68018326,031-ACL,-0.335343058,184,256,440
4713,-1.350869376,0.68018326,031-ACM,-0.335343058,155,183,338
4714,-1.350869376,0.68018326,031-ACN,-0.335343058,139,232,371
4715,-1.350869376,0.68018326,031-ACO,-0.335343058,71,214,285
4716,-1.350869376,0.68018326,031-ACP,-0.335343058,179,210,389
4717,-1.350869376,0.68018326,031-ACQ,-0.335343058,62,183,245
4718,-1.350869376,0.68018326,031-ACR,-0.335343058,6,30,36
4719,-1.350869376,0.68018326,031-ACS,-0.335343058,154,510,664
4720,-1.350869376,0.68018326,031-ACT,-0.335343058,115,312,427
4721,-1.350869376,0.68018326,031-ACU,-0.335343058,100,168,268
4722,-1.350869376,0.68018326,031-ACV,-0.335343058,56,316,372
4723,-1.350869376,0.68018326,031-ACW,-0.335343058,377,269,646
4724,-1.350869376,0.68018326,031-ALE,-0.335343058,66,270,336
4725,-1.350869376,0.68018326,031-ALF,-0.335343058,111,205,316
4726,-1.350869376,0.68018326,031-ALG,-0.335343058,147,244,391
4727,-1.350869376,0.68018326,031-ALH,-0.335343058,85,208,293
4728,-1.350869376,0.68018326,031-ALI,-0.335343058,197,390,587
4729,-1.350869376,0.68018326,031-ALJ,-0.335343058,220,477,697
4730,-1.350869376,0.68018326,031-ALK,-0.335343058,62,244,306
4731,-1.350869376,0.68018326,031-ALL,-0.335343058,145,347,492
4732,-1.350869376,0.68018326,031-ALM,-0.335343058,107,193,300
4733,-1.350869376,0.68018326,031-ALR,-0.335343058,66,314,380
4734,-1.350869376,0.68018326,031-ALS,-0.335343058,43,225,268
4735,-1.350869376,0.68018326,031-ALT,-0.335343058,60,303,363
4736,-1.350869376,0.68018326,031-ALU,-0.335343058,41,220,261
4737,-1.350869376,0.68018326,031-ALV,-0.335343058,5,314,319
4738,-1.350869376,0.68018326,031-ALW,-0.335343058,3,162,165
4739,-1.350869376,0.68018326,031-ALX,-0.335343058,101,233,334
4740,-1.350869376,0.68018326,031-ALY,-0.335343058,46,172,218
4741,-1.350869376,0.68018326,031-ALZ,-0.335343058,8,174,182
4742,-1.350869376,0.68018326,031-AMA,-0.335343058,95,212,307
4743,-1.350869376,0.68018326,031-AMB,-0.335343058,74,358,432
4744,-1.350869376,0.68018326,031-AMC,-0.335343058,89,294,383
4745,-1.350869376,0.68018326,031-AMD,-0.335343058,1,243,244
4746,-1.350869376,0.68018326,031-AME,-0.335343058,9,509,518
4747,-1.350869376,0.68018326,031-AMF,-0.335343058,50,369,419
4748,-1.350869376,0.68018326,031-BPY,-0.335343058,8,498,506
4749,-1.350869376,0.68018326,031-AMG,-0.335343058,97,275,372
4750,-1.350869376,0.68018326,031-AMH,-0.335343058,222,184,406
4751,-1.350869376,0.68018326,031-AMI,-0.335343058,69,518,587
4752,-1.350869376,0.68018326,031-AMJ,-0.335343058,41,388,429
4753,-1.350869376,0.68018326,031-AMK,-0.335343058,50,312,362
4754,-1.350869376,0.68018326,031-AMM,-0.335343058,147,797,944
4755,-1.350869376,0.68018326,031-AMO,-0.335343058,20,805,825
4756,-1.350869376,0.68018326,031-AMQ,-0.335343058,132,352,484
4757,-1.350869376,0.68018326,031-AMS,-0.335343058,62,391,453
4758,-1.350869376,0.68018326,031-AMU,-0.335343058,222,310,532
4759,-1.350869376,0.68018326,031-AMW,-0.335343058,214,405,619
4760,-1.350869376,0.68018326,031-AMY,-0.335343058,88,395,483
4761,-1.350869376,0.68018326,031-ANA,-0.335343058,128,281,409
4762,-1.350869376,0.68018326,031-ANB,-0.335343058,116,255,371
4763,-1.350869376,0.68018326,031-ANC,-0.335343058,115,265,380
4764,-1.350869376,0.68018326,031-AND,-0.335343058,279,645,924
4765,-1.350869376,0.68018326,031-ANE,-0.335343058,34,371,405
4766,-1.350869376,0.68018326,031-ANF,-0.335343058,206,462,668
4767,-1.350869376,0.68018326,031-ANG,-0.335343058,98,386,484
4768,-1.350869376,0.68018326,031-ANH,-0.335343058,99,366,465
4769,-1.350869376,0.68018326,031-ANI,-0.335343058,62,357,419
4770,-1.350869376,0.68018326,031-ANJ,-0.335343058,11,498,509
4771,-1.350869376,0.68018326,031-ANK,-0.335343058,54,417,471
4772,-1.350869376,0.68018326,031-ANL,-0.335343058,41,372,413
4773,-1.350869376,0.68018326,031-ANM,-0.335343058,80,171,251
4774,-1.350869376,0.68018326,031-ANN,-0.335343058,25,268,293
4775,-1.350869376,0.68018326,031-ANO,-0.335343058,128,283,411
4776,-1.350869376,0.68018326,031-ANP,-0.335343058,210,128,338
4777,-1.350869376,0.68018326,031-ANQ,-0.335343058,38,423,461
4778,-1.350869376,0.68018326,031-ANR,-0.335343058,93,365,458
4779,-1.350869376,0.68018326,031-ANS,-0.335343058,15,617,632
4780,-1.350869376,0.68018326,031-ANT,-0.335343058,217,231,448
4781,-1.350869376,0.68018326,031-ANU,-0.335343058,29,243,272
4782,-1.350869376,0.68018326,031-ANV,-0.335343058,65,384,449
4783,-1.350869376,0.68018326,031-ANW,-0.335343058,82,195,277
4784,-1.350869376,0.68018326,031-ANX,-0.335343058,166,334,500
4785,-1.350869376,0.68018326,031-ANY,-0.335343058,43,92,135
4786,-1.350869376,0.68018326,031-ANZ,-0.335343058,15,404,419
4787,-1.350869376,0.68018326,031-AOA,-0.335343058,39,192,231
4788,-1.350869376,0.68018326,031-AOB,-0.335343058,170,201,371
4789,-1.350869376,0.68018326,031-AOC,-0.335343058,208,228,436
4790,-1.350869376,0.68018326,031-AOD,-0.335343058,3,300,303
4791,-1.350869376,0.68018326,031-AOE,-0.335343058,0,352,352
4792,-1.350869376,0.68018326,031-AOF,-0.335343058,30,204,234
4793,-1.350869376,0.68018326,031-AOG,-0.335343058,97,298,395
4794,-1.350869376,0.68018326,031-AOH,-0.335343058,151,178,329
4795,-1.350869376,0.68018326,031-AOI,-0.335343058,56,624,680
4796,-1.350869376,0.68018326,031-AOK,-0.335343058,161,471,632
4797,-1.350869376,0.68018326,031-AOM,-0.335343058,103,189,292
4798,-1.350869376,0.68018326,031-AON,-0.335343058,142,271,413
4799,-1.350869376,0.68018326,031-AOO,-0.335343058,533,344,877
4800,-1.350869376,0.68018326,031-AOP,-0.335343058,190,210,400
4801,-1.350869376,0.68018326,031-AOQ,-0.335343058,73,372,445
4802,-1.350869376,0.68018326,031-AOR,-0.335343058,164,124,288
4803,-1.350869376,0.68018326,031-AOS,-0.335343058,408,332,740
4804,-1.350869376,0.68018326,031-AOT,-0.335343058,270,482,752
4805,-1.350869376,0.68018326,031-AOU,-0.335343058,503,356,859
4806,-1.350869376,0.68018326,031-AOV,-0.335343058,229,428,657
4807,-1.350869376,0.68018326,031-AOW,-0.335343058,158,208,366
4808,-1.350869376,0.68018326,031-AOX,-0.335343058,281,338,619
4809,-1.350869376,0.68018326,031-AOY,-0.335343058,157,206,363
4810,-1.350869376,0.68018326,031-AOZ,-0.335343058,181,193,374
4811,-1.350869376,0.68018326,031-APK,-0.335343058,240,244,484
4812,-1.350869376,0.68018326,031-APL,-0.335343058,174,232,406
4813,-1.350869376,0.68018326,031-APM,-0.335343058,63,138,201
4814,-1.350869376,0.68018326,031-APN,-0.335343058,348,480,828
4815,-1.350869376,0.68018326,031-APO,-0.335343058,196,257,453
4816,-1.350869376,0.68018326,031-APQ,-0.335343058,77,669,746
4817,-1.350869376,0.68018326,031-APS,-0.335343058,29,351,380
4818,-1.350869376,0.68018326,031-APU,-0.335343058,192,271,463
4819,-1.350869376,0.68018326,031-APW,-0.335343058,24,324,348
4820,-1.350869376,0.68018326,031-APY,-0.335343058,6,611,617
4821,-1.350869376,0.68018326,031-AQA,-0.335343058,183,203,386
4822,-1.350869376,0.68018326,031-AQC,-0.335343058,66,372,438
4823,-1.350869376,0.68018326,031-AQE,-0.335343058,127,408,535
4824,-1.350869376,0.68018326,031-AQG,-0.335343058,248,259,507
4825,-1.350869376,0.68018326,031-AQI,-0.335343058,73,421,494
4826,-1.350869376,0.68018326,031-AQK,-0.335343058,181,587,768
4827,-1.350869376,0.68018326,031-AQM,-0.335343058,69,387,456
4828,-1.350869376,0.68018326,031-AQO,-0.335343058,150,321,471
4829,-1.350869376,0.68018326,031-AQP,-0.335343058,72,367,439
4830,-1.350869376,0.68018326,031-AQQ,-0.335343058,86,450,536
4831,-1.350869376,0.68018326,031-AQR,-0.335343058,361,318,679
4832,-1.350869376,0.68018326,031-AQS,-0.335343058,179,179,358
4833,-1.350869376,0.68018326,031-AQT,-0.335343058,23,331,354
4834,-1.350869376,0.68018326,031-AQU,-0.335343058,190,212,402
4835,-1.350869376,0.68018326,031-AQV,-0.335343058,171,176,347
4836,-1.350869376,0.68018326,031-AQW,-0.335343058,45,436,481
4837,-1.350869376,0.68018326,031-AQX,-0.335343058,20,242,262
4838,-1.350869376,0.68018326,031-AQY,-0.335343058,190,232,422
4839,-1.350869376,0.68018326,031-ACZ,-0.335343058,2,467,469
4840,-1.350869376,0.68018326,031-ADA,-0.335343058,83,367,450
4841,-1.350869376,0.68018326,031-ADB,-0.335343058,53,357,410
4842,-1.350869376,0.68018326,031-ADC,-0.335343058,5,385,390
4843,-1.350869376,0.68018326,031-ADD,-0.335343058,5,458,463
4844,-1.350869376,0.68018326,031-ADE,-0.335343058,79,345,424
4845,-1.350869376,0.68018326,031-ADF,-0.335343058,4,390,394
4846,-1.350869376,0.68018326,031-ADG,-0.335343058,113,319,432
4847,-1.350869376,0.68018326,031-ADH,-0.335343058,3,399,402
4848,-1.350869376,0.68018326,031-ADI,-0.335343058,5,427,432
4849,-1.350869376,0.68018326,031-ADJ,-0.335343058,14,336,350
4850,-1.350869376,0.68018326,031-ADP,-0.335343058,122,186,308
4851,-1.350869376,0.68018326,031-ADQ,-0.335343058,166,234,400
4852,-1.350869376,0.68018326,031-ADR,-0.335343058,109,212,321
4853,-1.350869376,0.68018326,031-ADS,-0.335343058,172,218,390
4854,-1.350869376,0.68018326,031-ADT,-0.335343058,196,250,446
4855,-1.350869376,0.68018326,031-ADU,-0.335343058,157,204,361
4856,-1.350869376,0.68018326,031-ADV,-0.335343058,163,240,403
4857,-1.350869376,0.68018326,031-ADW,-0.335343058,148,200,348
4858,-1.350869376,0.68018326,031-ADX,-0.335343058,190,223,413
4859,-1.350869376,0.68018326,031-ADY,-0.335343058,110,166,276
4860,-1.350869376,0.68018326,031-ADZ,-0.335343058,198,253,451
4861,-1.350869376,0.68018326,031-AEA,-0.335343058,172,205,377
4862,-1.350869376,0.68018326,031-AEB,-0.335343058,294,243,537
4863,-1.350869376,0.68018326,031-AEC,-0.335343058,179,236,415
4864,-1.350869376,0.68018326,031-AED,-0.335343058,196,214,410
4865,-1.350869376,0.68018326,031-AEE,-0.335343058,100,197,297
4866,-1.350869376,0.68018326,031-BPU,-0.335343058,138,244,382
4867,-1.350869376,0.68018326,031-AEF,-0.335343058,74,101,175
4868,-1.350869376,0.68018326,031-AEG,-0.335343058,216,228,444
4869,-1.350869376,0.68018326,031-AEH,-0.335343058,184,556,740
4870,-1.350869376,0.68018326,031-AEI,-0.335343058,498,494,992
4871,-1.350869376,0.68018326,031-AEJ,-0.335343058,94,314,408
4872,-1.350869376,0.68018326,031-AEK,-0.335343058,135,200,335
4873,-1.350869376,0.68018326,031-AEL,-0.335343058,207,203,410
4874,-1.350869376,0.68018326,031-AEM,-0.335343058,364,395,759
4875,-1.350869376,0.68018326,031-AEN,-0.335343058,303,302,605
4876,-1.350869376,0.68018326,031-AEO,-0.335343058,352,478,830
4877,-1.350869376,0.68018326,031-AEP,-0.335343058,156,246,402
4878,-1.350869376,0.68018326,031-AEQ,-0.335343058,94,158,252
4879,-1.350869376,0.68018326,031-AER,-0.335343058,279,265,544
4880,-1.350869376,0.68018326,031-AES,-0.335343058,114,87,201
4881,-1.350869376,0.68018326,031-AET,-0.335343058,146,129,275
4882,-1.350869376,0.68018326,031-AFA,-0.335343058,93,280,373
4883,-1.350869376,0.68018326,031-AFB,-0.335343058,171,309,480
4884,-1.350869376,0.68018326,031-AFC,-0.335343058,20,353,373
4885,-1.350869376,0.68018326,031-AFD,-0.335343058,14,407,421
4886,-1.350869376,0.68018326,031-AFE,-0.335343058,148,411,559
4887,-1.350869376,0.68018326,031-BPV,-0.335343058,79,414,493
4888,-1.350869376,0.68018326,031-AFF,-0.335343058,20,524,544
4889,-1.350869376,0.68018326,031-AFG,-0.335343058,17,492,509
4890,-1.350869376,0.68018326,031-AFH,-0.335343058,13,743,756
4891,-1.350869376,0.68018326,031-AFI,-0.335343058,16,493,509
4892,-1.350869376,0.68018326,031-AFJ,-0.335343058,4,505,509
4893,-1.350869376,0.68018326,031-AFK,-0.335343058,9,706,715
4894,-1.350869376,0.68018326,031-AFL,-0.335343058,25,490,515
4895,-1.350869376,0.68018326,031-AFM,-0.335343058,6,422,428
4896,-1.350869376,0.68018326,031-AFN,-0.335343058,29,466,495
4897,-1.350869376,0.68018326,031-AFO,-0.335343058,22,419,441
4898,-1.350869376,0.68018326,031-AFP,-0.335343058,14,378,392
4899,-1.350869376,0.68018326,031-AFQ,-0.335343058,7,454,461
4900,-1.350869376,0.68018326,031-AFR,-0.335343058,9,421,430
4901,-1.350869376,0.68018326,031-AFS,-0.335343058,45,429,474
4902,-1.350869376,0.68018326,031-AFT,-0.335343058,16,419,435
4903,-1.350869376,0.68018326,031-AFU,-0.335343058,6,497,503
4904,-1.350869376,0.68018326,031-AGD,-0.335343058,13,382,395
4905,-1.350869376,0.68018326,031-AGE,-0.335343058,15,344,359
4906,-1.350869376,0.68018326,031-AGF,-0.335343058,147,180,327
4907,-1.350869376,0.68018326,031-AGG,-0.335343058,10,438,448
4908,-1.350869376,0.68018326,031-AGH,-0.335343058,105,319,424
4909,-1.350869376,0.68018326,031-AGI,-0.335343058,4,328,332
4910,-1.350869376,0.68018326,031-AGJ,-0.335343058,266,237,503
4911,-1.350869376,0.68018326,031-AGK,-0.335343058,136,198,334
4912,-1.350869376,0.68018326,031-AGL,-0.335343058,48,354,402
4913,-1.350869376,0.68018326,031-AGN,-0.335343058,2,229,231
4914,-1.350869376,0.68018326,031-AGO,-0.335343058,79,216,295
4915,-1.350869376,0.68018326,031-AGP,-0.335343058,2,456,458
4916,-1.350869376,0.68018326,031-AGQ,-0.335343058,19,312,331
4917,-1.350869376,0.68018326,031-AGR,-0.335343058,15,375,390
4918,-1.350869376,0.68018326,031-AGS,-0.335343058,2,375,377
4919,-1.350869376,0.68018326,031-AGT,-0.335343058,1,283,284
4920,-1.350869376,0.68018326,031-AGU,-0.335343058,17,381,398
4921,-1.350869376,0.68018326,031-AGV,-0.335343058,41,192,233
4922,-1.350869376,0.68018326,031-AGW,-0.335343058,64,196,260
4923,-1.350869376,0.68018326,031-BKB,-0.335343058,323,186,509
4924,-1.350869376,0.68018326,031-BKC,-0.335343058,676,200,876
4925,-1.350869376,0.68018326,031-BAU,-0.335343058,403,141,544
4926,-1.350869376,0.68018326,031-BAV,-0.335343058,292,71,363
4927,-1.350869376,0.68018326,031-BAX,-0.335343058,427,389,816
4928,-1.350869376,0.68018326,031-BAY,-0.335343058,373,173,546
4929,-1.350869376,0.68018326,031-BBA,-0.335343058,460,457,917
4930,-1.350869376,0.68018326,031-BBB,-0.335343058,431,134,565
4931,-1.350869376,0.68018326,031-BBD,-0.335343058,324,380,704
4932,-1.350869376,0.68018326,031-BBE,-0.335343058,98,553,651
4933,-1.350869376,0.68018326,031-BBG,-0.335343058,367,93,460
4934,-1.350869376,0.68018326,031-BBH,-0.335343058,223,148,371
4935,-1.350869376,0.68018326,031-BBJ,-0.335343058,711,248,959
4936,-1.350869376,0.68018326,031-BBK,-0.335343058,176,303,479
4937,-1.350869376,0.68018326,031-BBM,-0.335343058,358,79,437
4938,-1.350869376,0.68018326,031-BBN,-0.335343058,448,448,896
4939,-1.350869376,0.68018326,031-BBP,-0.335343058,314,125,439
4940,-1.350869376,0.68018326,031-BBQ,-0.335343058,309,396,705
4941,-1.350869376,0.68018326,031-BBS,-0.335343058,613,175,788
4942,-1.350869376,0.68018326,031-BBT,-0.335343058,254,149,403
4943,-1.350869376,0.68018326,031-BBV,-0.335343058,615,356,971
4944,-1.350869376,0.68018326,031-BBW,-0.335343058,284,117,401
4945,-1.350869376,0.68018326,031-BBY,-0.335343058,404,242,646
4946,-1.350869376,0.68018326,031-BBZ,-0.335343058,192,198,390
4947,-1.350869376,0.68018326,031-BCB,-0.335343058,800,244,1044
4948,-1.350869376,0.68018326,031-BCC,-0.335343058,290,252,542
4949,-1.350869376,0.68018326,031-BCE,-0.335343058,413,336,749
4950,-1.350869376,0.68018326,031-BCF,-0.335343058,534,359,893
4951,-1.350869376,0.68018326,031-BCG,-0.335343058,529,216,745
4952,-1.350869376,0.68018326,031-BCH,-0.335343058,189,261,450
4953,-1.350869376,0.68018326,031-BCI,-0.335343058,312,111,423
4954,-1.350869376,0.68018326,031-BCJ,-0.335343058,341,225,566
4955,-1.350869376,0.68018326,031-BCK,-0.335343058,229,180,409
4956,-1.350869376,0.68018326,031-BCL,-0.335343058,530,180,710
4957,-1.350869376,0.68018326,031-BCM,-0.335343058,828,209,1037
4958,-1.350869376,0.68018326,031-BCN,-0.335343058,475,102,577
4959,-1.350869376,0.68018326,031-BCO,-0.335343058,491,349,840
4960,-1.350869376,0.68018326,031-BCP,-0.335343058,176,398,574
4961,-1.350869376,0.68018326,031-BCQ,-0.335343058,522,232,754
4962,-1.350869376,0.68018326,031-BCR,-0.335343058,261,524,785
4963,-1.350869376,0.68018326,031-BCS,-0.335343058,213,205,418
4964,-1.350869376,0.68018326,031-BCT,-0.335343058,259,105,364
4965,-1.350869376,0.68018326,031-BCU,-0.335343058,424,365,789
4966,-1.350869376,0.68018326,031-BCV,-0.335343058,434,545,979
4967,-1.350869376,0.68018326,031-BCW,-0.335343058,455,337,792
4968,-1.350869376,0.68018326,031-BCX,-0.335343058,319,90,409
4969,-1.350869376,0.68018326,031-BCY,-0.335343058,367,109,476
4970,-1.350869376,0.68018326,031-BDA,-0.335343058,452,322,774
4971,-1.350869376,0.68018326,031-BDC,-0.335343058,228,152,380
4972,-1.350869376,0.68018326,031-BDE,-0.335343058,213,254,467
4973,-1.350869376,0.68018326,031-BDG,-0.335343058,50,81,131
4974,-1.350869376,0.68018326,031-BDH,-0.335343058,95,174,269
4975,-1.350869376,0.68018326,031-BDI,-0.335343058,141,208,349
4976,-1.350869376,0.68018326,031-BDJ,-0.335343058,15,405,420
4977,-1.350869376,0.68018326,031-BDK,-0.335343058,89,174,263
4978,-1.350869376,0.68018326,031-BDL,-0.335343058,164,251,415
4979,-1.350869376,0.68018326,031-BDM,-0.335343058,295,268,563
4980,-1.350869376,0.68018326,031-BDN,-0.335343058,1,1,2
4981,-1.350869376,0.68018326,031-BDO,-0.335343058,6,0,6
4982,-1.350869376,0.68018326,031-BDP,-0.335343058,2,0,2
4983,-1.350869376,0.68018326,031-BDQ,-0.335343058,1,2,3
4984,-1.350869376,0.68018326,031-BDR,-0.335343058,17,38,55
4985,-1.350869376,0.68018326,031-BDW,-0.335343058,339,115,454
4986,-1.350869376,0.68018326,031-BDX,-0.335343058,732,240,972
4987,-1.350869376,0.68018326,031-AQZ,-0.335343058,442,283,725
4988,-1.350869376,0.68018326,031-ARC,-0.335343058,456,276,732
4989,-1.350869376,0.68018326,031-ARE,-0.335343058,422,278,700
4990,-1.350869376,0.68018326,031-ARG,-0.335343058,498,336,834
4991,-1.350869376,0.68018326,031-BDZ,-0.335343058,178,127,305
4992,-1.350869376,0.68018326,031-BEA,-0.335343058,496,189,685
4993,-1.350869376,0.68018326,031-BEB,-0.335343058,300,153,453
4994,-1.350869376,0.68018326,031-BEC,-0.335343058,290,154,444
4995,-1.350869376,0.68018326,031-BED,-0.335343058,383,130,513
4996,-1.350869376,0.68018326,031-BEE,-0.335343058,479,131,610
4997,-1.350869376,0.68018326,031-BEF,-0.335343058,271,121,392
4998,-1.350869376,0.68018326,031-BEG,-0.335343058,386,168,554
4999,-1.350869376,0.68018326,031-BEH,-0.335343058,261,74,335
5000,-1.350869376,0.68018326,031-BEI,-0.335343058,379,150,529
5001,-1.350869376,0.68018326,031-BEJ,-0.335343058,335,163,498
5002,-1.350869376,0.68018326,031-BEK,-0.335343058,441,100,541
5003,-1.350869376,0.68018326,031-BEL,-0.335343058,597,160,757
5004,-1.350869376,0.68018326,031-BEM,-0.335343058,378,88,466
5005,-1.350869376,0.68018326,031-BEN,-0.335343058,270,86,356
5006,-1.350869376,0.68018326,031-BEO,-0.335343058,302,110,412
5007,-1.350869376,0.68018326,031-BEP,-0.335343058,290,185,475
5008,-1.350869376,0.68018326,031-BER,-0.335343058,307,106,413
5009,-1.350869376,0.68018326,031-BET,-0.335343058,475,165,640
5010,-1.350869376,0.68018326,031-BEU,-0.335343058,229,108,337
5011,-1.350869376,0.68018326,031-BEV,-0.335343058,328,139,467
5012,-1.350869376,0.68018326,031-BEW,-0.335343058,188,132,320
5013,-1.350869376,0.68018326,031-BEX,-0.335343058,304,106,410
5014,-1.350869376,0.68018326,031-BEY,-0.335343058,213,86,299
5015,-1.350869376,0.68018326,031-BEZ,-0.335343058,180,79,259
5016,-1.350869376,0.68018326,031-BFA,-0.335343058,464,260,724
5017,-1.350869376,0.68018326,031-BFB,-0.335343058,388,134,522
5018,-1.350869376,0.68018326,031-BFC,-0.335343058,259,107,366
5019,-1.350869376,0.68018326,031-BFD,-0.335343058,256,79,335
5020,-1.350869376,0.68018326,031-BFE,-0.335343058,371,149,520
5021,-1.350869376,0.68018326,031-BFF,-0.335343058,448,160,608
5022,-1.350869376,0.68018326,031-BFG,-0.335343058,146,57,203
5023,-1.350869376,0.68018326,031-BFH,-0.335343058,343,180,523
5024,-1.350869376,0.68018326,031-BFI,-0.335343058,316,101,417
5025,-1.350869376,0.68018326,031-BFJ,-0.335343058,257,200,457
5026,-1.350869376,0.68018326,031-BFK,-0.335343058,159,147,306
5027,-1.350869376,0.68018326,031-BFN,-0.335343058,327,200,527
5028,-1.350869376,0.68018326,031-BFO,-0.335343058,285,167,452
5029,-1.350869376,0.68018326,031-BFP,-0.335343058,349,115,464
5030,-1.350869376,0.68018326,031-BFQ,-0.335343058,228,99,327
5031,-1.350869376,0.68018326,031-BPR,-0.335343058,95,113,208
5032,-1.350869376,0.68018326,031-BDT,-0.335343058,255,170,425
5033,-1.350869376,0.68018326,031-BDU,-0.335343058,265,174,439
5034,-1.350869376,0.68018326,031-ARI,-0.335343058,105,665,770
5035,-1.350869376,0.68018326,031-ARJ,-0.335343058,267,537,804
5036,-1.350869376,0.68018326,031-ARK,-0.335343058,41,258,299
5037,-1.350869376,0.68018326,031-ARL,-0.335343058,67,324,391
5038,-1.350869376,0.68018326,031-ARM,-0.335343058,173,589,762
5039,-1.350869376,0.68018326,031-ARN,-0.335343058,86,316,402
5040,-1.350869376,0.68018326,031-ARO,-0.335343058,43,662,705
5041,-1.350869376,0.68018326,031-ARP,-0.335343058,67,590,657
5042,-1.350869376,0.68018326,031-ARQ,-0.335343058,91,314,405
5043,-1.350869376,0.68018326,031-ARR,-0.335343058,102,623,725
5044,-1.350869376,0.68018326,031-ARS,-0.335343058,97,396,493
5045,-1.350869376,0.68018326,031-ART,-0.335343058,85,299,384
5046,-1.350869376,0.68018326,031-ARU,-0.335343058,46,389,435
5047,-1.350869376,0.68018326,031-ARV,-0.335343058,97,331,428
5048,-1.350869376,0.68018326,031-ARW,-0.335343058,74,345,419
5049,-1.350869376,0.68018326,031-ARX,-0.335343058,56,337,393
5050,-1.350869376,0.68018326,031-ARY,-0.335343058,31,328,359
5051,-1.350869376,0.68018326,031-ARZ,-0.335343058,39,323,362
5052,-1.350869376,0.68018326,031-ASA,-0.335343058,87,326,413
5053,-1.350869376,0.68018326,031-BFR,-0.335343058,439,342,781
5054,-1.350869376,0.68018326,031-BFS,-0.335343058,428,386,814
5055,-1.350869376,0.68018326,031-BFW,-0.335343058,128,438,566
5056,-1.350869376,0.68018326,031-BFX,-0.335343058,39,427,466
5057,-1.350869376,0.68018326,031-BFY,-0.335343058,85,371,456
5058,-1.350869376,0.68018326,031-BFZ,-0.335343058,43,419,462
5059,-1.350869376,0.68018326,031-BGI,-0.335343058,649,248,897
5060,-1.350869376,0.68018326,031-BGJ,-0.335343058,681,164,845
5061,-1.350869376,0.68018326,031-BGK,-0.335343058,479,215,694
5062,-1.350869376,0.68018326,031-BGL,-0.335343058,373,170,543
5063,-1.350869376,0.68018326,031-BGM,-0.335343058,311,95,406
5064,-1.350869376,0.68018326,031-BGN,-0.335343058,264,83,347
5065,-1.350869376,0.68018326,031-BGO,-0.335343058,474,293,767
5066,-1.350869376,0.68018326,031-BGP,-0.335343058,271,120,391
5067,-1.350869376,0.68018326,031-BGQ,-0.335343058,616,192,808
5068,-1.350869376,0.68018326,031-BGR,-0.335343058,417,159,576
5069,-1.350869376,0.68018326,031-BGS,-0.335343058,532,193,725
5070,-1.350869376,0.68018326,031-BGT,-0.335343058,577,170,747
5071,-1.350869376,0.68018326,031-BGU,-0.335343058,269,73,342
5072,-1.350869376,0.68018326,031-BGV,-0.335343058,288,129,417
5073,-1.350869376,0.68018326,031-BGW,-0.335343058,284,130,414
5074,-1.350869376,0.68018326,031-BGX,-0.335343058,656,214,870
5075,-1.350869376,0.68018326,031-BGY,-0.335343058,535,221,756
5076,-1.350869376,0.68018326,031-BGZ,-0.335343058,497,121,618
5077,-1.350869376,0.68018326,031-BHA,-0.335343058,262,72,334
5078,-1.350869376,0.68018326,031-BHB,-0.335343058,539,150,689
5079,-1.350869376,0.68018326,031-BHC,-0.335343058,169,29,198
5080,-1.350869376,0.68018326,031-BHD,-0.335343058,393,245,638
5081,-1.350869376,0.68018326,031-BHE,-0.335343058,672,277,949
5082,-1.350869376,0.68018326,031-BHF,-0.335343058,896,370,1266
5083,-1.350869376,0.68018326,031-BHG,-0.335343058,317,130,447
5084,-1.350869376,0.68018326,031-BHH,-0.335343058,251,246,497
5085,-1.350869376,0.68018326,031-BHI,-0.335343058,812,209,1021
5086,-1.350869376,0.68018326,031-BHJ,-0.335343058,538,184,722
5087,-1.350869376,0.68018326,031-BHK,-0.335343058,256,180,436
5088,-1.350869376,0.68018326,031-BHL,-0.335343058,255,124,379
5089,-1.350869376,0.68018326,031-BHM,-0.335343058,397,133,530
5090,-1.350869376,0.68018326,031-BHN,-0.335343058,254,48,302
5091,-1.350869376,0.68018326,031-BHP,-0.335343058,618,243,861
5092,-1.350869376,0.68018326,031-BHQ,-0.335343058,395,74,469
5093,-1.350869376,0.68018326,031-BHS,-0.335343058,276,141,417
5094,-1.350869376,0.68018326,031-BHT,-0.335343058,189,74,263
5095,-1.350869376,0.68018326,031-BHV,-0.335343058,648,286,934
5096,-1.350869376,0.68018326,031-BHW,-0.335343058,459,104,563
5097,-1.350869376,0.68018326,031-BHY,-0.335343058,207,114,321
5098,-1.350869376,0.68018326,031-BHZ,-0.335343058,396,116,512
5099,-1.350869376,0.68018326,031-BIB,-0.335343058,151,109,260
5100,-1.350869376,0.68018326,031-BIC,-0.335343058,410,102,512
5101,-1.350869376,0.68018326,031-BIE,-0.335343058,401,100,501
5102,-1.350869376,0.68018326,031-BIF,-0.335343058,345,139,484
5103,-1.350869376,0.68018326,031-BIH,-0.335343058,474,142,616
5104,-1.350869376,0.68018326,031-BII,-0.335343058,254,139,393
5105,-1.350869376,0.68018326,031-BIJ,-0.335343058,321,126,447
5106,-1.350869376,0.68018326,031-BIK,-0.335343058,541,131,672
5107,-1.350869376,0.68018326,031-BIL,-0.335343058,307,152,459
5108,-1.350869376,0.68018326,031-BIM,-0.335343058,524,143,667
5109,-1.350869376,0.68018326,031-BIN,-0.335343058,429,87,516
5110,-1.350869376,0.68018326,031-BIO,-0.335343058,334,97,431
5111,-1.350869376,0.68018326,031-BIP,-0.335343058,320,136,456
5112,-1.350869376,0.68018326,031-BIQ,-0.335343058,264,92,356
5113,-1.350869376,0.68018326,031-BIR,-0.335343058,355,89,444
5114,-1.350869376,0.68018326,031-BIS,-0.335343058,324,120,444
5115,-1.350869376,0.68018326,031-BIT,-0.335343058,368,123,491
5116,-1.350869376,0.68018326,031-BIU,-0.335343058,304,51,355
5117,-1.350869376,0.68018326,031-BIV,-0.335343058,545,164,709
5118,-1.350869376,0.68018326,031-BIW,-0.335343058,858,185,1043
5119,-1.350869376,0.68018326,031-BIX,-0.335343058,359,85,444
5120,-1.350869376,0.68018326,031-BIY,-0.335343058,99,61,160
5121,-1.350869376,0.68018326,031-BGC,-0.335343058,261,175,436
5122,-1.350869376,0.68018326,031-BGD,-0.335343058,341,139,480
5123,-1.350869376,0.68018326,031-BGE,-0.335343058,241,120,361
5124,-1.350869376,0.68018326,031-BGF,-0.335343058,213,183,396
5125,-1.350869376,0.68018326,031-BGG,-0.335343058,244,199,443
5126,-1.350869376,0.68018326,031-BIZ,-0.335343058,469,143,612
5127,-1.350869376,0.68018326,031-BJA,-0.335343058,382,103,485
5128,-1.350869376,0.68018326,031-BJB,-0.335343058,368,103,471
5129,-1.350869376,0.68018326,031-BJC,-0.335343058,275,158,433
5130,-1.350869376,0.68018326,031-BJD,-0.335343058,204,63,267
5131,-1.350869376,0.68018326,031-BJE,-0.335343058,467,212,679
5132,-1.350869376,0.68018326,031-BJF,-0.335343058,597,267,864
5133,-1.350869376,0.68018326,031-BJG,-0.335343058,707,272,979
5134,-1.350869376,0.68018326,031-BJH,-0.335343058,569,253,822
5135,-1.350869376,0.68018326,031-BJI,-0.335343058,904,296,1200
5136,-1.350869376,0.68018326,031-ASG,-0.335343058,383,178,561
5137,-1.350869376,0.68018326,031-ASH,-0.335343058,362,166,528
5138,-1.350869376,0.68018326,031-ASI,-0.335343058,453,230,683
5139,-1.350869376,0.68018326,031-ASJ,-0.335343058,427,166,593
5140,-1.350869376,0.68018326,031-ASK,-0.335343058,305,95,400
5141,-1.350869376,0.68018326,031-ASL,-0.335343058,377,179,556
5142,-1.350869376,0.68018326,031-ASM,-0.335343058,461,218,679
5143,-1.350869376,0.68018326,031-BOP,-0.335343058,2,458,460
5144,-1.350869376,0.68018326,031-BOQ,-0.335343058,1,496,497
5145,-1.350869376,0.68018326,031-BOR,-0.335343058,2,173,175
5146,-1.350869376,0.68018326,031-BOS,-0.335343058,1,295,296
5147,-1.350869376,0.68018326,031-BOT,-0.335343058,4,442,446
5148,-1.350869376,0.68018326,031-BJL,-0.335343058,185,146,331
5149,-1.350869376,0.68018326,031-BJM,-0.335343058,132,190,322
5150,-1.350869376,0.68018326,031-BJN,-0.335343058,123,174,297
5151,-1.350869376,0.68018326,031-BJO,-0.335343058,138,166,304
5152,-1.350869376,0.68018326,031-BJP,-0.335343058,49,160,209
5153,-1.350869376,0.68018326,031-ASO,-0.335343058,401,223,624
5154,-1.350869376,0.68018326,031-ASP,-0.335343058,372,214,586
5155,-1.350869376,0.68018326,031-ASQ,-0.335343058,153,141,294
5156,-1.350869376,0.68018326,031-ASR,-0.335343058,382,277,659
5157,-1.350869376,0.68018326,031-ASS,-0.335343058,507,306,813
5158,-1.350869376,0.68018326,031-AST,-0.335343058,363,255,618
5159,-1.350869376,0.68018326,031-ASU,-0.335343058,333,179,512
5160,-1.350869376,0.68018326,031-ASV,-0.335343058,230,139,369
5161,-1.350869376,0.68018326,031-ASW,-0.335343058,331,197,528
5162,-1.350869376,0.68018326,031-ASZ,-0.335343058,284,207,491
5163,-1.350869376,0.68018326,031-ATA,-0.335343058,340,170,510
5164,-1.350869376,0.68018326,031-ATB,-0.335343058,400,252,652
5165,-1.350869376,0.68018326,031-ATC,-0.335343058,306,178,484
5166,-1.350869376,0.68018326,031-ATD,-0.335343058,263,188,451
5167,-1.350869376,0.68018326,031-ATE,-0.335343058,280,192,472
5168,-1.350869376,0.68018326,031-ATF,-0.335343058,297,159,456
5169,-1.350869376,0.68018326,031-ATG,-0.335343058,257,111,368
5170,-1.350869376,0.68018326,031-ATH,-0.335343058,312,209,521
5171,-1.350869376,0.68018326,031-ATI,-0.335343058,416,212,628
5172,-1.350869376,0.68018326,031-ATJ,-0.335343058,237,97,334
5173,-1.350869376,0.68018326,031-BJS,-0.335343058,208,245,453
5174,-1.350869376,0.68018326,031-BJT,-0.335343058,364,245,609
5175,-1.350869376,0.68018326,031-BJU,-0.335343058,302,229,531
5176,-1.350869376,0.68018326,031-BJV,-0.335343058,204,215,419
5177,-1.350869376,0.68018326,031-BKD,-0.335343058,489,154,643
5178,-1.350869376,0.68018326,031-BKE,-0.335343058,917,178,1095
5179,-1.350869376,0.68018326,031-BKF,-0.335343058,501,135,636
5180,-1.350869376,0.68018326,031-BKG,-0.335343058,845,246,1091
5181,-1.350869376,0.68018326,031-BKH,-0.335343058,559,116,675
5182,-1.350869376,0.68018326,031-BKI,-0.335343058,279,85,364
5183,-1.350869376,0.68018326,031-BKJ,-0.335343058,579,153,732
5184,-1.350869376,0.68018326,031-BJX,-0.335343058,195,64,259
5185,-1.350869376,0.68018326,031-BJY,-0.335343058,331,94,425
5186,-1.350869376,0.68018326,031-BPC,-0.335343058,76,24,100
5187,-1.350869376,0.68018326,031-BPD,-0.335343058,243,93,336
5188,-1.350869376,0.68018326,031-ATN,-0.335343058,254,150,404
5189,-1.350869376,0.68018326,031-ATO,-0.335343058,308,177,485
5190,-1.350869376,0.68018326,031-ATP,-0.335343058,391,238,629
5191,-1.350869376,0.68018326,031-ATQ,-0.335343058,312,212,524
5192,-1.350869376,0.68018326,031-ATR,-0.335343058,288,232,520
5193,-1.350869376,0.68018326,031-ATS,-0.335343058,329,212,541
5194,-1.350869376,0.68018326,031-ATT,-0.335343058,322,168,490
5195,-1.350869376,0.68018326,031-ATU,-0.335343058,337,160,497
5196,-1.350869376,0.68018326,031-ATV,-0.335343058,258,163,421
5197,-1.350869376,0.68018326,031-ATW,-0.335343058,489,283,772
5198,-1.350869376,0.68018326,031-ATX,-0.335343058,493,334,827
5199,-1.350869376,0.68018326,031-ATY,-0.335343058,439,234,673
5200,-1.350869376,0.68018326,031-AUA,-0.335343058,149,398,547
5201,-1.350869376,0.68018326,031-AUB,-0.335343058,158,442,600
5202,-1.350869376,0.68018326,031-AUC,-0.335343058,346,376,722
5203,-1.350869376,0.68018326,031-AUE,-0.335343058,314,433,747
5204,-1.350869376,0.68018326,031-056,-0.335343058,283,364,647
5205,-1.350869376,0.68018326,031-BKK,-0.335343058,375,231,606
5206,-1.350869376,0.68018326,031-BKL,-0.335343058,240,159,399
5207,-1.350869376,0.68018326,031-BPF,-0.335343058,306,123,429
5208,-1.350869376,0.68018326,031-AUI,-0.335343058,181,278,459
5209,-1.350869376,0.68018326,031-AUJ,-0.335343058,229,223,452
5210,-1.350869376,0.68018326,031-AUK,-0.335343058,193,224,417
5211,-1.350869376,0.68018326,031-AUM,-0.335343058,93,246,339
5212,-1.350869376,0.68018326,031-AUN,-0.335343058,106,238,344
5213,-1.350869376,0.68018326,031-AUO,-0.335343058,138,265,403
5214,-1.350869376,0.68018326,031-AUP,-0.335343058,149,263,412
5215,-1.350869376,0.68018326,031-AUQ,-0.335343058,186,211,397
5216,-1.350869376,0.68018326,031-AUR,-0.335343058,176,299,475
5217,-1.350869376,0.68018326,031-AUS,-0.335343058,88,410,498
5218,-1.350869376,0.68018326,031-AUT,-0.335343058,172,236,408
5219,-1.350869376,0.68018326,031-BJZ,-0.335343058,451,129,580
5220,-1.350869376,0.68018326,031-AUV,-0.335343058,232,262,494
5221,-1.350869376,0.68018326,031-AUW,-0.335343058,279,295,574
5222,-1.350869376,0.68018326,031-AUX,-0.335343058,293,385,678
5223,-1.350869376,0.68018326,031-AUZ,-0.335343058,390,301,691
5224,-1.350869376,0.68018326,031-AVA,-0.335343058,402,422,824
5225,-1.350869376,0.68018326,031-AVB,-0.335343058,303,262,565
5226,-1.350869376,0.68018326,031-AVD,-0.335343058,303,296,599
5227,-1.350869376,0.68018326,031-AVE,-0.335343058,264,287,551
5228,-1.350869376,0.68018326,031-AVF,-0.335343058,215,224,439
5229,-1.350869376,0.68018326,031-AVG,-0.335343058,323,230,553
5230,-1.350869376,0.68018326,031-AVH,-0.335343058,267,269,536
5231,-1.350869376,0.68018326,031-AVI,-0.335343058,381,316,697
5232,-1.350869376,0.68018326,031-AVJ,-0.335343058,407,329,736
5233,-1.350869376,0.68018326,031-AVV,-0.335343058,282,204,486
5234,-1.350869376,0.68018326,031-AVW,-0.335343058,114,261,375
5235,-1.350869376,0.68018326,031-AVX,-0.335343058,243,213,456
5236,-1.350869376,0.68018326,031-AVZ,-0.335343058,184,137,321
5237,-1.350869376,0.68018326,031-AWA,-0.335343058,191,137,328
5238,-1.350869376,0.68018326,031-AWB,-0.335343058,272,135,407
5239,-1.350869376,0.68018326,031-AWD,-0.335343058,313,135,448
5240,-1.350869376,0.68018326,031-AWE,-0.335343058,415,183,598
5241,-1.350869376,0.68018326,031-AWF,-0.335343058,193,169,362
5242,-1.350869376,0.68018326,031-AWH,-0.335343058,423,208,631
5243,-1.350869376,0.68018326,031-AWI,-0.335343058,326,118,444
5244,-1.350869376,0.68018326,031-AWJ,-0.335343058,282,158,440
5245,-1.350869376,0.68018326,031-AWT,-0.335343058,170,163,333
5246,-1.350869376,0.68018326,031-AWU,-0.335343058,169,190,359
5247,-1.350869376,0.68018326,031-AWV,-0.335343058,255,232,487
5248,-1.350869376,0.68018326,031-AWW,-0.335343058,433,281,714
5249,-1.350869376,0.68018326,031-AWX,-0.335343058,72,79,151
5250,-1.350869376,0.68018326,031-AWZ,-0.335343058,267,115,382
5251,-1.350869376,0.68018326,031-AXA,-0.335343058,320,203,523
5252,-1.350869376,0.68018326,031-AXB,-0.335343058,262,127,389
5253,-1.350869376,0.68018326,031-AXC,-0.335343058,287,172,459
5254,-1.350869376,0.68018326,031-BQA,-0.335343058,93,100,193
5255,-1.350869376,0.68018326,031-AXD,-0.335343058,447,219,666
5256,-1.350869376,0.68018326,031-AXE,-0.335343058,247,126,373
5257,-1.350869376,0.68018326,031-AXF,-0.335343058,295,162,457
5258,-1.350869376,0.68018326,031-AXG,-0.335343058,121,58,179
5259,-1.350869376,0.68018326,031-AXI,-0.335343058,67,381,448
5260,-1.350869376,0.68018326,031-AXJ,-0.335343058,37,401,438
5261,-1.350869376,0.68018326,031-AXK,-0.335343058,39,499,538
5262,-1.350869376,0.68018326,031-AXL,-0.335343058,218,217,435
5263,-1.350869376,0.68018326,031-AXM,-0.335343058,70,335,405
5264,-1.350869376,0.68018326,031-AXN,-0.335343058,131,322,453
5265,-1.350869376,0.68018326,031-AXQ,-0.335343058,285,505,790
5266,-1.350869376,0.68018326,031-AXR,-0.335343058,429,514,943
5267,-1.350869376,0.68018326,031-AXS,-0.335343058,246,172,418
5268,-1.350869376,0.68018326,031-AXT,-0.335343058,474,431,905
5269,-1.350869376,0.68018326,031-AXU,-0.335343058,311,376,687
5270,-1.350869376,0.68018326,031-AXV,-0.335343058,192,277,469
5271,-1.350869376,0.68018326,031-AXW,-0.335343058,46,133,179
5272,-1.350869376,0.68018326,031-AXX,-0.335343058,48,114,162
5273,-1.350869376,0.68018326,031-AXY,-0.335343058,211,373,584
5274,-1.350869376,0.68018326,031-BKM,-0.335343058,32,303,335
5275,-1.350869376,0.68018326,031-BKN,-0.335343058,174,338,512
5276,-1.350869376,0.68018326,031-BKO,-0.335343058,252,331,583
5277,-1.350869376,0.68018326,031-BKP,-0.335343058,154,246,400
5278,-1.350869376,0.68018326,031-BKQ,-0.335343058,191,284,475
5279,-1.350869376,0.68018326,031-BKR,-0.335343058,140,197,337
5280,-1.350869376,0.68018326,031-BKS,-0.335343058,135,215,350
5281,-1.350869376,0.68018326,031-BKT,-0.335343058,53,153,206
5282,-1.350869376,0.68018326,031-BKU,-0.335343058,234,223,457
5283,-1.350869376,0.68018326,031-BKV,-0.335343058,87,480,567
5284,-1.350869376,0.68018326,031-BKW,-0.335343058,206,143,349
5285,-1.350869376,0.68018326,031-BKX,-0.335343058,243,389,632
5286,-1.350869376,0.68018326,031-BKY,-0.335343058,225,252,477
5287,-1.350869376,0.68018326,031-BKZ,-0.335343058,23,301,324
5288,-1.350869376,0.68018326,031-BLA,-0.335343058,372,180,552
5289,-1.350869376,0.68018326,031-BLB,-0.335343058,162,247,409
5290,-1.350869376,0.68018326,031-BLC,-0.335343058,152,153,305
5291,-1.350869376,0.68018326,031-BLD,-0.335343058,132,92,224
5292,-1.350869376,0.68018326,031-BLE,-0.335343058,107,309,416
5293,-1.350869376,0.68018326,031-BLF,-0.335343058,330,143,473
5294,-1.350869376,0.68018326,031-BLG,-0.335343058,140,180,320
5295,-1.350869376,0.68018326,031-BLH,-0.335343058,111,252,363
5296,-1.350869376,0.68018326,031-BLI,-0.335343058,14,337,351
5297,-1.350869376,0.68018326,031-BLJ,-0.335343058,32,315,347
5298,-1.350869376,0.68018326,031-BLK,-0.335343058,190,283,473
5299,-1.350869376,0.68018326,031-BLL,-0.335343058,393,180,573
5300,-1.350869376,0.68018326,031-BLM,-0.335343058,207,197,404
5301,-1.350869376,0.68018326,031-BLN,-0.335343058,302,231,533
5302,-1.350869376,0.68018326,031-BLO,-0.335343058,264,191,455
5303,-1.350869376,0.68018326,031-BLP,-0.335343058,215,313,528
5304,-1.350869376,0.68018326,031-BLQ,-0.335343058,47,276,323
5305,-1.350869376,0.68018326,031-BLR,-0.335343058,254,275,529
5306,-1.350869376,0.68018326,031-BLS,-0.335343058,291,276,567
5307,-1.350869376,0.68018326,031-BLT,-0.335343058,149,93,242
5308,-1.350869376,0.68018326,031-BLU,-0.335343058,297,197,494
5309,-1.350869376,0.68018326,031-BLV,-0.335343058,238,122,360
5310,-1.350869376,0.68018326,031-BLW,-0.335343058,188,152,340
5311,-1.350869376,0.68018326,031-BLX,-0.335343058,208,220,428
5312,-1.350869376,0.68018326,031-BLY,-0.335343058,75,372,447
5313,-1.350869376,0.68018326,031-BLZ,-0.335343058,221,282,503
5314,-1.350869376,0.68018326,031-BMA,-0.335343058,255,283,538
5315,-1.350869376,0.68018326,031-BMB,-0.335343058,161,184,345
5316,-1.350869376,0.68018326,031-BMC,-0.335343058,256,161,417
5317,-1.350869376,0.68018326,031-BMD,-0.335343058,165,171,336
5318,-1.350869376,0.68018326,031-BME,-0.335343058,216,290,506
5319,-1.350869376,0.68018326,031-BMF,-0.335343058,285,334,619
5320,-1.350869376,0.68018326,031-BMG,-0.335343058,19,319,338
5321,-1.350869376,0.68018326,031-BMI,-0.335343058,289,227,516
5322,-1.350869376,0.68018326,031-BMJ,-0.335343058,63,404,467
5323,-1.350869376,0.68018326,031-AWL,-0.335343058,366,233,599
5324,-1.350869376,0.68018326,031-AWN,-0.335343058,340,212,552
5325,-1.350869376,0.68018326,031-AWP,-0.335343058,286,300,586
5326,-1.350869376,0.68018326,031-AWR,-0.335343058,283,268,551
5327,-1.350869376,0.68018326,031-BMK,-0.335343058,15,84,99
5328,-1.350869376,0.68018326,031-BMM,-0.335343058,312,189,501
5329,-1.350869376,0.68018326,031-BMO,-0.335343058,256,152,408
5330,-1.350869376,0.68018326,031-BMP,-0.335343058,424,224,648
5331,-1.350869376,0.68018326,031-BMQ,-0.335343058,319,166,485
5332,-1.350869376,0.68018326,031-BMR,-0.335343058,242,154,396
5333,-1.350869376,0.68018326,031-BMS,-0.335343058,305,233,538
5334,-1.350869376,0.68018326,031-BMT,-0.335343058,179,200,379
5335,-1.350869376,0.68018326,031-BMU,-0.335343058,623,316,939
5336,-1.350869376,0.68018326,031-BMV,-0.335343058,154,171,325
5337,-1.350869376,0.68018326,031-BMW,-0.335343058,184,124,308
5338,-1.350869376,0.68018326,031-BMX,-0.335343058,284,153,437
5339,-1.350869376,0.68018326,031-BMY,-0.335343058,260,149,409
5340,-1.350869376,0.68018326,031-BMZ,-0.335343058,327,180,507
5341,-1.350869376,0.68018326,031-BNA,-0.335343058,72,125,197
5342,-1.350869376,0.68018326,031-BNB,-0.335343058,347,198,545
5343,-1.350869376,0.68018326,031-BNC,-0.335343058,304,156,460
5344,-1.350869376,0.68018326,031-BND,-0.335343058,185,187,372
5345,-1.350869376,0.68018326,031-BNE,-0.335343058,216,171,387
5346,-1.350869376,0.68018326,031-BNF,-0.335343058,163,166,329
5347,-1.350869376,0.68018326,031-BNG,-0.335343058,321,173,494
5348,-1.350869376,0.68018326,031-BNH,-0.335343058,248,104,352
5349,-1.350869376,0.68018326,031-BNI,-0.335343058,357,138,495
5350,-1.350869376,0.68018326,031-BNJ,-0.335343058,262,208,470
5351,-1.350869376,0.68018326,031-BNK,-0.335343058,238,187,425
5352,-1.350869376,0.68018326,031-BNM,-0.335343058,93,111,204
5353,-1.350869376,0.68018326,031-BNN,-0.335343058,484,338,822
5354,-1.350869376,0.68018326,031-BNO,-0.335343058,292,139,431
5355,-1.350869376,0.68018326,031-BNP,-0.335343058,487,351,838
5356,-1.350869376,0.68018326,031-BNQ,-0.335343058,216,114,330
5357,-1.350869376,0.68018326,031-BNR,-0.335343058,276,294,570
5358,-1.350869376,0.68018326,031-BNS,-0.335343058,346,204,550
5359,-1.350869376,0.68018326,031-BNT,-0.335343058,266,177,443
5360,-1.350869376,0.68018326,031-BNU,-0.335343058,313,322,635
5361,-1.350869376,0.68018326,031-BNV,-0.335343058,143,66,209
5362,-1.350869376,0.68018326,031-BNW,-0.335343058,306,135,441
5363,-1.350869376,0.68018326,031-BNX,-0.335343058,404,166,570
5364,-1.350869376,0.68018326,031-BNY,-0.335343058,148,112,260
5365,-1.350869376,0.68018326,031-BNZ,-0.335343058,336,205,541
5366,-1.350869376,0.68018326,031-BOA,-0.335343058,208,71,279
5367,-1.350869376,0.68018326,031-BOB,-0.335343058,434,269,703
5368,-1.350869376,0.68018326,031-BOC,-0.335343058,255,104,359
5369,-1.350869376,0.68018326,031-BOE,-0.335343058,294,163,457
5370,-1.350869376,0.68018326,031-BOF,-0.335343058,271,159,430
5371,-1.350869376,0.68018326,031-BOG,-0.335343058,343,180,523
5372,-1.350869376,0.68018326,031-BOH,-0.335343058,251,139,390
5373,-1.350869376,0.68018326,031-BOI,-0.335343058,288,107,395
5374,-1.350869376,0.68018326,031-BOJ,-0.335343058,271,124,395
5375,-1.350869376,0.68018326,031-BOK,-0.335343058,471,196,667
5376,-1.350869376,0.68018326,031-BPJ,-0.335343058,198,104,302
5377,-1.350869376,0.68018326,031-BOL,-0.335343058,36,383,419
5378,-1.350869376,0.68018326,031-BOM,-0.335343058,39,368,407
5379,-1.350869376,0.68018326,031-BON,-0.335343058,12,447,459
5380,-1.350869376,0.68018326,031-BOO,-0.335343058,112,406,518
5381,-1.350869376,0.68018326,031-AYD,-0.335343058,207,314,521
5382,-1.350869376,0.68018326,031-AYE,-0.335343058,276,281,557
5383,-1.350869376,0.68018326,031-AYF,-0.335343058,330,291,621
5384,-1.350869376,0.68018326,031-AYG,-0.335343058,239,302,541
5385,-1.350869376,0.68018326,031-AYH,-0.335343058,320,297,617
5386,-1.350869376,0.68018326,031-AYI,-0.335343058,126,343,469
5387,-1.350869376,0.68018326,031-AYJ,-0.335343058,188,337,525
5388,-1.350869376,0.68018326,031-AYK,-0.335343058,260,257,517
5389,-1.350869376,0.68018326,031-AYL,-0.335343058,153,322,475
5390,-1.350869376,0.68018326,031-AYM,-0.335343058,278,266,544
5391,-1.350869376,0.68018326,032-ABP,-0.335343058,423,189,612
5392,-1.350869376,0.68018326,032-ABQ,-0.335343058,463,221,684
5393,-1.350869376,0.68018326,032-ABR,-0.335343058,398,193,591
5394,-1.350869376,0.68018326,032-ABS,-0.335343058,412,201,613
5395,-1.350869376,0.68018326,032-ABT,-0.335343058,478,153,631
5396,-1.350869376,0.68018326,032-ABU,-0.335343058,373,163,536
5397,-1.350869376,0.68018326,032-ABV,-0.335343058,426,242,668
5398,-1.350869376,0.68018326,032-ABW,-0.335343058,439,142,581
5399,-1.350869376,0.68018326,032-AAA,-0.335343058,224,300,524
5400,-1.350869376,0.68018326,032-AAB,-0.335343058,286,294,580
5401,-1.350869376,0.68018326,032-AAG,-0.335343058,234,234,468
5402,-1.350869376,0.68018326,032-AAZ,-0.335343058,199,202,401
5403,-1.350869376,0.68018326,032-AAE,-0.335343058,151,169,320
5404,-1.350869376,0.68018326,032-AAJ,-0.335343058,338,212,550
5405,-1.350869376,0.68018326,032-AAL,-0.335343058,423,196,619
5406,-1.350869376,0.68018326,032-AAH,-0.335343058,460,225,685
5407,-1.350869376,0.68018326,032-AAM,-0.335343058,391,148,539
5408,-1.350869376,0.68018326,032-AAI,-0.335343058,260,212,472
5409,-1.350869376,0.68018326,032-AAK,-0.335343058,566,373,939
5410,-1.350869376,0.68018326,032-ACT,-0.335343058,468,157,625
5411,-1.350869376,0.68018326,032-AAO,-0.335343058,143,150,293
5412,-1.350869376,0.68018326,032-AAP,-0.335343058,279,193,472
5413,-1.350869376,0.68018326,032-AAQ,-0.335343058,169,177,346
5414,-1.350869376,0.68018326,032-AAR,-0.335343058,290,265,555
5415,-1.350869376,0.68018326,032-AAC,-0.335343058,197,233,430
5416,-1.350869376,0.68018326,032-AAU,-0.335343058,132,198,330
5417,-1.350869376,0.68018326,032-AAV,-0.335343058,432,289,721
5418,-1.350869376,0.68018326,032-AAW,-0.335343058,391,233,624
5419,-1.350869376,0.68018326,032-AAX,-0.335343058,420,289,709
5420,-1.350869376,0.68018326,032-ABM,-0.335343058,343,306,649
5421,-1.350869376,0.68018326,032-ABA,-0.335343058,237,257,494
5422,-1.350869376,0.68018326,032-ABB,-0.335343058,330,291,621
5423,-1.350869376,0.68018326,032-ABC,-0.335343058,209,220,429
5424,-1.350869376,0.68018326,032-ABD,-0.335343058,277,208,485
5425,-1.350869376,0.68018326,032-ABE,-0.335343058,247,163,410
5426,-1.350869376,0.68018326,032-ABF,-0.335343058,296,229,525
5427,-1.350869376,0.68018326,032-ABG,-0.335343058,226,216,442
5428,-1.350869376,0.68018326,032-ABH,-0.335343058,302,176,478
5429,-1.350869376,0.68018326,032-ABI,-0.335343058,255,198,453
5430,-1.350869376,0.68018326,032-ABJ,-0.335343058,344,203,547
5431,-1.350869376,0.68018326,032-ABK,-0.335343058,370,190,560
5432,-1.350869376,0.68018326,032-ABL,-0.335343058,266,153,419
5433,-1.350869376,0.68018326,032-AAS,-0.335343058,243,247,490
5434,-1.350869376,0.68018326,032-ABN,-0.335343058,338,421,759
5435,-1.350869376,0.68018326,032-ABO,-0.335343058,286,402,688
5436,-1.350869376,0.68018326,032-ABX,-0.335343058,466,203,669
5437,-1.350869376,0.68018326,032-ABY,-0.335343058,517,287,804
5438,-1.350869376,0.68018326,032-ABZ,-0.335343058,343,231,574
5439,-1.350869376,0.68018326,032-ACA,-0.335343058,628,188,816
5440,-1.350869376,0.68018326,032-ACB,-0.335343058,419,302,721
5441,-1.350869376,0.68018326,032-ACC,-0.335343058,623,237,860
5442,-1.350869376,0.68018326,032-ACD,-0.335343058,326,208,534
5443,-1.350869376,0.68018326,032-ACE,-0.335343058,386,157,543
5444,-1.350869376,0.68018326,032-ACS,-0.335343058,573,287,860
5445,-1.350869376,0.68018326,032-ACH,-0.335343058,603,262,865
5446,-1.350869376,0.68018326,032-ACK,-0.335343058,398,295,693
5447,-1.350869376,0.68018326,032-ACI,-0.335343058,537,180,717
5448,-1.350869376,0.68018326,032-ACJ,-0.335343058,300,89,389
5449,-1.350869376,0.68018326,032-ACL,-0.335343058,318,103,421
5450,-1.350869376,0.68018326,032-ACM,-0.335343058,293,136,429
5451,-1.350869376,0.68018326,032-ACN,-0.335343058,356,125,481
5452,-1.350869376,0.68018326,032-ACO,-0.335343058,390,132,522
5453,-1.350869376,0.68018326,032-ACR,-0.335343058,510,315,825
5454,-1.350869376,0.68018326,033-AAZ,-0.335343058,203,149,352
5455,-1.350869376,0.68018326,033-ABA,-0.335343058,207,152,359
5456,-1.350869376,0.68018326,033-ABB,-0.335343058,264,195,459
5457,-1.350869376,0.68018326,033-ABC,-0.335343058,142,140,282
5458,-1.350869376,0.68018326,033-ABE,-0.335343058,189,123,312
5459,-1.350869376,0.68018326,033-AAL,-0.335343058,214,141,355
5460,-1.350869376,0.68018326,033-AAN,-0.335343058,286,167,453
5461,-1.350869376,0.68018326,033-AAO,-0.335343058,159,116,275
5462,-1.350869376,0.68018326,033-AAP,-0.335343058,279,177,456
5463,-1.350869376,0.68018326,033-AAM,-0.335343058,214,139,353
5464,-1.350869376,0.68018326,033-AAV,-0.335343058,148,114,262
5465,-1.350869376,0.68018326,033-AAW,-0.335343058,139,124,263
5466,-1.350869376,0.68018326,033-AAQ,-0.335343058,243,85,328
5467,-1.350869376,0.68018326,033-AAU,-0.335343058,173,117,290
5468,-1.350869376,0.68018326,033-AAA,-0.335343058,84,102,186
5469,-1.350869376,0.68018326,033-AAB,-0.335343058,143,137,280
5470,-1.350869376,0.68018326,033-AAC,-0.335343058,116,103,219
5471,-1.350869376,0.68018326,033-AAD,-0.335343058,171,136,307
5472,-1.350869376,0.68018326,033-AAE,-0.335343058,256,164,420
5473,-1.350869376,0.68018326,033-AAF,-0.335343058,159,146,305
5474,-1.350869376,0.68018326,033-AAG,-0.335343058,101,85,186
5475,-1.350869376,0.68018326,033-AAH,-0.335343058,111,150,261
5476,-1.350869376,0.68018326,033-AAI,-0.335343058,160,100,260
5477,-1.350869376,0.68018326,033-AAJ,-0.335343058,112,98,210
5478,-1.350869376,0.68018326,033-AAK,-0.335343058,170,150,320
5479,-1.350869376,0.68018326,033-AAX,-0.335343058,358,123,481
5480,-1.350869376,0.68018326,033-AAY,-0.335343058,301,153,454
5481,-1.350869376,0.68018326,033-ABD,-0.335343058,194,111,305
5482,-1.350869376,0.68018326,033-ABF,-0.335343058,350,169,519
5483,-1.350869376,0.68018326,033-ABH,-0.335343058,301,153,454
5484,-1.350869376,0.68018326,033-ABG,-0.335343058,80,91,171
5485,-1.350869376,0.68018326,033-AAS,-0.335343058,254,202,456
5486,-1.350869376,0.68018326,033-ABI,-0.335343058,285,121,406
5487,-1.350869376,0.68018326,033-ABJ,-0.335343058,317,156,473
5488,-1.350869376,0.68018326,033-AAT,-0.335343058,163,101,264
5489,-1.350869376,0.68018326,033-ABK,-0.335343058,247,104,351
5490,-1.350869376,0.68018326,033-ABL,-0.335343058,181,88,269
5491,-1.350869376,0.68018326,033-ABM,-0.335343058,275,131,406
5492,-1.350869376,0.68018326,034-AAA,-0.335343058,109,75,184
5493,-1.350869376,0.68018326,034-AAB,-0.335343058,130,127,257
5494,-1.350869376,0.68018326,034-AAE,-0.335343058,416,462,878
5495,-1.350869376,0.68018326,034-AAG,-0.335343058,425,457,882
5496,-1.350869376,0.68018326,034-AAL,-0.335343058,175,147,322
5497,-1.350869376,0.68018326,034-AAM,-0.335343058,209,181,390
5498,-1.350869376,0.68018326,034-AAO,-0.335343058,220,151,371
5499,-1.350869376,0.68018326,034-AAS,-0.335343058,452,449,901
5500,-1.350869376,0.68018326,034-AAU,-0.335343058,293,234,527
5501,-1.350869376,0.68018326,034-AAV,-0.335343058,109,90,199
5502,-1.350869376,0.68018326,034-AAX,-0.335343058,395,313,708
5503,-1.350869376,0.68018326,034-ABA,-0.335343058,110,81,191
5504,-1.350869376,0.68018326,034-ABB,-0.335343058,322,310,632
5505,-1.350869376,0.68018326,034-ABF,-0.335343058,256,310,566
5506,-1.350869376,0.68018326,034-ABH,-0.335343058,115,137,252
5507,-1.350869376,0.68018326,034-ABI,-0.335343058,136,159,295
5508,-1.350869376,0.68018326,035-AAJ,-0.335343058,243,109,352
5509,-1.350869376,0.68018326,035-AAK,-0.335343058,334,232,566
5510,-1.350869376,0.68018326,035-AAL,-0.335343058,215,189,404
5511,-1.350869376,0.68018326,035-AAM,-0.335343058,194,199,393
5512,-1.350869376,0.68018326,035-AAN,-0.335343058,118,111,229
5513,-1.350869376,0.68018326,035-AAO,-0.335343058,282,178,460
5514,-1.350869376,0.68018326,035-AAP,-0.335343058,382,184,566
5515,-1.350869376,0.68018326,035-AAR,-0.335343058,155,116,271
5516,-1.350869376,0.68018326,035-AAQ,-0.335343058,357,230,587
5517,-1.350869376,0.68018326,035-AAS,-0.335343058,193,275,468
5518,-1.350869376,0.68018326,035-AAV,-0.335343058,259,245,504
5519,-1.350869376,0.68018326,035-AAT,-0.335343058,199,123,322
5520,-1.350869376,0.68018326,035-AAU,-0.335343058,251,211,462
5521,-1.350869376,0.68018326,035-AAW,-0.335343058,304,143,447
5522,-1.350869376,0.68018326,035-AAX,-0.335343058,131,156,287
5523,-1.350869376,0.68018326,035-AAY,-0.335343058,193,141,334
5524,-1.350869376,0.68018326,035-AAZ,-0.335343058,226,106,332
5525,-1.350869376,0.68018326,035-ABA,-0.335343058,191,159,350
5526,-1.350869376,0.68018326,035-ABB,-0.335343058,357,168,525
5527,-1.350869376,0.68018326,035-AAA,-0.335343058,208,282,490
5528,-1.350869376,0.68018326,035-AAB,-0.335343058,242,250,492
5529,-1.350869376,0.68018326,035-AAC,-0.335343058,260,229,489
5530,-1.350869376,0.68018326,035-AAD,-0.335343058,193,234,427
5531,-1.350869376,0.68018326,035-AAE,-0.335343058,211,236,447
5532,-1.350869376,0.68018326,035-AAF,-0.335343058,229,160,389
5533,-1.350869376,0.68018326,035-AAG,-0.335343058,160,197,357
5534,-1.350869376,0.68018326,035-AAH,-0.335343058,197,216,413
5535,-1.350869376,0.68018326,035-AAI,-0.335343058,346,286,632
5536,-1.350869376,0.68018326,035-ABC,-0.335343058,326,219,545
5537,-1.350869376,0.68018326,035-ABD,-0.335343058,282,106,388
5538,-1.350869376,0.68018326,035-ABE,-0.335343058,461,191,652
5539,-1.350869376,0.68018326,035-ABF,-0.335343058,235,192,427
5540,-1.350869376,0.68018326,035-ABG,-0.335343058,305,247,552
5541,-1.350869376,0.68018326,036-AAQ,-0.335343058,151,103,254
5542,-1.350869376,0.68018326,036-AAR,-0.335343058,255,106,361
5543,-1.350869376,0.68018326,036-AAS,-0.335343058,479,214,693
5544,-1.350869376,0.68018326,036-AAT,-0.335343058,465,194,659
5545,-1.350869376,0.68018326,036-AAU,-0.335343058,361,162,523
5546,-1.350869376,0.68018326,036-AAX,-0.335343058,494,181,675
5547,-1.350869376,0.68018326,036-AAY,-0.335343058,223,107,330
5548,-1.350869376,0.68018326,036-AAB,-0.335343058,158,158,316
5549,-1.350869376,0.68018326,036-AAC,-0.335343058,270,254,524
5550,-1.350869376,0.68018326,036-AAF,-0.335343058,178,197,375
5551,-1.350869376,0.68018326,036-AAH,-0.335343058,195,182,377
5552,-1.350869376,0.68018326,036-ABB,-0.335343058,238,116,354
5553,-1.350869376,0.68018326,036-AAI,-0.335343058,381,241,622
5554,-1.350869376,0.68018326,036-AAJ,-0.335343058,177,141,318
5555,-1.350869376,0.68018326,036-AAK,-0.335343058,236,191,427
5556,-1.350869376,0.68018326,036-AAL,-0.335343058,304,257,561
5557,-1.350869376,0.68018326,036-AAN,-0.335343058,265,184,449
5558,-1.350869376,0.68018326,036-AAO,-0.335343058,246,122,368
5559,-1.350869376,0.68018326,036-ABC,-0.335343058,297,192,489
5560,-1.350869376,0.68018326,036-AAZ,-0.335343058,289,191,480
5561,-1.350869376,0.68018326,036-ABD,-0.335343058,335,158,493
5562,-1.350869376,0.68018326,036-ABE,-0.335343058,383,144,527
5563,-1.350869376,0.68018326,036-ABF,-0.335343058,606,236,842
5564,-1.350869376,0.68018326,036-AAV,-0.335343058,417,199,616
5565,-1.350869376,0.68018326,036-ABG,-0.335343058,320,188,508
5566,-1.350869376,0.68018326,036-ABH,-0.335343058,270,160,430
5567,-1.350869376,0.68018326,036-ABI,-0.335343058,310,168,478
5568,-1.350869376,0.68018326,036-ABJ,-0.335343058,294,169,463
5569,-1.350869376,0.68018326,036-ABK,-0.335343058,354,155,509
5570,-1.350869376,0.68018326,036-ABL,-0.335343058,283,193,476
5571,-1.350869376,0.68018326,036-ABM,-0.335343058,268,274,542
5572,-1.350869376,0.68018326,036-ABN,-0.335343058,372,302,674
5573,-1.350869376,0.68018326,036-ABO,-0.335343058,490,209,699
5574,-1.350869376,0.68018326,036-ABP,-0.335343058,265,140,405
5575,-1.350869376,0.68018326,036-ABQ,-0.335343058,506,280,786
5576,-1.350869376,0.68018326,036-ABR,-0.335343058,378,172,550
5577,-1.350869376,0.68018326,036-ABT,-0.335343058,394,216,610
5578,-1.350869376,0.68018326,037-AAL,-0.335343058,192,229,421
5579,-1.350869376,0.68018326,037-ABD,-0.335343058,103,236,339
5580,-1.350869376,0.68018326,037-AAM,-0.335343058,201,145,346
5581,-1.350869376,0.68018326,037-AAN,-0.335343058,298,230,528
5582,-1.350869376,0.68018326,037-AAO,-0.335343058,160,134,294
5583,-1.350869376,0.68018326,037-AAP,-0.335343058,274,244,518
5584,-1.350869376,0.68018326,037-AAQ,-0.335343058,155,134,289
5585,-1.350869376,0.68018326,037-AAR,-0.335343058,228,166,394
5586,-1.350869376,0.68018326,037-AAS,-0.335343058,185,146,331
5587,-1.350869376,0.68018326,037-AAT,-0.335343058,309,270,579
5588,-1.350869376,0.68018326,037-AAU,-0.335343058,191,255,446
5589,-1.350869376,0.68018326,037-ABG,-0.335343058,187,146,333
5590,-1.350869376,0.68018326,037-AAV,-0.335343058,219,201,420
5591,-1.350869376,0.68018326,037-ABI,-0.335343058,136,111,247
5592,-1.350869376,0.68018326,037-AAY,-0.335343058,89,96,185
5593,-1.350869376,0.68018326,037-AAB,-0.335343058,126,140,266
5594,-1.350869376,0.68018326,037-AAC,-0.335343058,157,169,326
5595,-1.350869376,0.68018326,037-AAD,-0.335343058,125,112,237
5596,-1.350869376,0.68018326,037-AAE,-0.335343058,147,143,290
5597,-1.350869376,0.68018326,037-AAF,-0.335343058,165,205,370
5598,-1.350869376,0.68018326,037-AAG,-0.335343058,161,228,389
5599,-1.350869376,0.68018326,037-AAI,-0.335343058,263,216,479
5600,-1.350869376,0.68018326,037-AAJ,-0.335343058,151,177,328
5601,-1.350869376,0.68018326,037-AAK,-0.335343058,166,137,303
5602,-1.350869376,0.68018326,037-AAW,-0.335343058,278,212,490
5603,-1.350869376,0.68018326,037-AAX,-0.335343058,212,202,414
5604,-1.350869376,0.68018326,037-ABE,-0.335343058,57,147,204
5605,-1.350869376,0.68018326,037-AAZ,-0.335343058,231,224,455
5606,-1.350869376,0.68018326,037-ABH,-0.335343058,205,178,383
5607,-1.350869376,0.68018326,037-ABA,-0.335343058,218,213,431
5608,-1.350869376,0.68018326,037-ABB,-0.335343058,192,169,361
5609,-1.350869376,0.68018326,037-ABC,-0.335343058,142,211,353
5610,-1.350869376,0.68018326,037-ABF,-0.335343058,275,264,539
5611,-1.350869376,0.68018326,037-ABJ,-0.335343058,166,169,335
5612,-1.350869376,0.68018326,038-AAM,-0.335343058,91,28,119
5613,-1.350869376,0.68018326,038-AAA,-0.335343058,475,62,537
5614,-1.350869376,0.68018326,038-AAB,-0.335343058,323,65,388
5615,-1.350869376,0.68018326,038-AAC,-0.335343058,233,36,269
5616,-1.350869376,0.68018326,038-AAD,-0.335343058,776,279,1055
5617,-1.350869376,0.68018326,038-AAJ,-0.335343058,503,354,857
5618,-1.350869376,0.68018326,038-AAL,-0.335343058,382,173,555
5619,-1.350869376,0.68018326,038-AAN,-0.335343058,414,258,672
5620,-1.350869376,0.68018326,038-AAF,-0.335343058,517,346,863
5621,-1.350869376,0.68018326,038-AAH,-0.335343058,228,159,387
5622,-1.350869376,0.68018326,038-AAO,-0.335343058,529,204,733
5623,-1.350869376,0.68018326,038-AAP,-0.335343058,489,53,542
5624,-1.350869376,0.68018326,038-AAR,-0.335343058,535,202,737
5625,-1.350869376,0.68018326,038-AAT,-0.335343058,275,177,452
5626,-1.350869376,0.68018326,038-AAU,-0.335343058,550,282,832
5627,-1.350869376,0.68018326,038-AAW,-0.335343058,368,49,417
5628,-1.350869376,0.68018326,038-AAX,-0.335343058,605,107,712
5629,-1.350869376,0.68018326,038-AAY,-0.335343058,227,160,387
5630,-1.350869376,0.68018326,038-ABA,-0.335343058,200,147,347
5631,-1.350869376,0.68018326,039-AAA,-0.335343058,259,447,706
5632,-1.350869376,0.68018326,039-AAD,-0.335343058,308,379,687
5633,-1.350869376,0.68018326,039-ABI,-0.335343058,180,155,335
5634,-1.350869376,0.68018326,039-ABJ,-0.335343058,463,238,701
5635,-1.350869376,0.68018326,039-ABK,-0.335343058,407,311,718
5636,-1.350869376,0.68018326,039-ABL,-0.335343058,207,110,317
5637,-1.350869376,0.68018326,039-ABM,-0.335343058,91,87,178
5638,-1.350869376,0.68018326,039-ABN,-0.335343058,248,236,484
5639,-1.350869376,0.68018326,039-ABO,-0.335343058,477,324,801
5640,-1.350869376,0.68018326,039-ABP,-0.335343058,233,116,349
5641,-1.350869376,0.68018326,039-ABQ,-0.335343058,321,247,568
5642,-1.350869376,0.68018326,039-ABS,-0.335343058,259,220,479
5643,-1.350869376,0.68018326,039-ABT,-0.335343058,314,214,528
5644,-1.350869376,0.68018326,039-ACI,-0.335343058,230,335,565
5645,-1.350869376,0.68018326,039-ABU,-0.335343058,229,182,411
5646,-1.350869376,0.68018326,039-ABV,-0.335343058,230,127,357
5647,-1.350869376,0.68018326,039-ABX,-0.335343058,247,189,436
5648,-1.350869376,0.68018326,039-ABY,-0.335343058,178,255,433
5649,-1.350869376,0.68018326,039-ABZ,-0.335343058,258,218,476
5650,-1.350869376,0.68018326,039-AAG,-0.335343058,359,352,711
5651,-1.350869376,0.68018326,039-AAH,-0.335343058,345,476,821
5652,-1.350869376,0.68018326,039-AAI,-0.335343058,217,276,493
5653,-1.350869376,0.68018326,039-AAL,-0.335343058,362,260,622
5654,-1.350869376,0.68018326,039-AAM,-0.335343058,284,336,620
5655,-1.350869376,0.68018326,039-AAN,-0.335343058,324,346,670
5656,-1.350869376,0.68018326,039-AAQ,-0.335343058,161,248,409
5657,-1.350869376,0.68018326,039-AAR,-0.335343058,259,251,510
5658,-1.350869376,0.68018326,039-AAS,-0.335343058,298,224,522
5659,-1.350869376,0.68018326,039-AAV,-0.335343058,174,324,498
5660,-1.350869376,0.68018326,039-AAW,-0.335343058,224,246,470
5661,-1.350869376,0.68018326,039-AAX,-0.335343058,261,309,570
5662,-1.350869376,0.68018326,039-ACB,-0.335343058,304,312,616
5663,-1.350869376,0.68018326,039-ACD,-0.335343058,213,151,364
5664,-1.350869376,0.68018326,039-ACC,-0.335343058,307,269,576
5665,-1.350869376,0.68018326,039-ACE,-0.335343058,320,206,526
5666,-1.350869376,0.68018326,039-ACF,-0.335343058,276,299,575
5667,-1.350869376,0.68018326,039-ABW,-0.335343058,172,133,305
5668,-1.350869376,0.68018326,039-ACG,-0.335343058,302,169,471
5669,-1.350869376,0.68018326,039-ACH,-0.335343058,271,229,500
5670,-1.350869376,0.68018326,039-ACK,-0.335343058,253,120,373
5671,-1.350869376,0.68018326,039-ACL,-0.335343058,143,119,262
5672,-1.350869376,0.68018326,039-ACM,-0.335343058,206,175,381
5673,-1.350869376,0.68018326,039-ACN,-0.335343058,158,221,379
5674,-1.350869376,0.68018326,039-ACO,-0.335343058,139,178,317
5675,-1.350869376,0.68018326,039-ACP,-0.335343058,150,162,312
5676,-1.350869376,0.68018326,039-ACQ,-0.335343058,223,236,459
5677,-1.350869376,0.68018326,039-ABA,-0.335343058,144,197,341
5678,-1.350869376,0.68018326,039-ABC,-0.335343058,117,186,303
5679,-1.350869376,0.68018326,039-ABE,-0.335343058,122,96,218
5680,-1.350869376,0.68018326,039-ABF,-0.335343058,272,218,490
5681,-1.350869376,0.68018326,039-ABG,-0.335343058,103,126,229
5682,-1.350869376,0.68018326,039-ABH,-0.335343058,282,236,518
5683,-1.350869376,0.68018326,040-AAS,-0.335343058,279,156,435
5684,-1.350869376,0.68018326,040-AAV,-0.335343058,134,77,211
5685,-1.350869376,0.68018326,040-AAT,-0.335343058,367,214,581
5686,-1.350869376,0.68018326,040-ABO,-0.335343058,366,185,551
5687,-1.350869376,0.68018326,040-AAW,-0.335343058,277,150,427
5688,-1.350869376,0.68018326,040-AAX,-0.335343058,149,95,244
5689,-1.350869376,0.68018326,040-AAY,-0.335343058,329,247,576
5690,-1.350869376,0.68018326,040-AAA,-0.335343058,120,76,196
5691,-1.350869376,0.68018326,040-AAB,-0.335343058,388,191,579
5692,-1.350869376,0.68018326,040-AAC,-0.335343058,275,262,537
5693,-1.350869376,0.68018326,040-AAE,-0.335343058,163,123,286
5694,-1.350869376,0.68018326,040-AAG,-0.335343058,159,89,248
5695,-1.350869376,0.68018326,040-AAH,-0.335343058,279,152,431
5696,-1.350869376,0.68018326,040-AAI,-0.335343058,259,147,406
5697,-1.350869376,0.68018326,040-AAZ,-0.335343058,260,161,421
5698,-1.350869376,0.68018326,040-ABA,-0.335343058,253,245,498
5699,-1.350869376,0.68018326,040-ABP,-0.335343058,229,115,344
5700,-1.350869376,0.68018326,040-ABC,-0.335343058,298,216,514
5701,-1.350869376,0.68018326,040-ABD,-0.335343058,156,144,300
5702,-1.350869376,0.68018326,040-ABE,-0.335343058,308,190,498
5703,-1.350869376,0.68018326,040-ABF,-0.335343058,249,124,373
5704,-1.350869376,0.68018326,040-ABG,-0.335343058,207,108,315
5705,-1.350869376,0.68018326,040-ABH,-0.335343058,214,137,351
5706,-1.350869376,0.68018326,040-ABJ,-0.335343058,258,209,467
5707,-1.350869376,0.68018326,040-ABI,-0.335343058,152,87,239
5708,-1.350869376,0.68018326,040-ABB,-0.335343058,239,144,383
5709,-1.350869376,0.68018326,040-ABQ,-0.335343058,234,133,367
5710,-1.350869376,0.68018326,040-ABM,-0.335343058,193,144,337
5711,-1.350869376,0.68018326,040-ABN,-0.335343058,225,135,360
5712,-1.350869376,0.68018326,040-AAJ,-0.335343058,263,200,463
5713,-1.350869376,0.68018326,040-AAL,-0.335343058,125,106,231
5714,-1.350869376,0.68018326,040-AAM,-0.335343058,133,94,227
5715,-1.350869376,0.68018326,040-AAN,-0.335343058,220,144,364
5716,-1.350869376,0.68018326,040-AAO,-0.335343058,160,146,306
5717,-1.350869376,0.68018326,040-AAQ,-0.335343058,127,76,203
5718,-1.350869376,0.68018326,040-AAR,-0.335343058,172,175,347
5719,-1.350869376,0.68018326,041-ADB,-0.335343058,128,200,328
5720,-1.350869376,0.68018326,041-ADG,-0.335343058,63,149,212
5721,-1.350869376,0.68018326,041-ABJ,-0.335343058,522,364,886
5722,-1.350869376,0.68018326,041-AEB,-0.335343058,316,203,519
5723,-1.350869376,0.68018326,041-ADH,-0.335343058,155,121,276
5724,-1.350869376,0.68018326,041-AEC,-0.335343058,55,53,108
5725,-1.350869376,0.68018326,041-ABL,-0.335343058,327,281,608
5726,-1.350869376,0.68018326,041-AEH,-0.335343058,342,304,646
5727,-1.350869376,0.68018326,041-ABI,-0.335343058,109,108,217
5728,-1.350869376,0.68018326,041-ADS,-0.335343058,238,345,583
5729,-1.350869376,0.68018326,041-ABM,-0.335343058,99,85,184
5730,-1.350869376,0.68018326,041-ACT,-0.335343058,92,196,288
5731,-1.350869376,0.68018326,041-ADI,-0.335343058,264,290,554
5732,-1.350869376,0.68018326,041-ACP,-0.335343058,207,296,503
5733,-1.350869376,0.68018326,041-ACK,-0.335343058,53,74,127
5734,-1.350869376,0.68018326,041-ADK,-0.335343058,94,125,219
5735,-1.350869376,0.68018326,041-ADT,-0.335343058,88,227,315
5736,-1.350869376,0.68018326,041-ACL,-0.335343058,205,151,356
5737,-1.350869376,0.68018326,041-ACR,-0.335343058,81,146,227
5738,-1.350869376,0.68018326,041-ACZ,-0.335343058,58,111,169
5739,-1.350869376,0.68018326,041-ABY,-0.335343058,267,237,504
5740,-1.350869376,0.68018326,041-ADC,-0.335343058,96,165,261
5741,-1.350869376,0.68018326,041-ABN,-0.335343058,243,193,436
5742,-1.350869376,0.68018326,041-ADM,-0.335343058,223,324,547
5743,-1.350869376,0.68018326,041-ADN,-0.335343058,168,253,421
5744,-1.350869376,0.68018326,041-ADO,-0.335343058,230,256,486
5745,-1.350869376,0.68018326,041-ADP,-0.335343058,189,216,405
5746,-1.350869376,0.68018326,041-ACS,-0.335343058,102,137,239
5747,-1.350869376,0.68018326,041-ABZ,-0.335343058,312,142,454
5748,-1.350869376,0.68018326,041-ABO,-0.335343058,70,46,116
5749,-1.350869376,0.68018326,041-ACN,-0.335343058,438,276,714
5750,-1.350869376,0.68018326,041-ADD,-0.335343058,84,169,253
5751,-1.350869376,0.68018326,041-ADE,-0.335343058,131,160,291
5752,-1.350869376,0.68018326,041-ACA,-0.335343058,329,272,601
5753,-1.350869376,0.68018326,041-ACB,-0.335343058,421,308,729
5754,-1.350869376,0.68018326,041-ADU,-0.335343058,78,132,210
5755,-1.350869376,0.68018326,041-ACV,-0.335343058,162,100,262
5756,-1.350869376,0.68018326,041-ACU,-0.335343058,216,110,326
5757,-1.350869376,0.68018326,041-ACW,-0.335343058,301,155,456
5758,-1.350869376,0.68018326,041-ADA,-0.335343058,214,216,430
5759,-1.350869376,0.68018326,041-ACX,-0.335343058,607,383,990
5760,-1.350869376,0.68018326,041-ADF,-0.335343058,90,285,375
5761,-1.350869376,0.68018326,041-ABR,-0.335343058,110,80,190
5762,-1.350869376,0.68018326,041-ADL,-0.335343058,75,72,147
5763,-1.350869376,0.68018326,041-AAA,-0.335343058,40,227,267
5764,-1.350869376,0.68018326,041-AAB,-0.335343058,98,283,381
5765,-1.350869376,0.68018326,041-AAC,-0.335343058,126,296,422
5766,-1.350869376,0.68018326,041-AAE,-0.335343058,276,259,535
5767,-1.350869376,0.68018326,041-AAF,-0.335343058,283,368,651
5768,-1.350869376,0.68018326,041-AAG,-0.335343058,164,172,336
5769,-1.350869376,0.68018326,041-AAI,-0.335343058,208,219,427
5770,-1.350869376,0.68018326,041-AAJ,-0.335343058,275,215,490
5771,-1.350869376,0.68018326,041-AAK,-0.335343058,332,253,585
5772,-1.350869376,0.68018326,041-AAM,-0.335343058,67,272,339
5773,-1.350869376,0.68018326,041-AAN,-0.335343058,86,270,356
5774,-1.350869376,0.68018326,041-AAO,-0.335343058,496,103,599
5775,-1.350869376,0.68018326,041-AAQ,-0.335343058,211,237,448
5776,-1.350869376,0.68018326,041-AAR,-0.335343058,282,230,512
5777,-1.350869376,0.68018326,041-AAS,-0.335343058,233,215,448
5778,-1.350869376,0.68018326,041-AAT,-0.335343058,251,228,479
5779,-1.350869376,0.68018326,041-AAU,-0.335343058,136,94,230
5780,-1.350869376,0.68018326,041-AAV,-0.335343058,258,219,477
5781,-1.350869376,0.68018326,041-AAW,-0.335343058,360,191,551
5782,-1.350869376,0.68018326,041-AAX,-0.335343058,381,283,664
5783,-1.350869376,0.68018326,041-ACO,-0.335343058,75,84,159
5784,-1.350869376,0.68018326,041-ADW,-0.335343058,251,435,686
5785,-1.350869376,0.68018326,041-ABA,-0.335343058,283,319,602
5786,-1.350869376,0.68018326,041-ABC,-0.335343058,319,316,635
5787,-1.350869376,0.68018326,041-ABE,-0.335343058,320,284,604
5788,-1.350869376,0.68018326,041-ABG,-0.335343058,285,318,603
5789,-1.350869376,0.68018326,041-ACE,-0.335343058,239,239,478
5790,-1.350869376,0.68018326,041-AEE,-0.335343058,364,256,620
5791,-1.350869376,0.68018326,041-AEF,-0.335343058,141,129,270
5792,-1.350869376,0.68018326,041-AEG,-0.335343058,179,266,445
5793,-1.350869376,0.68018326,041-ACF,-0.335343058,209,124,333
5794,-1.350869376,0.68018326,041-ABS,-0.335343058,325,293,618
5795,-1.350869376,0.68018326,041-ABT,-0.335343058,308,306,614
5796,-1.350869376,0.68018326,041-ABU,-0.335343058,326,285,611
5797,-1.350869376,0.68018326,041-ABV,-0.335343058,186,220,406
5798,-1.350869376,0.68018326,041-ACI,-0.335343058,317,270,587
5799,-1.350869376,0.68018326,041-ACH,-0.335343058,119,118,237
5800,-1.350869376,0.68018326,041-AEA,-0.335343058,98,223,321
5801,-1.350869376,0.68018326,042-AAO,-0.335343058,352,135,487
5802,-1.350869376,0.68018326,042-AAP,-0.335343058,278,174,452
5803,-1.350869376,0.68018326,042-AAQ,-0.335343058,451,249,700
5804,-1.350869376,0.68018326,042-AAR,-0.335343058,213,91,304
5805,-1.350869376,0.68018326,042-AAZ,-0.335343058,445,262,707
5806,-1.350869376,0.68018326,042-AAS,-0.335343058,405,184,589
5807,-1.350869376,0.68018326,042-AAT,-0.335343058,262,126,388
5808,-1.350869376,0.68018326,042-AAU,-0.335343058,250,192,442
5809,-1.350869376,0.68018326,042-AAV,-0.335343058,343,200,543
5810,-1.350869376,0.68018326,042-AAW,-0.335343058,99,113,212
5811,-1.350869376,0.68018326,042-ABT,-0.335343058,229,159,388
5812,-1.350869376,0.68018326,042-ABV,-0.335343058,136,76,212
5813,-1.350869376,0.68018326,042-ABW,-0.335343058,305,158,463
5814,-1.350869376,0.68018326,042-ACA,-0.335343058,308,161,469
5815,-1.350869376,0.68018326,042-AAX,-0.335343058,141,1164,1305
5816,-1.350869376,0.68018326,042-AAY,-0.335343058,286,144,430
5817,-1.350869376,0.68018326,042-ABA,-0.335343058,337,159,496
5818,-1.350869376,0.68018326,042-ACB,-0.335343058,329,160,489
5819,-1.350869376,0.68018326,042-ABB,-0.335343058,235,147,382
5820,-1.350869376,0.68018326,042-ABC,-0.335343058,277,164,441
5821,-1.350869376,0.68018326,042-ABD,-0.335343058,260,121,381
5822,-1.350869376,0.68018326,042-ABE,-0.335343058,261,176,437
5823,-1.350869376,0.68018326,042-ACC,-0.335343058,244,168,412
5824,-1.350869376,0.68018326,042-ACE,-0.335343058,285,175,460
5825,-1.350869376,0.68018326,042-ACF,-0.335343058,276,186,462
5826,-1.350869376,0.68018326,042-ABF,-0.335343058,312,105,417
5827,-1.350869376,0.68018326,042-ABG,-0.335343058,177,104,281
5828,-1.350869376,0.68018326,042-ABZ,-0.335343058,255,127,382
5829,-1.350869376,0.68018326,042-ABH,-0.335343058,343,174,517
5830,-1.350869376,0.68018326,042-ABI,-0.335343058,338,136,474
5831,-1.350869376,0.68018326,042-ABJ,-0.335343058,317,151,468
5832,-1.350869376,0.68018326,042-ACD,-0.335343058,283,177,460
5833,-1.350869376,0.68018326,042-ABK,-0.335343058,371,149,520
5834,-1.350869376,0.68018326,042-ABL,-0.335343058,324,218,542
5835,-1.350869376,0.68018326,042-ABM,-0.335343058,313,239,552
5836,-1.350869376,0.68018326,042-ABN,-0.335343058,362,176,538
5837,-1.350869376,0.68018326,042-ABO,-0.335343058,305,142,447
5838,-1.350869376,0.68018326,042-ABP,-0.335343058,375,217,592
5839,-1.350869376,0.68018326,042-AAA,-0.335343058,162,140,302
5840,-1.350869376,0.68018326,042-AAB,-0.335343058,230,221,451
5841,-1.350869376,0.68018326,042-AAC,-0.335343058,364,225,589
5842,-1.350869376,0.68018326,042-AAD,-0.335343058,243,183,426
5843,-1.350869376,0.68018326,042-AAE,-0.335343058,216,178,394
5844,-1.350869376,0.68018326,042-AAF,-0.335343058,154,129,283
5845,-1.350869376,0.68018326,042-AAG,-0.335343058,326,269,595
5846,-1.350869376,0.68018326,042-AAH,-0.335343058,190,188,378
5847,-1.350869376,0.68018326,042-AAI,-0.335343058,337,273,610
5848,-1.350869376,0.68018326,042-AAJ,-0.335343058,318,239,557
5849,-1.350869376,0.68018326,042-ABY,-0.335343058,346,222,568
5850,-1.350869376,0.68018326,042-AAK,-0.335343058,197,195,392
5851,-1.350869376,0.68018326,042-AAL,-0.335343058,166,173,339
5852,-1.350869376,0.68018326,042-AAM,-0.335343058,260,168,428
5853,-1.350869376,0.68018326,042-AAN,-0.335343058,222,185,407
5854,-1.350869376,0.68018326,042-ABQ,-0.335343058,453,190,643
5855,-1.350869376,0.68018326,042-ABR,-0.335343058,317,170,487
5856,-1.350869376,0.68018326,042-ABS,-0.335343058,311,167,478
5857,-1.350869376,0.68018326,042-ABU,-0.335343058,382,200,582
5858,-1.350869376,0.68018326,042-ABX,-0.335343058,364,140,504
5859,-1.350869376,0.68018326,043-AFJ,-0.335343058,408,257,665
5860,-1.350869376,0.68018326,043-AFK,-0.335343058,666,290,956
5861,-1.350869376,0.68018326,043-AFL,-0.335343058,335,246,581
5862,-1.350869376,0.68018326,043-AFM,-0.335343058,346,330,676
5863,-1.350869376,0.68018326,043-AFN,-0.335343058,327,353,680
5864,-1.350869376,0.68018326,043-AFO,-0.335343058,344,243,587
5865,-1.350869376,0.68018326,043-AFP,-0.335343058,548,314,862
5866,-1.350869376,0.68018326,043-AFQ,-0.335343058,364,295,659
5867,-1.350869376,0.68018326,043-AFR,-0.335343058,423,262,685
5868,-1.350869376,0.68018326,043-AFS,-0.335343058,497,335,832
5869,-1.350869376,0.68018326,043-AHX,-0.335343058,335,241,576
5870,-1.350869376,0.68018326,043-AHY,-0.335343058,379,195,574
5871,-1.350869376,0.68018326,043-AHZ,-0.335343058,401,405,806
5872,-1.350869376,0.68018326,043-AIA,-0.335343058,299,236,535
5873,-1.350869376,0.68018326,043-AIB,-0.335343058,793,377,1170
5874,-1.350869376,0.68018326,043-AAA,-0.335343058,253,293,546
5875,-1.350869376,0.68018326,043-AAB,-0.335343058,198,324,522
5876,-1.350869376,0.68018326,043-AAC,-0.335343058,201,309,510
5877,-1.350869376,0.68018326,043-AAD,-0.335343058,360,388,748
5878,-1.350869376,0.68018326,043-AAE,-0.335343058,253,361,614
5879,-1.350869376,0.68018326,043-AAF,-0.335343058,224,272,496
5880,-1.350869376,0.68018326,043-AAG,-0.335343058,237,340,577
5881,-1.350869376,0.68018326,043-AAH,-0.335343058,202,248,450
5882,-1.350869376,0.68018326,043-AAI,-0.335343058,197,266,463
5883,-1.350869376,0.68018326,043-AAJ,-0.335343058,141,226,367
5884,-1.350869376,0.68018326,043-AAK,-0.335343058,185,246,431
5885,-1.350869376,0.68018326,043-AAL,-0.335343058,303,318,621
5886,-1.350869376,0.68018326,043-AAM,-0.335343058,221,271,492
5887,-1.350869376,0.68018326,043-AAN,-0.335343058,277,303,580
5888,-1.350869376,0.68018326,043-AAO,-0.335343058,236,267,503
5889,-1.350869376,0.68018326,043-AAP,-0.335343058,212,346,558
5890,-1.350869376,0.68018326,043-AAQ,-0.335343058,175,173,348
5891,-1.350869376,0.68018326,043-AAR,-0.335343058,232,239,471
5892,-1.350869376,0.68018326,043-AGT,-0.335343058,304,478,782
5893,-1.350869376,0.68018326,043-AGU,-0.335343058,335,440,775
5894,-1.350869376,0.68018326,043-AGY,-0.335343058,113,121,234
5895,-1.350869376,0.68018326,043-AAS,-0.335343058,276,170,446
5896,-1.350869376,0.68018326,043-AHG,-0.335343058,177,223,400
5897,-1.350869376,0.68018326,043-AAT,-0.335343058,291,187,478
5898,-1.350869376,0.68018326,043-AHH,-0.335343058,410,177,587
5899,-1.350869376,0.68018326,043-AAU,-0.335343058,334,263,597
5900,-1.350869376,0.68018326,043-AHI,-0.335343058,285,220,505
5901,-1.350869376,0.68018326,043-AAV,-0.335343058,398,232,630
5902,-1.350869376,0.68018326,043-AHJ,-0.335343058,255,158,413
5903,-1.350869376,0.68018326,043-AFT,-0.335343058,287,146,433
5904,-1.350869376,0.68018326,043-AFU,-0.335343058,48,80,128
5905,-1.350869376,0.68018326,043-AFV,-0.335343058,412,280,692
5906,-1.350869376,0.68018326,043-AFW,-0.335343058,310,240,550
5907,-1.350869376,0.68018326,043-AIC,-0.335343058,416,253,669
5908,-1.350869376,0.68018326,043-AFX,-0.335343058,306,397,703
5909,-1.350869376,0.68018326,043-AFY,-0.335343058,184,221,405
5910,-1.350869376,0.68018326,043-AFZ,-0.335343058,301,424,725
5911,-1.350869376,0.68018326,043-AGA,-0.335343058,403,366,769
5912,-1.350869376,0.68018326,043-AGB,-0.335343058,284,310,594
5913,-1.350869376,0.68018326,043-AGC,-0.335343058,295,342,637
5914,-1.350869376,0.68018326,043-AGD,-0.335343058,342,387,729
5915,-1.350869376,0.68018326,043-AGE,-0.335343058,391,340,731
5916,-1.350869376,0.68018326,043-AGF,-0.335343058,284,166,450
5917,-1.350869376,0.68018326,043-AGG,-0.335343058,195,312,507
5918,-1.350869376,0.68018326,043-AIE,-0.335343058,176,276,452
5919,-1.350869376,0.68018326,043-AIF,-0.335343058,311,250,561
5920,-1.350869376,0.68018326,043-AGH,-0.335343058,311,327,638
5921,-1.350869376,0.68018326,043-AGI,-0.335343058,306,259,565
5922,-1.350869376,0.68018326,043-AID,-0.335343058,255,243,498
5923,-1.350869376,0.68018326,043-AAW,-0.335343058,360,334,694
5924,-1.350869376,0.68018326,043-AAX,-0.335343058,312,363,675
5925,-1.350869376,0.68018326,043-AAY,-0.335343058,222,249,471
5926,-1.350869376,0.68018326,043-AHK,-0.335343058,406,320,726
5927,-1.350869376,0.68018326,043-AAZ,-0.335343058,374,284,658
5928,-1.350869376,0.68018326,043-ABA,-0.335343058,267,328,595
5929,-1.350869376,0.68018326,043-ABB,-0.335343058,320,241,561
5930,-1.350869376,0.68018326,043-ABC,-0.335343058,360,224,584
5931,-1.350869376,0.68018326,043-ABD,-0.335343058,394,333,727
5932,-1.350869376,0.68018326,043-ABE,-0.335343058,362,241,603
5933,-1.350869376,0.68018326,043-AHL,-0.335343058,323,284,607
5934,-1.350869376,0.68018326,043-AHM,-0.335343058,204,169,373
5935,-1.350869376,0.68018326,043-ABF,-0.335343058,263,263,526
5936,-1.350869376,0.68018326,043-ABG,-0.335343058,176,209,385
5937,-1.350869376,0.68018326,043-ABH,-0.335343058,266,285,551
5938,-1.350869376,0.68018326,043-ABI,-0.335343058,224,208,432
5939,-1.350869376,0.68018326,043-ABJ,-0.335343058,261,204,465
5940,-1.350869376,0.68018326,043-ABK,-0.335343058,252,273,525
5941,-1.350869376,0.68018326,043-ABL,-0.335343058,305,243,548
5942,-1.350869376,0.68018326,043-ABM,-0.335343058,200,185,385
5943,-1.350869376,0.68018326,043-ABN,-0.335343058,350,285,635
5944,-1.350869376,0.68018326,043-ABO,-0.335343058,273,350,623
5945,-1.350869376,0.68018326,043-ABP,-0.335343058,316,253,569
5946,-1.350869376,0.68018326,043-AHN,-0.335343058,260,256,516
5947,-1.350869376,0.68018326,043-ABQ,-0.335343058,232,263,495
5948,-1.350869376,0.68018326,043-ABR,-0.335343058,267,358,625
5949,-1.350869376,0.68018326,043-ABS,-0.335343058,360,341,701
5950,-1.350869376,0.68018326,043-ABT,-0.335343058,342,365,707
5951,-1.350869376,0.68018326,043-ABU,-0.335343058,327,360,687
5952,-1.350869376,0.68018326,043-ABV,-0.335343058,279,264,543
5953,-1.350869376,0.68018326,043-ABW,-0.335343058,321,316,637
5954,-1.350869376,0.68018326,043-ABX,-0.335343058,412,337,749
5955,-1.350869376,0.68018326,043-AHO,-0.335343058,335,318,653
5956,-1.350869376,0.68018326,043-AHP,-0.335343058,167,227,394
5957,-1.350869376,0.68018326,043-AHQ,-0.335343058,341,310,651
5958,-1.350869376,0.68018326,043-ABY,-0.335343058,307,296,603
5959,-1.350869376,0.68018326,043-ABZ,-0.335343058,582,428,1010
5960,-1.350869376,0.68018326,043-ACA,-0.335343058,267,343,610
5961,-1.350869376,0.68018326,043-ACB,-0.335343058,241,339,580
5962,-1.350869376,0.68018326,043-ACC,-0.335343058,309,344,653
5963,-1.350869376,0.68018326,043-ACD,-0.335343058,394,318,712
5964,-1.350869376,0.68018326,043-ACE,-0.335343058,336,311,647
5965,-1.350869376,0.68018326,043-ACF,-0.335343058,368,363,731
5966,-1.350869376,0.68018326,043-AHR,-0.335343058,402,321,723
5967,-1.350869376,0.68018326,043-AHS,-0.335343058,346,260,606
5968,-1.350869376,0.68018326,043-ACG,-0.335343058,154,230,384
5969,-1.350869376,0.68018326,043-ACH,-0.335343058,211,274,485
5970,-1.350869376,0.68018326,043-ACI,-0.335343058,277,286,563
5971,-1.350869376,0.68018326,043-ACJ,-0.335343058,287,304,591
5972,-1.350869376,0.68018326,043-ACK,-0.335343058,253,301,554
5973,-1.350869376,0.68018326,043-AHT,-0.335343058,200,250,450
5974,-1.350869376,0.68018326,043-AHU,-0.335343058,221,284,505
5975,-1.350869376,0.68018326,043-AHC,-0.335343058,312,206,518
5976,-1.350869376,0.68018326,043-ACL,-0.335343058,77,268,345
5977,-1.350869376,0.68018326,043-ACM,-0.335343058,189,316,505
5978,-1.350869376,0.68018326,043-ACN,-0.335343058,82,425,507
5979,-1.350869376,0.68018326,043-ACP,-0.335343058,126,249,375
5980,-1.350869376,0.68018326,043-ACQ,-0.335343058,244,389,633
5981,-1.350869376,0.68018326,043-ACR,-0.335343058,131,210,341
5982,-1.350869376,0.68018326,043-ACT,-0.335343058,178,265,443
5983,-1.350869376,0.68018326,043-ACU,-0.335343058,281,396,677
5984,-1.350869376,0.68018326,043-ACV,-0.335343058,89,240,329
5985,-1.350869376,0.68018326,043-ACW,-0.335343058,180,337,517
5986,-1.350869376,0.68018326,043-ACX,-0.335343058,405,601,1006
5987,-1.350869376,0.68018326,043-ACY,-0.335343058,79,342,421
5988,-1.350869376,0.68018326,043-ACZ,-0.335343058,129,330,459
5989,-1.350869376,0.68018326,043-AGJ,-0.335343058,507,492,999
5990,-1.350869376,0.68018326,043-AGK,-0.335343058,255,269,524
5991,-1.350869376,0.68018326,043-AGL,-0.335343058,203,256,459
5992,-1.350869376,0.68018326,043-AGM,-0.335343058,326,216,542
5993,-1.350869376,0.68018326,043-AGN,-0.335343058,337,331,668
5994,-1.350869376,0.68018326,043-AGO,-0.335343058,280,258,538
5995,-1.350869376,0.68018326,043-AGP,-0.335343058,187,278,465
5996,-1.350869376,0.68018326,043-AGQ,-0.335343058,147,210,357
5997,-1.350869376,0.68018326,043-AGR,-0.335343058,299,271,570
5998,-1.350869376,0.68018326,043-AGS,-0.335343058,260,270,530
5999,-1.350869376,0.68018326,043-AIG,-0.335343058,240,227,467
6000,-1.350869376,0.68018326,043-AIH,-0.335343058,445,437,882
6001,-1.350869376,0.68018326,043-AII,-0.335343058,282,239,521
6002,-1.350869376,0.68018326,043-AIJ,-0.335343058,189,185,374
6003,-1.350869376,0.68018326,043-AIK,-0.335343058,385,271,656
6004,-1.350869376,0.68018326,043-AGZ,-0.335343058,353,241,594
6005,-1.350869376,0.68018326,043-AHA,-0.335343058,188,178,366
6006,-1.350869376,0.68018326,043-AHB,-0.335343058,259,221,480
6007,-1.350869376,0.68018326,043-AIL,-0.335343058,245,246,491
6008,-1.350869376,0.68018326,043-AIM,-0.335343058,362,291,653
6009,-1.350869376,0.68018326,043-AIN,-0.335343058,403,345,748
6010,-1.350869376,0.68018326,043-AHD,-0.335343058,423,361,784
6011,-1.350869376,0.68018326,043-AHE,-0.335343058,228,232,460
6012,-1.350869376,0.68018326,043-AHF,-0.335343058,236,84,320
6013,-1.350869376,0.68018326,043-ADB,-0.335343058,290,329,619
6014,-1.350869376,0.68018326,043-ADC,-0.335343058,212,214,426
6015,-1.350869376,0.68018326,043-ADD,-0.335343058,200,261,461
6016,-1.350869376,0.68018326,043-ADE,-0.335343058,158,136,294
6017,-1.350869376,0.68018326,043-ADF,-0.335343058,175,199,374
6018,-1.350869376,0.68018326,043-ADG,-0.335343058,295,190,485
6019,-1.350869376,0.68018326,043-ADH,-0.335343058,235,278,513
6020,-1.350869376,0.68018326,043-ADI,-0.335343058,145,181,326
6021,-1.350869376,0.68018326,043-ADJ,-0.335343058,184,223,407
6022,-1.350869376,0.68018326,043-ADK,-0.335343058,209,266,475
6023,-1.350869376,0.68018326,043-ADL,-0.335343058,150,167,317
6024,-1.350869376,0.68018326,043-ADM,-0.335343058,207,343,550
6025,-1.350869376,0.68018326,043-ADN,-0.335343058,243,198,441
6026,-1.350869376,0.68018326,043-ADO,-0.335343058,138,249,387
6027,-1.350869376,0.68018326,043-ADP,-0.335343058,157,209,366
6028,-1.350869376,0.68018326,043-ADQ,-0.335343058,251,217,468
6029,-1.350869376,0.68018326,043-ADR,-0.335343058,272,349,621
6030,-1.350869376,0.68018326,043-ADS,-0.335343058,406,452,858
6031,-1.350869376,0.68018326,043-ADT,-0.335343058,229,346,575
6032,-1.350869376,0.68018326,043-ADV,-0.335343058,334,502,836
6033,-1.350869376,0.68018326,043-ADU,-0.335343058,241,262,503
6034,-1.350869376,0.68018326,043-ADW,-0.335343058,390,310,700
6035,-1.350869376,0.68018326,043-AHV,-0.335343058,425,387,812
6036,-1.350869376,0.68018326,043-ADX,-0.335343058,84,151,235
6037,-1.350869376,0.68018326,043-ADY,-0.335343058,205,221,426
6038,-1.350869376,0.68018326,043-ADZ,-0.335343058,210,272,482
6039,-1.350869376,0.68018326,043-AEA,-0.335343058,193,238,431
6040,-1.350869376,0.68018326,043-AEB,-0.335343058,230,195,425
6041,-1.350869376,0.68018326,043-AEC,-0.335343058,275,297,572
6042,-1.350869376,0.68018326,043-.00,-0.335343058,432,449,881
6043,-1.350869376,0.68018326,043-AEE,-0.335343058,275,250,525
6044,-1.350869376,0.68018326,043-AEF,-0.335343058,155,232,387
6045,-1.350869376,0.68018326,043-AEG,-0.335343058,520,438,958
6046,-1.350869376,0.68018326,043-AEI,-0.335343058,232,256,488
6047,-1.350869376,0.68018326,043-AEJ,-0.335343058,274,231,505
6048,-1.350869376,0.68018326,043-AEK,-0.335343058,221,152,373
6049,-1.350869376,0.68018326,043-AEL,-0.335343058,237,152,389
6050,-1.350869376,0.68018326,043-AEM,-0.335343058,387,271,658
6051,-1.350869376,0.68018326,043-AEN,-0.335343058,321,235,556
6052,-1.350869376,0.68018326,043-AEO,-0.335343058,152,556,708
6053,-1.350869376,0.68018326,043-AEP,-0.335343058,442,272,714
6054,-1.350869376,0.68018326,043-AEQ,-0.335343058,275,205,480
6055,-1.350869376,0.68018326,043-AER,-0.335343058,173,404,577
6056,-1.350869376,0.68018326,043-AES,-0.335343058,158,262,420
6057,-1.350869376,0.68018326,043-AHW,-0.335343058,255,220,475
6058,-1.350869376,0.68018326,043-AET,-0.335343058,196,219,415
6059,-1.350869376,0.68018326,043-AEU,-0.335343058,188,271,459
6060,-1.350869376,0.68018326,043-AEV,-0.335343058,164,241,405
6061,-1.350869376,0.68018326,043-AEW,-0.335343058,228,258,486
6062,-1.350869376,0.68018326,043-AEX,-0.335343058,182,258,440
6063,-1.350869376,0.68018326,043-AEY,-0.335343058,208,270,478
6064,-1.350869376,0.68018326,043-AEZ,-0.335343058,233,293,526
6065,-1.350869376,0.68018326,043-AFA,-0.335343058,167,222,389
6066,-1.350869376,0.68018326,043-AFB,-0.335343058,188,276,464
6067,-1.350869376,0.68018326,043-AFC,-0.335343058,235,282,517
6068,-1.350869376,0.68018326,043-AFD,-0.335343058,167,159,326
6069,-1.350869376,0.68018326,043-AFE,-0.335343058,213,284,497
6070,-1.350869376,0.68018326,043-AFF,-0.335343058,161,153,314
6071,-1.350869376,0.68018326,043-AFG,-0.335343058,246,280,526
6072,-1.350869376,0.68018326,043-AFH,-0.335343058,179,213,392
6073,-1.350869376,0.68018326,043-AFI,-0.335343058,239,314,553
6074,-1.350869376,0.68018326,044-AAZ,-0.335343058,190,104,294
6075,-1.350869376,0.68018326,044-ABA,-0.335343058,68,54,122
6076,-1.350869376,0.68018326,044-ACC,-0.335343058,79,80,159
6077,-1.350869376,0.68018326,044-ACM,-0.335343058,210,109,319
6078,-1.350869376,0.68018326,044-ACN,-0.335343058,180,96,276
6079,-1.350869376,0.68018326,044-ABL,-0.335343058,205,223,428
6080,-1.350869376,0.68018326,044-ABM,-0.335343058,289,227,516
6081,-1.350869376,0.68018326,044-ABN,-0.335343058,198,241,439
6082,-1.350869376,0.68018326,044-ACU,-0.335343058,77,50,127
6083,-1.350869376,0.68018326,044-ACV,-0.335343058,124,87,211
6084,-1.350869376,0.68018326,044-ADA,-0.335343058,110,109,219
6085,-1.350869376,0.68018326,044-ADB,-0.335343058,237,157,394
6086,-1.350869376,0.68018326,044-ADC,-0.335343058,229,132,361
6087,-1.350869376,0.68018326,044-ABB,-0.335343058,166,167,333
6088,-1.350869376,0.68018326,044-ABC,-0.335343058,144,244,388
6089,-1.350869376,0.68018326,044-ABD,-0.335343058,294,294,588
6090,-1.350869376,0.68018326,044-ABE,-0.335343058,104,123,227
6091,-1.350869376,0.68018326,044-ABF,-0.335343058,320,182,502
6092,-1.350869376,0.68018326,044-ABG,-0.335343058,168,109,277
6093,-1.350869376,0.68018326,044-ABH,-0.335343058,239,143,382
6094,-1.350869376,0.68018326,044-ABO,-0.335343058,86,164,250
6095,-1.350869376,0.68018326,044-ABP,-0.335343058,72,64,136
6096,-1.350869376,0.68018326,044-AAA,-0.335343058,154,151,305
6097,-1.350869376,0.68018326,044-AAB,-0.335343058,72,92,164
6098,-1.350869376,0.68018326,044-AAC,-0.335343058,66,65,131
6099,-1.350869376,0.68018326,044-AAD,-0.335343058,57,87,144
6100,-1.350869376,0.68018326,044-AAE,-0.335343058,193,132,325
6101,-1.350869376,0.68018326,044-AAF,-0.335343058,215,167,382
6102,-1.350869376,0.68018326,044-AAG,-0.335343058,78,76,154
6103,-1.350869376,0.68018326,044-AAH,-0.335343058,63,33,96
6104,-1.350869376,0.68018326,044-AAI,-0.335343058,80,59,139
6105,-1.350869376,0.68018326,044-AAJ,-0.335343058,55,166,221
6106,-1.350869376,0.68018326,044-AAK,-0.335343058,67,54,121
6107,-1.350869376,0.68018326,044-AAL,-0.335343058,63,144,207
6108,-1.350869376,0.68018326,044-AAM,-0.335343058,33,41,74
6109,-1.350869376,0.68018326,044-AAN,-0.335343058,81,68,149
6110,-1.350869376,0.68018326,044-AAO,-0.335343058,104,120,224
6111,-1.350869376,0.68018326,044-AAP,-0.335343058,95,105,200
6112,-1.350869376,0.68018326,044-AAQ,-0.335343058,106,57,163
6113,-1.350869376,0.68018326,044-AAR,-0.335343058,107,72,179
6114,-1.350869376,0.68018326,044-AAS,-0.335343058,116,102,218
6115,-1.350869376,0.68018326,044-AAT,-0.335343058,108,115,223
6116,-1.350869376,0.68018326,044-AAU,-0.335343058,226,115,341
6117,-1.350869376,0.68018326,044-AAV,-0.335343058,102,129,231
6118,-1.350869376,0.68018326,044-AAW,-0.335343058,84,89,173
6119,-1.350869376,0.68018326,044-AAX,-0.335343058,116,120,236
6120,-1.350869376,0.68018326,044-AAY,-0.335343058,190,94,284
6121,-1.350869376,0.68018326,044-ACD,-0.335343058,232,153,385
6122,-1.350869376,0.68018326,044-ACE,-0.335343058,548,291,839
6123,-1.350869376,0.68018326,044-ACF,-0.335343058,221,119,340
6124,-1.350869376,0.68018326,044-ACG,-0.335343058,363,213,576
6125,-1.350869376,0.68018326,044-ACH,-0.335343058,225,118,343
6126,-1.350869376,0.68018326,044-ACI,-0.335343058,438,190,628
6127,-1.350869376,0.68018326,044-ACJ,-0.335343058,185,114,299
6128,-1.350869376,0.68018326,044-ABQ,-0.335343058,222,172,394
6129,-1.350869376,0.68018326,044-ABR,-0.335343058,216,131,347
6130,-1.350869376,0.68018326,044-ABS,-0.335343058,310,173,483
6131,-1.350869376,0.68018326,044-ABT,-0.335343058,148,100,248
6132,-1.350869376,0.68018326,044-ABU,-0.335343058,127,97,224
6133,-1.350869376,0.68018326,044-ACK,-0.335343058,357,195,552
6134,-1.350869376,0.68018326,044-ABV,-0.335343058,226,219,445
6135,-1.350869376,0.68018326,044-ABW,-0.335343058,273,161,434
6136,-1.350869376,0.68018326,044-ABX,-0.335343058,162,105,267
6137,-1.350869376,0.68018326,044-ACT,-0.335343058,111,103,214
6138,-1.350869376,0.68018326,044-ABY,-0.335343058,295,231,526
6139,-1.350869376,0.68018326,044-ABZ,-0.335343058,237,234,471
6140,-1.350869376,0.68018326,044-ABI,-0.335343058,163,109,272
6141,-1.350869376,0.68018326,044-ABJ,-0.335343058,323,191,514
6142,-1.350869376,0.68018326,044-ABK,-0.335343058,219,133,352
6143,-1.350869376,0.68018326,044-ACA,-0.335343058,143,80,223
6144,-1.350869376,0.68018326,044-ACB,-0.335343058,246,155,401
6145,-1.350869376,0.68018326,044-ACL,-0.335343058,107,97,204
6146,-1.350869376,0.68018326,044-ACO,-0.335343058,377,204,581
6147,-1.350869376,0.68018326,044-ACP,-0.335343058,266,164,430
6148,-1.350869376,0.68018326,044-ACQ,-0.335343058,338,166,504
6149,-1.350869376,0.68018326,044-ACR,-0.335343058,347,202,549
6150,-1.350869376,0.68018326,044-ACS,-0.335343058,291,131,422
6151,-1.350869376,0.68018326,044-ACW,-0.335343058,99,90,189
6152,-1.350869376,0.68018326,044-ACX,-0.335343058,210,153,363
6153,-1.350869376,0.68018326,044-ACY,-0.335343058,210,186,396
6154,-1.350869376,0.68018326,044-ACZ,-0.335343058,134,127,261
6155,-1.350869376,0.68018326,044-ADD,-0.335343058,44,42,86
6156,-1.350869376,0.68018326,044-ADE,-0.335343058,225,128,353
6157,-1.350869376,0.68018326,044-ADF,-0.335343058,357,173,530
6158,-1.350869376,0.68018326,045-AFB,-0.335343058,184,89,273
6159,-1.350869376,0.68018326,045-ACJ,-0.335343058,608,259,867
6160,-1.350869376,0.68018326,045-ACK,-0.335343058,598,307,905
6161,-1.350869376,0.68018326,045-AFJ,-0.335343058,251,231,482
6162,-1.350869376,0.68018326,045-AFK,-0.335343058,240,265,505
6163,-1.350869376,0.68018326,045-ACL,-0.335343058,421,255,676
6164,-1.350869376,0.68018326,045-ACM,-0.335343058,316,224,540
6165,-1.350869376,0.68018326,045-ACN,-0.335343058,411,225,636
6166,-1.350869376,0.68018326,045-ACO,-0.335343058,324,174,498
6167,-1.350869376,0.68018326,045-ACP,-0.335343058,508,293,801
6168,-1.350869376,0.68018326,045-ACQ,-0.335343058,348,153,501
6169,-1.350869376,0.68018326,045-ACR,-0.335343058,610,426,1036
6170,-1.350869376,0.68018326,045-AFW,-0.335343058,353,259,612
6171,-1.350869376,0.68018326,045-ACS,-0.335343058,280,143,423
6172,-1.350869376,0.68018326,045-ACT,-0.335343058,346,193,539
6173,-1.350869376,0.68018326,045-ACU,-0.335343058,420,202,622
6174,-1.350869376,0.68018326,045-ACV,-0.335343058,455,341,796
6175,-1.350869376,0.68018326,045-ACW,-0.335343058,436,364,800
6176,-1.350869376,0.68018326,045-ACX,-0.335343058,441,293,734
6177,-1.350869376,0.68018326,045-ACY,-0.335343058,236,176,412
6178,-1.350869376,0.68018326,045-ACZ,-0.335343058,151,238,389
6179,-1.350869376,0.68018326,045-ADA,-0.335343058,308,341,649
6180,-1.350869376,0.68018326,045-ADB,-0.335343058,611,331,942
6181,-1.350869376,0.68018326,045-ADC,-0.335343058,224,763,987
6182,-1.350869376,0.68018326,045-ADE,-0.335343058,230,178,408
6183,-1.350869376,0.68018326,045-ADF,-0.335343058,307,182,489
6184,-1.350869376,0.68018326,045-ADD,-0.335343058,300,198,498
6185,-1.350869376,0.68018326,045-ADH,-0.335343058,502,311,813
6186,-1.350869376,0.68018326,045-ADI,-0.335343058,469,279,748
6187,-1.350869376,0.68018326,045-ADJ,-0.335343058,475,277,752
6188,-1.350869376,0.68018326,045-ADK,-0.335343058,665,335,1000
6189,-1.350869376,0.68018326,045-ADL,-0.335343058,538,292,830
6190,-1.350869376,0.68018326,045-ADM,-0.335343058,377,144,521
6191,-1.350869376,0.68018326,045-ADN,-0.335343058,129,56,185
6192,-1.350869376,0.68018326,045-AAA,-0.335343058,556,419,975
6193,-1.350869376,0.68018326,045-AAB,-0.335343058,309,357,666
6194,-1.350869376,0.68018326,045-AAE,-0.335343058,487,345,832
6195,-1.350869376,0.68018326,045-AAD,-0.335343058,405,338,743
6196,-1.350869376,0.68018326,045-AAG,-0.335343058,479,295,774
6197,-1.350869376,0.68018326,045-AAH,-0.335343058,492,343,835
6198,-1.350869376,0.68018326,045-AFH,-0.335343058,307,254,561
6199,-1.350869376,0.68018326,045-AFI,-0.335343058,224,194,418
6200,-1.350869376,0.68018326,045-ADO,-0.335343058,398,253,651
6201,-1.350869376,0.68018326,045-ADP,-0.335343058,388,119,507
6202,-1.350869376,0.68018326,045-ADQ,-0.335343058,457,190,647
6203,-1.350869376,0.68018326,045-AFQ,-0.335343058,344,142,486
6204,-1.350869376,0.68018326,045-AEG,-0.335343058,722,404,1126
6205,-1.350869376,0.68018326,045-AEI,-0.335343058,554,360,914
6206,-1.350869376,0.68018326,045-ADG,-0.335343058,163,103,266
6207,-1.350869376,0.68018326,045-ADR,-0.335343058,433,195,628
6208,-1.350869376,0.68018326,045-ADS,-0.335343058,529,205,734
6209,-1.350869376,0.68018326,045-ADT,-0.335343058,380,202,582
6210,-1.350869376,0.68018326,045-ADU,-0.335343058,261,174,435
6211,-1.350869376,0.68018326,045-ADV,-0.335343058,428,208,636
6212,-1.350869376,0.68018326,045-ADW,-0.335343058,480,269,749
6213,-1.350869376,0.68018326,045-ADX,-0.335343058,340,186,526
6214,-1.350869376,0.68018326,045-ADY,-0.335343058,307,161,468
6215,-1.350869376,0.68018326,045-ADZ,-0.335343058,384,238,622
6216,-1.350869376,0.68018326,045-AEA,-0.335343058,298,153,451
6217,-1.350869376,0.68018326,045-AEB,-0.335343058,321,210,531
6218,-1.350869376,0.68018326,045-AEC,-0.335343058,519,332,851
6219,-1.350869376,0.68018326,045-AEE,-0.335343058,444,182,626
6220,-1.350869376,0.68018326,045-AEF,-0.335343058,476,197,673
6221,-1.350869376,0.68018326,045-AAJ,-0.335343058,283,321,604
6222,-1.350869376,0.68018326,045-AAK,-0.335343058,244,307,551
6223,-1.350869376,0.68018326,045-AAL,-0.335343058,171,235,406
6224,-1.350869376,0.68018326,045-AAM,-0.335343058,135,307,442
6225,-1.350869376,0.68018326,045-AAP,-0.335343058,240,236,476
6226,-1.350869376,0.68018326,045-AAQ,-0.335343058,182,289,471
6227,-1.350869376,0.68018326,045-AAR,-0.335343058,203,301,504
6228,-1.350869376,0.68018326,045-AAS,-0.335343058,204,279,483
6229,-1.350869376,0.68018326,045-AAV,-0.335343058,237,204,441
6230,-1.350869376,0.68018326,045-AAW,-0.335343058,255,248,503
6231,-1.350869376,0.68018326,045-AAX,-0.335343058,625,434,1059
6232,-1.350869376,0.68018326,045-AAY,-0.335343058,343,360,703
6233,-1.350869376,0.68018326,045-AAZ,-0.335343058,364,285,649
6234,-1.350869376,0.68018326,045-ABB,-0.335343058,322,381,703
6235,-1.350869376,0.68018326,045-ABC,-0.335343058,263,235,498
6236,-1.350869376,0.68018326,045-ABD,-0.335343058,312,280,592
6237,-1.350869376,0.68018326,045-ABE,-0.335343058,450,296,746
6238,-1.350869376,0.68018326,045-ABF,-0.335343058,356,323,679
6239,-1.350869376,0.68018326,045-ABJ,-0.335343058,568,267,835
6240,-1.350869376,0.68018326,045-ABK,-0.335343058,326,222,548
6241,-1.350869376,0.68018326,045-ABL,-0.335343058,355,200,555
6242,-1.350869376,0.68018326,045-ABM,-0.335343058,428,333,761
6243,-1.350869376,0.68018326,045-ABN,-0.335343058,303,241,544
6244,-1.350869376,0.68018326,045-ABO,-0.335343058,326,279,605
6245,-1.350869376,0.68018326,045-ABR,-0.335343058,490,392,882
6246,-1.350869376,0.68018326,045-ABS,-0.335343058,381,333,714
6247,-1.350869376,0.68018326,045-ABT,-0.335343058,393,292,685
6248,-1.350869376,0.68018326,045-ABU,-0.335343058,284,274,558
6249,-1.350869376,0.68018326,045-ABV,-0.335343058,497,290,787
6250,-1.350869376,0.68018326,045-ABZ,-0.335343058,267,398,665
6251,-1.350869376,0.68018326,045-ACA,-0.335343058,217,286,503
6252,-1.350869376,0.68018326,045-ACB,-0.335343058,279,307,586
6253,-1.350869376,0.68018326,045-ACC,-0.335343058,288,325,613
6254,-1.350869376,0.68018326,045-AEK,-0.335343058,464,251,715
6255,-1.350869376,0.68018326,045-AEL,-0.335343058,331,217,548
6256,-1.350869376,0.68018326,045-AEO,-0.335343058,237,203,440
6257,-1.350869376,0.68018326,045-AEP,-0.335343058,307,245,552
6258,-1.350869376,0.68018326,045-AEQ,-0.335343058,314,164,478
6259,-1.350869376,0.68018326,045-AES,-0.335343058,370,261,631
6260,-1.350869376,0.68018326,045-AET,-0.335343058,533,356,889
6261,-1.350869376,0.68018326,045-AEU,-0.335343058,409,196,605
6262,-1.350869376,0.68018326,045-AEV,-0.335343058,509,469,978
6263,-1.350869376,0.68018326,045-AFX,-0.335343058,355,242,597
6264,-1.350869376,0.68018326,045-AEW,-0.335343058,424,223,647
6265,-1.350869376,0.68018326,045-AEX,-0.335343058,329,227,556
6266,-1.350869376,0.68018326,045-AFY,-0.335343058,460,259,719
6267,-1.350869376,0.68018326,045-AEY,-0.335343058,422,283,705
6268,-1.350869376,0.68018326,045-AEZ,-0.335343058,430,292,722
6269,-1.350869376,0.68018326,045-AFA,-0.335343058,459,252,711
6270,-1.350869376,0.68018326,045-AFR,-0.335343058,385,421,806
6271,-1.350869376,0.68018326,045-AFS,-0.335343058,534,554,1088
6272,-1.350869376,0.68018326,045-AFT,-0.335343058,260,289,549
6273,-1.350869376,0.68018326,045-AFU,-0.335343058,418,610,1028
6274,-1.350869376,0.68018326,045-AFV,-0.335343058,428,613,1041
6275,-1.350869376,0.68018326,045-AFC,-0.335343058,452,198,650
6276,-1.350869376,0.68018326,045-AFD,-0.335343058,330,157,487
6277,-1.350869376,0.68018326,045-AER,-0.335343058,96,84,180
6278,-1.350869376,0.68018326,045-AFE,-0.335343058,622,358,980
6279,-1.350869376,0.68018326,045-AFF,-0.335343058,308,196,504
6280,-1.350869376,0.68018326,045-AFG,-0.335343058,389,175,564
6281,-1.350869376,0.68018326,045-AFM,-0.335343058,449,392,841
6282,-1.350869376,0.68018326,045-AFL,-0.335343058,346,160,506
6283,-1.350869376,0.68018326,046-ABK,-0.335343058,247,146,393
6284,-1.350869376,0.68018326,046-AAQ,-0.335343058,187,60,247
6285,-1.350869376,0.68018326,046-AAR,-0.335343058,216,104,320
6286,-1.350869376,0.68018326,046-ABG,-0.335343058,404,175,579
6287,-1.350869376,0.68018326,046-AAA,-0.335343058,282,275,557
6288,-1.350869376,0.68018326,046-AAB,-0.335343058,416,307,723
6289,-1.350869376,0.68018326,046-AAM,-0.335343058,273,234,507
6290,-1.350869376,0.68018326,046-AAN,-0.335343058,351,339,690
6291,-1.350869376,0.68018326,046-AAO,-0.335343058,93,134,227
6292,-1.350869376,0.68018326,046-AAT,-0.335343058,541,265,806
6293,-1.350869376,0.68018326,046-ABC,-0.335343058,142,53,195
6294,-1.350869376,0.68018326,046-AAV,-0.335343058,425,217,642
6295,-1.350869376,0.68018326,046-AAW,-0.335343058,400,196,596
6296,-1.350869376,0.68018326,046-AAY,-0.335343058,240,124,364
6297,-1.350869376,0.68018326,046-ABP,-0.335343058,185,199,384
6298,-1.350869376,0.68018326,046-AAZ,-0.335343058,528,217,745
6299,-1.350869376,0.68018326,046-ABD,-0.335343058,551,280,831
6300,-1.350869376,0.68018326,046-ABE,-0.335343058,259,55,314
6301,-1.350869376,0.68018326,046-ABH,-0.335343058,605,252,857
6302,-1.350869376,0.68018326,046-ABI,-0.335343058,330,208,538
6303,-1.350869376,0.68018326,046-ABJ,-0.335343058,266,125,391
6304,-1.350869376,0.68018326,046-ABF,-0.335343058,156,108,264
6305,-1.350869376,0.68018326,046-ABL,-0.335343058,551,314,865
6306,-1.350869376,0.68018326,046-ABM,-0.335343058,590,242,832
6307,-1.350869376,0.68018326,046-ABN,-0.335343058,159,82,241
6308,-1.350869376,0.68018326,046-ABX,-0.335343058,282,225,507
6309,-1.350869376,0.68018326,046-AAE,-0.335343058,298,222,520
6310,-1.350869376,0.68018326,046-AAG,-0.335343058,375,280,655
6311,-1.350869376,0.68018326,046-AAH,-0.335343058,298,134,432
6312,-1.350869376,0.68018326,046-AAI,-0.335343058,225,132,357
6313,-1.350869376,0.68018326,046-ABR,-0.335343058,288,196,484
6314,-1.350869376,0.68018326,046-ABQ,-0.335343058,312,170,482
6315,-1.350869376,0.68018326,046-ABS,-0.335343058,282,142,424
6316,-1.350869376,0.68018326,046-ABT,-0.335343058,324,157,481
6317,-1.350869376,0.68018326,046-AAJ,-0.335343058,235,237,472
6318,-1.350869376,0.68018326,046-AAL,-0.335343058,131,220,351
6319,-1.350869376,0.68018326,046-ABU,-0.335343058,356,121,477
6320,-1.350869376,0.68018326,046-ABV,-0.335343058,357,206,563
6321,-1.350869376,0.68018326,046-ABW,-0.335343058,290,123,413
6322,-1.350869376,0.68018326,046-ABA,-0.335343058,358,135,493
6323,-1.350869376,0.68018326,046-ABB,-0.335343058,270,137,407
6324,-1.350869376,0.68018326,046-AAS,-0.335343058,255,117,372
6325,-1.350869376,0.68018326,046-ABZ,-0.335343058,402,190,592
6326,-1.350869376,0.68018326,046-AAX,-0.335343058,113,81,194
6327,-1.350869376,0.68018326,047-AAA,-0.335343058,312,299,611
6328,-1.350869376,0.68018326,047-AAB,-0.335343058,336,310,646
6329,-1.350869376,0.68018326,047-AAC,-0.335343058,339,347,686
6330,-1.350869376,0.68018326,047-AAE,-0.335343058,313,412,725
6331,-1.350869376,0.68018326,047-AAF,-0.335343058,264,292,556
6332,-1.350869376,0.68018326,047-AAG,-0.335343058,313,302,615
6333,-1.350869376,0.68018326,047-AAH,-0.335343058,201,305,506
6334,-1.350869376,0.68018326,047-AAI,-0.335343058,251,277,528
6335,-1.350869376,0.68018326,047-AAJ,-0.335343058,189,318,507
6336,-1.350869376,0.68018326,047-AAK,-0.335343058,278,348,626
6337,-1.350869376,0.68018326,047-AAL,-0.335343058,275,302,577
6338,-1.350869376,0.68018326,047-AAM,-0.335343058,204,297,501
6339,-1.350869376,0.68018326,047-AIE,-0.335343058,376,394,770
6340,-1.350869376,0.68018326,047-AIF,-0.335343058,410,461,871
6341,-1.350869376,0.68018326,047-AIG,-0.335343058,309,371,680
6342,-1.350869376,0.68018326,047-AIH,-0.335343058,307,402,709
6343,-1.350869376,0.68018326,047-AAO,-0.335343058,623,525,1148
6344,-1.350869376,0.68018326,047-AAP,-0.335343058,288,253,541
6345,-1.350869376,0.68018326,047-AKY,-0.335343058,348,265,613
6346,-1.350869376,0.68018326,047-AKZ,-0.335343058,584,395,979
6347,-1.350869376,0.68018326,047-AAQ,-0.335343058,487,448,935
6348,-1.350869376,0.68018326,047-AAR,-0.335343058,369,445,814
6349,-1.350869376,0.68018326,047-AKT,-0.335343058,322,415,737
6350,-1.350869376,0.68018326,047-AAS,-0.335343058,384,284,668
6351,-1.350869376,0.68018326,047-AAT,-0.335343058,319,249,568
6352,-1.350869376,0.68018326,047-AKU,-0.335343058,540,460,1000
6353,-1.350869376,0.68018326,047-AAU,-0.335343058,474,406,880
6354,-1.350869376,0.68018326,047-AAV,-0.335343058,533,334,867
6355,-1.350869376,0.68018326,047-AKV,-0.335343058,596,271,867
6356,-1.350869376,0.68018326,047-AAW,-0.335343058,404,264,668
6357,-1.350869376,0.68018326,047-AAX,-0.335343058,482,320,802
6358,-1.350869376,0.68018326,047-AAY,-0.335343058,673,443,1116
6359,-1.350869376,0.68018326,047-AAZ,-0.335343058,351,419,770
6360,-1.350869376,0.68018326,047-ABA,-0.335343058,357,283,640
6361,-1.350869376,0.68018326,047-ABB,-0.335343058,342,203,545
6362,-1.350869376,0.68018326,047-ABC,-0.335343058,253,226,479
6363,-1.350869376,0.68018326,047-ABD,-0.335343058,622,339,961
6364,-1.350869376,0.68018326,047-ABE,-0.335343058,474,348,822
6365,-1.350869376,0.68018326,047-ABF,-0.335343058,260,247,507
6366,-1.350869376,0.68018326,047-ABG,-0.335343058,264,266,530
6367,-1.350869376,0.68018326,047-ABH,-0.335343058,256,241,497
6368,-1.350869376,0.68018326,047-ABI,-0.335343058,366,318,684
6369,-1.350869376,0.68018326,047-ABJ,-0.335343058,288,256,544
6370,-1.350869376,0.68018326,047-ABK,-0.335343058,250,278,528
6371,-1.350869376,0.68018326,047-ABL,-0.335343058,226,280,506
6372,-1.350869376,0.68018326,047-ABM,-0.335343058,325,328,653
6373,-1.350869376,0.68018326,047-ABN,-0.335343058,391,346,737
6374,-1.350869376,0.68018326,047-ABO,-0.335343058,462,473,935
6375,-1.350869376,0.68018326,047-AIM,-0.335343058,291,220,511
6376,-1.350869376,0.68018326,047-AIN,-0.335343058,461,455,916
6377,-1.350869376,0.68018326,047-AIO,-0.335343058,430,418,848
6378,-1.350869376,0.68018326,047-AIQ,-0.335343058,251,285,536
6379,-1.350869376,0.68018326,047-AIR,-0.335343058,221,277,498
6380,-1.350869376,0.68018326,047-AIS,-0.335343058,293,278,571
6381,-1.350869376,0.68018326,047-AIT,-0.335343058,395,350,745
6382,-1.350869376,0.68018326,047-AIU,-0.335343058,247,289,536
6383,-1.350869376,0.68018326,047-AIV,-0.335343058,381,193,574
6384,-1.350869376,0.68018326,047-AIW,-0.335343058,289,239,528
6385,-1.350869376,0.68018326,047-AIZ,-0.335343058,209,302,511
6386,-1.350869376,0.68018326,047-AJA,-0.335343058,356,267,623
6387,-1.350869376,0.68018326,047-AJB,-0.335343058,337,355,692
6388,-1.350869376,0.68018326,047-AJC,-0.335343058,311,294,605
6389,-1.350869376,0.68018326,047-AJD,-0.335343058,407,309,716
6390,-1.350869376,0.68018326,047-AJE,-0.335343058,330,303,633
6391,-1.350869376,0.68018326,047-AJF,-0.335343058,310,281,591
6392,-1.350869376,0.68018326,047-AJG,-0.335343058,266,286,552
6393,-1.350869376,0.68018326,047-AJH,-0.335343058,310,302,612
6394,-1.350869376,0.68018326,047-AJI,-0.335343058,324,271,595
6395,-1.350869376,0.68018326,047-AJJ,-0.335343058,174,306,480
6396,-1.350869376,0.68018326,047-ABP,-0.335343058,224,293,517
6397,-1.350869376,0.68018326,047-ABQ,-0.335343058,158,304,462
6398,-1.350869376,0.68018326,047-ABR,-0.335343058,212,294,506
6399,-1.350869376,0.68018326,047-ABS,-0.335343058,115,345,460
6400,-1.350869376,0.68018326,047-ABT,-0.335343058,184,301,485
6401,-1.350869376,0.68018326,047-ABU,-0.335343058,187,360,547
6402,-1.350869376,0.68018326,047-ABW,-0.335343058,75,377,452
6403,-1.350869376,0.68018326,047-ABX,-0.335343058,162,408,570
6404,-1.350869376,0.68018326,047-ABY,-0.335343058,107,399,506
6405,-1.350869376,0.68018326,047-ABZ,-0.335343058,77,509,586
6406,-1.350869376,0.68018326,047-ACA,-0.335343058,114,388,502
6407,-1.350869376,0.68018326,047-ACD,-0.335343058,251,387,638
6408,-1.350869376,0.68018326,047-ACE,-0.335343058,197,365,562
6409,-1.350869376,0.68018326,047-ACF,-0.335343058,273,358,631
6410,-1.350869376,0.68018326,047-ACG,-0.335343058,232,289,521
6411,-1.350869376,0.68018326,047-ACH,-0.335343058,320,384,704
6412,-1.350869376,0.68018326,047-ACI,-0.335343058,383,481,864
6413,-1.350869376,0.68018326,047-ACJ,-0.335343058,474,574,1048
6414,-1.350869376,0.68018326,047-ACM,-0.335343058,291,287,578
6415,-1.350869376,0.68018326,047-ACN,-0.335343058,276,401,677
6416,-1.350869376,0.68018326,047-ACO,-0.335343058,303,365,668
6417,-1.350869376,0.68018326,047-ACP,-0.335343058,314,343,657
6418,-1.350869376,0.68018326,047-ACQ,-0.335343058,296,394,690
6419,-1.350869376,0.68018326,047-ACR,-0.335343058,214,310,524
6420,-1.350869376,0.68018326,047-ACS,-0.335343058,173,364,537
6421,-1.350869376,0.68018326,047-ACW,-0.335343058,106,301,407
6422,-1.350869376,0.68018326,047-ACX,-0.335343058,146,373,519
6423,-1.350869376,0.68018326,047-ACY,-0.335343058,110,366,476
6424,-1.350869376,0.68018326,047-ACZ,-0.335343058,28,461,489
6425,-1.350869376,0.68018326,047-ADA,-0.335343058,141,400,541
6426,-1.350869376,0.68018326,047-ADC,-0.335343058,153,450,603
6427,-1.350869376,0.68018326,047-ADD,-0.335343058,157,297,454
6428,-1.350869376,0.68018326,047-ADE,-0.335343058,62,495,557
6429,-1.350869376,0.68018326,047-ADF,-0.335343058,209,421,630
6430,-1.350869376,0.68018326,047-ADG,-0.335343058,245,400,645
6431,-1.350869376,0.68018326,047-ADI,-0.335343058,181,411,592
6432,-1.350869376,0.68018326,047-ADJ,-0.335343058,247,431,678
6433,-1.350869376,0.68018326,047-ADK,-0.335343058,219,336,555
6434,-1.350869376,0.68018326,047-ADL,-0.335343058,210,393,603
6435,-1.350869376,0.68018326,047-ADM,-0.335343058,210,351,561
6436,-1.350869376,0.68018326,047-AND,-0.335343058,241,436,677
6437,-1.350869376,0.68018326,047-AJL,-0.335343058,210,344,554
6438,-1.350869376,0.68018326,047-AJM,-0.335343058,268,333,601
6439,-1.350869376,0.68018326,047-AJN,-0.335343058,267,331,598
6440,-1.350869376,0.68018326,047-AJP,-0.335343058,432,421,853
6441,-1.350869376,0.68018326,047-AJQ,-0.335343058,370,312,682
6442,-1.350869376,0.68018326,047-AJR,-0.335343058,260,287,547
6443,-1.350869376,0.68018326,047-AJT,-0.335343058,342,357,699
6444,-1.350869376,0.68018326,047-AJV,-0.335343058,255,288,543
6445,-1.350869376,0.68018326,047-AJW,-0.335343058,263,222,485
6446,-1.350869376,0.68018326,047-AJX,-0.335343058,360,303,663
6447,-1.350869376,0.68018326,047-AJY,-0.335343058,287,346,633
6448,-1.350869376,0.68018326,047-AJZ,-0.335343058,371,307,678
6449,-1.350869376,0.68018326,047-AKA,-0.335343058,355,345,700
6450,-1.350869376,0.68018326,047-AKB,-0.335343058,495,454,949
6451,-1.350869376,0.68018326,047-ADQ,-0.335343058,96,307,403
6452,-1.350869376,0.68018326,047-ADR,-0.335343058,92,361,453
6453,-1.350869376,0.68018326,047-ADS,-0.335343058,142,348,490
6454,-1.350869376,0.68018326,047-ADT,-0.335343058,96,378,474
6455,-1.350869376,0.68018326,047-ADU,-0.335343058,70,352,422
6456,-1.350869376,0.68018326,047-ADV,-0.335343058,162,345,507
6457,-1.350869376,0.68018326,047-ADW,-0.335343058,249,342,591
6458,-1.350869376,0.68018326,047-ADX,-0.335343058,117,322,439
6459,-1.350869376,0.68018326,047-ADY,-0.335343058,93,319,412
6460,-1.350869376,0.68018326,047-ADZ,-0.335343058,49,405,454
6461,-1.350869376,0.68018326,047-AEA,-0.335343058,35,392,427
6462,-1.350869376,0.68018326,047-AEB,-0.335343058,115,239,354
6463,-1.350869376,0.68018326,047-AEC,-0.335343058,160,328,488
6464,-1.350869376,0.68018326,047-AEF,-0.335343058,115,470,585
6465,-1.350869376,0.68018326,047-AEG,-0.335343058,39,471,510
6466,-1.350869376,0.68018326,047-AEH,-0.335343058,81,302,383
6467,-1.350869376,0.68018326,047-AEI,-0.335343058,97,340,437
6468,-1.350869376,0.68018326,047-AEJ,-0.335343058,50,456,506
6469,-1.350869376,0.68018326,047-AEK,-0.335343058,64,380,444
6470,-1.350869376,0.68018326,047-AEM,-0.335343058,262,576,838
6471,-1.350869376,0.68018326,047-AEN,-0.335343058,202,563,765
6472,-1.350869376,0.68018326,047-AEO,-0.335343058,113,364,477
6473,-1.350869376,0.68018326,047-AEP,-0.335343058,206,512,718
6474,-1.350869376,0.68018326,047-AEQ,-0.335343058,200,366,566
6475,-1.350869376,0.68018326,047-AER,-0.335343058,142,243,385
6476,-1.350869376,0.68018326,047-AEW,-0.335343058,44,438,482
6477,-1.350869376,0.68018326,047-AEX,-0.335343058,37,374,411
6478,-1.350869376,0.68018326,047-AEY,-0.335343058,31,319,350
6479,-1.350869376,0.68018326,047-AEZ,-0.335343058,76,468,544
6480,-1.350869376,0.68018326,047-AFA,-0.335343058,68,390,458
6481,-1.350869376,0.68018326,047-AFB,-0.335343058,94,374,468
6482,-1.350869376,0.68018326,047-AFD,-0.335343058,84,427,511
6483,-1.350869376,0.68018326,047-AFE,-0.335343058,92,397,489
6484,-1.350869376,0.68018326,047-AFF,-0.335343058,97,344,441
6485,-1.350869376,0.68018326,047-AFG,-0.335343058,69,421,490
6486,-1.350869376,0.68018326,047-AFH,-0.335343058,140,389,529
6487,-1.350869376,0.68018326,047-AFI,-0.335343058,108,418,526
6488,-1.350869376,0.68018326,047-AFL,-0.335343058,102,279,381
6489,-1.350869376,0.68018326,047-AFM,-0.335343058,146,289,435
6490,-1.350869376,0.68018326,047-AFN,-0.335343058,98,281,379
6491,-1.350869376,0.68018326,047-AFO,-0.335343058,169,423,592
6492,-1.350869376,0.68018326,047-AFP,-0.335343058,93,485,578
6493,-1.350869376,0.68018326,047-AFQ,-0.335343058,173,384,557
6494,-1.350869376,0.68018326,047-AFR,-0.335343058,128,269,397
6495,-1.350869376,0.68018326,047-AFU,-0.335343058,340,547,887
6496,-1.350869376,0.68018326,047-AFV,-0.335343058,132,379,511
6497,-1.350869376,0.68018326,047-AFW,-0.335343058,114,344,458
6498,-1.350869376,0.68018326,047-AFX,-0.335343058,229,482,711
6499,-1.350869376,0.68018326,047-AFY,-0.335343058,163,311,474
6500,-1.350869376,0.68018326,047-AFZ,-0.335343058,351,580,931
6501,-1.350869376,0.68018326,047-AGA,-0.335343058,174,371,545
6502,-1.350869376,0.68018326,047-AGB,-0.335343058,224,474,698
6503,-1.350869376,0.68018326,047-AGN,-0.335343058,295,318,613
6504,-1.350869376,0.68018326,047-AGO,-0.335343058,640,572,1212
6505,-1.350869376,0.68018326,047-AGP,-0.335343058,566,653,1219
6506,-1.350869376,0.68018326,047-AGQ,-0.335343058,305,453,758
6507,-1.350869376,0.68018326,047-ALC,-0.335343058,378,397,775
6508,-1.350869376,0.68018326,047-ALD,-0.335343058,332,297,629
6509,-1.350869376,0.68018326,047-AGS,-0.335343058,225,377,602
6510,-1.350869376,0.68018326,047-AGT,-0.335343058,205,268,473
6511,-1.350869376,0.68018326,047-AGU,-0.335343058,208,265,473
6512,-1.350869376,0.68018326,047-AGV,-0.335343058,307,312,619
6513,-1.350869376,0.68018326,047-ALA,-0.335343058,244,337,581
6514,-1.350869376,0.68018326,047-AGC,-0.335343058,365,404,769
6515,-1.350869376,0.68018326,047-AGY,-0.335343058,356,390,746
6516,-1.350869376,0.68018326,047-AGZ,-0.335343058,254,326,580
6517,-1.350869376,0.68018326,047-AHA,-0.335343058,539,432,971
6518,-1.350869376,0.68018326,047-AHB,-0.335343058,409,385,794
6519,-1.350869376,0.68018326,047-AHC,-0.335343058,258,269,527
6520,-1.350869376,0.68018326,047-AHD,-0.335343058,261,279,540
6521,-1.350869376,0.68018326,047-AHE,-0.335343058,307,346,653
6522,-1.350869376,0.68018326,047-AHF,-0.335343058,327,305,632
6523,-1.350869376,0.68018326,047-AHG,-0.335343058,250,316,566
6524,-1.350869376,0.68018326,047-AKF,-0.335343058,206,308,514
6525,-1.350869376,0.68018326,047-AKG,-0.335343058,215,305,520
6526,-1.350869376,0.68018326,047-AHI,-0.335343058,104,591,695
6527,-1.350869376,0.68018326,047-AHJ,-0.335343058,41,487,528
6528,-1.350869376,0.68018326,047-AKS,-0.335343058,52,374,426
6529,-1.350869376,0.68018326,047-AHK,-0.335343058,69,1126,1195
6530,-1.350869376,0.68018326,047-AHL,-0.335343058,47,950,997
6531,-1.350869376,0.68018326,047-AHM,-0.335343058,112,653,765
6532,-1.350869376,0.68018326,047-AHO,-0.335343058,99,530,629
6533,-1.350869376,0.68018326,047-AKC,-0.335343058,488,487,975
6534,-1.350869376,0.68018326,047-AKD,-0.335343058,479,428,907
6535,-1.350869376,0.68018326,047-AKE,-0.335343058,207,215,422
6536,-1.350869376,0.68018326,047-AIK,-0.335343058,209,242,451
6537,-1.350869376,0.68018326,047-AIL,-0.335343058,222,213,435
6538,-1.350869376,0.68018326,047-AHP,-0.335343058,252,384,636
6539,-1.350869376,0.68018326,047-AHQ,-0.335343058,165,276,441
6540,-1.350869376,0.68018326,047-AHR,-0.335343058,193,358,551
6541,-1.350869376,0.68018326,047-AHS,-0.335343058,193,336,529
6542,-1.350869376,0.68018326,047-AHT,-0.335343058,188,314,502
6543,-1.350869376,0.68018326,047-AHU,-0.335343058,175,277,452
6544,-1.350869376,0.68018326,047-AHV,-0.335343058,255,425,680
6545,-1.350869376,0.68018326,047-AHW,-0.335343058,210,292,502
6546,-1.350869376,0.68018326,047-AKH,-0.335343058,135,326,461
6547,-1.350869376,0.68018326,047-AKI,-0.335343058,152,380,532
6548,-1.350869376,0.68018326,047-AKK,-0.335343058,143,378,521
6549,-1.350869376,0.68018326,047-AKL,-0.335343058,321,358,679
6550,-1.350869376,0.68018326,047-AKM,-0.335343058,367,383,750
6551,-1.350869376,0.68018326,047-ALE,-0.335343058,352,386,738
6552,-1.350869376,0.68018326,047-AHX,-0.335343058,261,314,575
6553,-1.350869376,0.68018326,047-AHY,-0.335343058,119,76,195
6554,-1.350869376,0.68018326,047-AHZ,-0.335343058,153,324,477
6555,-1.350869376,0.68018326,047-AIA,-0.335343058,239,282,521
6556,-1.350869376,0.68018326,047-AIB,-0.335343058,363,367,730
6557,-1.350869376,0.68018326,047-AIC,-0.335343058,254,265,519
6558,-1.350869376,0.68018326,047-AKN,-0.335343058,419,327,746
6559,-1.350869376,0.68018326,047-AKO,-0.335343058,324,385,709
6560,-1.350869376,0.68018326,047-AKP,-0.335343058,331,336,667
6561,-1.350869376,0.68018326,047-AKQ,-0.335343058,305,382,687
6562,-1.350869376,0.68018326,048-ARP,-0.335343058,12,24,36
6563,-1.350869376,0.68018326,048-ARQ,-0.335343058,206,208,414
6564,-1.350869376,0.68018326,048-ARR,-0.335343058,79,123,202
6565,-1.350869376,0.68018326,048-ARS,-0.335343058,161,248,409
6566,-1.350869376,0.68018326,048-ART,-0.335343058,146,277,423
6567,-1.350869376,0.68018326,048-ARU,-0.335343058,266,354,620
6568,-1.350869376,0.68018326,048-AAA,-0.335343058,168,169,337
6569,-1.350869376,0.68018326,048-AAB,-0.335343058,161,290,451
6570,-1.350869376,0.68018326,048-AAC,-0.335343058,123,188,311
6571,-1.350869376,0.68018326,048-AAD,-0.335343058,142,263,405
6572,-1.350869376,0.68018326,048-AAE,-0.335343058,190,298,488
6573,-1.350869376,0.68018326,048-AAF,-0.335343058,180,227,407
6574,-1.350869376,0.68018326,048-AAG,-0.335343058,174,231,405
6575,-1.350869376,0.68018326,048-AAH,-0.335343058,126,204,330
6576,-1.350869376,0.68018326,048-AAI,-0.335343058,248,311,559
6577,-1.350869376,0.68018326,048-AAJ,-0.335343058,136,195,331
6578,-1.350869376,0.68018326,048-AAK,-0.335343058,193,205,398
6579,-1.350869376,0.68018326,048-AAL,-0.335343058,82,141,223
6580,-1.350869376,0.68018326,048-AAM,-0.335343058,284,390,674
6581,-1.350869376,0.68018326,048-AAO,-0.335343058,111,132,243
6582,-1.350869376,0.68018326,048-AAP,-0.335343058,126,221,347
6583,-1.350869376,0.68018326,048-AAQ,-0.335343058,201,275,476
6584,-1.350869376,0.68018326,048-AAR,-0.335343058,309,360,669
6585,-1.350869376,0.68018326,048-AAS,-0.335343058,235,277,512
6586,-1.350869376,0.68018326,048-AAT,-0.335343058,86,117,203
6587,-1.350869376,0.68018326,048-AAU,-0.335343058,192,163,355
6588,-1.350869376,0.68018326,048-ARV,-0.335343058,530,294,824
6589,-1.350869376,0.68018326,048-AVL,-0.335343058,365,312,677
6590,-1.350869376,0.68018326,048-AVM,-0.335343058,677,531,1208
6591,-1.350869376,0.68018326,048-AVN,-0.335343058,105,116,221
6592,-1.350869376,0.68018326,048-ARW,-0.335343058,284,184,468
6593,-1.350869376,0.68018326,048-ARX,-0.335343058,553,365,918
6594,-1.350869376,0.68018326,048-ARY,-0.335343058,248,203,451
6595,-1.350869376,0.68018326,048-ARZ,-0.335343058,362,191,553
6596,-1.350869376,0.68018326,048-AVD,-0.335343058,232,181,413
6597,-1.350869376,0.68018326,048-AVE,-0.335343058,348,264,612
6598,-1.350869376,0.68018326,048-AVJ,-0.335343058,404,218,622
6599,-1.350869376,0.68018326,048-AVK,-0.335343058,315,159,474
6600,-1.350869376,0.68018326,048-AAV,-0.335343058,211,280,491
6601,-1.350869376,0.68018326,048-AAW,-0.335343058,168,334,502
6602,-1.350869376,0.68018326,048-AAX,-0.335343058,223,218,441
6603,-1.350869376,0.68018326,048-AAY,-0.335343058,164,337,501
6604,-1.350869376,0.68018326,048-AAZ,-0.335343058,226,477,703
6605,-1.350869376,0.68018326,048-ABA,-0.335343058,279,342,621
6606,-1.350869376,0.68018326,048-ABB,-0.335343058,170,284,454
6607,-1.350869376,0.68018326,048-ABC,-0.335343058,166,268,434
6608,-1.350869376,0.68018326,048-ABD,-0.335343058,148,354,502
6609,-1.350869376,0.68018326,048-ABE,-0.335343058,127,218,345
6610,-1.350869376,0.68018326,048-ABF,-0.335343058,83,169,252
6611,-1.350869376,0.68018326,048-ABG,-0.335343058,198,436,634
6612,-1.350869376,0.68018326,048-ABH,-0.335343058,138,227,365
6613,-1.350869376,0.68018326,048-ABI,-0.335343058,87,174,261
6614,-1.350869376,0.68018326,048-ABJ,-0.335343058,160,310,470
6615,-1.350869376,0.68018326,048-ABK,-0.335343058,193,333,526
6616,-1.350869376,0.68018326,048-ABL,-0.335343058,197,363,560
6617,-1.350869376,0.68018326,048-ABM,-0.335343058,344,433,777
6618,-1.350869376,0.68018326,048-ABN,-0.335343058,197,289,486
6619,-1.350869376,0.68018326,048-ABO,-0.335343058,155,232,387
6620,-1.350869376,0.68018326,048-ABP,-0.335343058,161,278,439
6621,-1.350869376,0.68018326,048-ABQ,-0.335343058,104,272,376
6622,-1.350869376,0.68018326,048-ASA,-0.335343058,169,204,373
6623,-1.350869376,0.68018326,048-ASB,-0.335343058,207,228,435
6624,-1.350869376,0.68018326,048-ASC,-0.335343058,199,200,399
6625,-1.350869376,0.68018326,048-ASD,-0.335343058,195,170,365
6626,-1.350869376,0.68018326,048-ASE,-0.335343058,166,232,398
6627,-1.350869376,0.68018326,048-ASF,-0.335343058,222,125,347
6628,-1.350869376,0.68018326,048-ASG,-0.335343058,293,201,494
6629,-1.350869376,0.68018326,048-ASH,-0.335343058,320,314,634
6630,-1.350869376,0.68018326,048-ASI,-0.335343058,278,206,484
6631,-1.350869376,0.68018326,048-ASJ,-0.335343058,294,234,528
6632,-1.350869376,0.68018326,048-AVF,-0.335343058,131,107,238
6633,-1.350869376,0.68018326,048-ASK,-0.335343058,398,376,774
6634,-1.350869376,0.68018326,048-ASL,-0.335343058,87,90,177
6635,-1.350869376,0.68018326,048-ASM,-0.335343058,161,268,429
6636,-1.350869376,0.68018326,048-ASN,-0.335343058,95,329,424
6637,-1.350869376,0.68018326,048-ASO,-0.335343058,381,542,923
6638,-1.350869376,0.68018326,048-ASP,-0.335343058,139,188,327
6639,-1.350869376,0.68018326,048-ASQ,-0.335343058,134,119,253
6640,-1.350869376,0.68018326,048-ASR,-0.335343058,200,185,385
6641,-1.350869376,0.68018326,048-ASS,-0.335343058,214,280,494
6642,-1.350869376,0.68018326,048-AST,-0.335343058,243,164,407
6643,-1.350869376,0.68018326,048-ASU,-0.335343058,213,275,488
6644,-1.350869376,0.68018326,048-ASV,-0.335343058,136,196,332
6645,-1.350869376,0.68018326,048-ASW,-0.335343058,136,134,270
6646,-1.350869376,0.68018326,048-ASX,-0.335343058,298,244,542
6647,-1.350869376,0.68018326,048-ASY,-0.335343058,228,303,531
6648,-1.350869376,0.68018326,048-ASZ,-0.335343058,371,558,929
6649,-1.350869376,0.68018326,048-ATA,-0.335343058,535,489,1024
6650,-1.350869376,0.68018326,048-ATB,-0.335343058,791,504,1295
6651,-1.350869376,0.68018326,048-AVC,-0.335343058,114,286,400
6652,-1.350869376,0.68018326,048-AVG,-0.335343058,208,279,487
6653,-1.350869376,0.68018326,048-AVW,-0.335343058,218,145,363
6654,-1.350869376,0.68018326,048-AVX,-0.335343058,185,240,425
6655,-1.350869376,0.68018326,048-ATC,-0.335343058,224,483,707
6656,-1.350869376,0.68018326,048-ATD,-0.335343058,44,110,154
6657,-1.350869376,0.68018326,048-ATE,-0.335343058,233,349,582
6658,-1.350869376,0.68018326,048-ATF,-0.335343058,202,276,478
6659,-1.350869376,0.68018326,048-ATG,-0.335343058,256,332,588
6660,-1.350869376,0.68018326,048-ATH,-0.335343058,310,284,594
6661,-1.350869376,0.68018326,048-ATI,-0.335343058,270,179,449
6662,-1.350869376,0.68018326,048-ATJ,-0.335343058,195,258,453
6663,-1.350869376,0.68018326,048-ATK,-0.335343058,323,400,723
6664,-1.350869376,0.68018326,048-ATL,-0.335343058,138,197,335
6665,-1.350869376,0.68018326,048-ABR,-0.335343058,321,269,590
6666,-1.350869376,0.68018326,048-ABS,-0.335343058,226,193,419
6667,-1.350869376,0.68018326,048-ABT,-0.335343058,75,100,175
6668,-1.350869376,0.68018326,048-ABU,-0.335343058,196,233,429
6669,-1.350869376,0.68018326,048-ABV,-0.335343058,189,184,373
6670,-1.350869376,0.68018326,048-ABW,-0.335343058,123,214,337
6671,-1.350869376,0.68018326,048-ABX,-0.335343058,220,259,479
6672,-1.350869376,0.68018326,048-ABY,-0.335343058,192,339,531
6673,-1.350869376,0.68018326,048-ABZ,-0.335343058,365,456,821
6674,-1.350869376,0.68018326,048-ACA,-0.335343058,390,226,616
6675,-1.350869376,0.68018326,048-ACB,-0.335343058,365,230,595
6676,-1.350869376,0.68018326,048-ACC,-0.335343058,184,110,294
6677,-1.350869376,0.68018326,048-ACD,-0.335343058,432,302,734
6678,-1.350869376,0.68018326,048-ACE,-0.335343058,430,373,803
6679,-1.350869376,0.68018326,048-AVO,-0.335343058,171,210,381
6680,-1.350869376,0.68018326,048-ACI,-0.335343058,335,382,717
6681,-1.350869376,0.68018326,048-ACJ,-0.335343058,172,184,356
6682,-1.350869376,0.68018326,048-ACK,-0.335343058,208,219,427
6683,-1.350869376,0.68018326,048-ACL,-0.335343058,92,155,247
6684,-1.350869376,0.68018326,048-ACM,-0.335343058,141,223,364
6685,-1.350869376,0.68018326,048-ACN,-0.335343058,356,317,673
6686,-1.350869376,0.68018326,048-ACO,-0.335343058,92,168,260
6687,-1.350869376,0.68018326,048-ATM,-0.335343058,244,389,633
6688,-1.350869376,0.68018326,048-ATN,-0.335343058,500,374,874
6689,-1.350869376,0.68018326,048-ATO,-0.335343058,136,137,273
6690,-1.350869376,0.68018326,048-AVB,-0.335343058,262,148,410
6691,-1.350869376,0.68018326,048-ATP,-0.335343058,228,233,461
6692,-1.350869376,0.68018326,048-AVI,-0.335343058,236,202,438
6693,-1.350869376,0.68018326,048-ATQ,-0.335343058,229,240,469
6694,-1.350869376,0.68018326,048-AVP,-0.335343058,167,257,424
6695,-1.350869376,0.68018326,048-ATR,-0.335343058,173,165,338
6696,-1.350869376,0.68018326,048-AVR,-0.335343058,212,161,373
6697,-1.350869376,0.68018326,048-ATS,-0.335343058,338,299,637
6698,-1.350869376,0.68018326,048-AVS,-0.335343058,163,165,328
6699,-1.350869376,0.68018326,048-ATT,-0.335343058,314,270,584
6700,-1.350869376,0.68018326,048-ATU,-0.335343058,179,153,332
6701,-1.350869376,0.68018326,048-ATV,-0.335343058,221,237,458
6702,-1.350869376,0.68018326,048-AVT,-0.335343058,155,99,254
6703,-1.350869376,0.68018326,048-AVU,-0.335343058,548,352,900
6704,-1.350869376,0.68018326,048-ATY,-0.335343058,170,187,357
6705,-1.350869376,0.68018326,048-ATZ,-0.335343058,187,271,458
6706,-1.350869376,0.68018326,048-AUA,-0.335343058,273,290,563
6707,-1.350869376,0.68018326,048-AUB,-0.335343058,318,335,653
6708,-1.350869376,0.68018326,048-AVV,-0.335343058,595,467,1062
6709,-1.350869376,0.68018326,048-AUD,-0.335343058,239,230,469
6710,-1.350869376,0.68018326,048-AUE,-0.335343058,287,310,597
6711,-1.350869376,0.68018326,048-AUF,-0.335343058,267,220,487
6712,-1.350869376,0.68018326,048-AUG,-0.335343058,417,388,805
6713,-1.350869376,0.68018326,048-AUH,-0.335343058,227,358,585
6714,-1.350869376,0.68018326,048-AUI,-0.335343058,202,213,415
6715,-1.350869376,0.68018326,048-AUJ,-0.335343058,218,232,450
6716,-1.350869376,0.68018326,048-AUK,-0.335343058,219,207,426
6717,-1.350869376,0.68018326,048-AUL,-0.335343058,233,291,524
6718,-1.350869376,0.68018326,048-AUM,-0.335343058,221,230,451
6719,-1.350869376,0.68018326,048-AIJ,-0.335343058,37,459,496
6720,-1.350869376,0.68018326,048-AIW,-0.335343058,75,517,592
6721,-1.350869376,0.68018326,048-AIL,-0.335343058,39,491,530
6722,-1.350869376,0.68018326,048-AIM,-0.335343058,10,459,469
6723,-1.350869376,0.68018326,048-AIN,-0.335343058,0,296,296
6724,-1.350869376,0.68018326,048-AIO,-0.335343058,8,411,419
6725,-1.350869376,0.68018326,048-AIP,-0.335343058,5,292,297
6726,-1.350869376,0.68018326,048-AIS,-0.335343058,28,358,386
6727,-1.350869376,0.68018326,048-AIR,-0.335343058,41,409,450
6728,-1.350869376,0.68018326,048-AIV,-0.335343058,6,302,308
6729,-1.350869376,0.68018326,048-AIU,-0.335343058,41,352,393
6730,-1.350869376,0.68018326,048-AIX,-0.335343058,68,303,371
6731,-1.350869376,0.68018326,048-AIY,-0.335343058,54,161,215
6732,-1.350869376,0.68018326,048-AIZ,-0.335343058,70,275,345
6733,-1.350869376,0.68018326,048-AJA,-0.335343058,58,139,197
6734,-1.350869376,0.68018326,048-AJB,-0.335343058,64,167,231
6735,-1.350869376,0.68018326,048-AJC,-0.335343058,61,160,221
6736,-1.350869376,0.68018326,048-AJD,-0.335343058,117,273,390
6737,-1.350869376,0.68018326,048-AJE,-0.335343058,106,193,299
6738,-1.350869376,0.68018326,048-AJF,-0.335343058,121,229,350
6739,-1.350869376,0.68018326,048-AJG,-0.335343058,167,456,623
6740,-1.350869376,0.68018326,048-AJH,-0.335343058,132,248,380
6741,-1.350869376,0.68018326,048-AJI,-0.335343058,91,235,326
6742,-1.350869376,0.68018326,048-AJJ,-0.335343058,67,158,225
6743,-1.350869376,0.68018326,048-AJK,-0.335343058,123,280,403
6744,-1.350869376,0.68018326,048-AJL,-0.335343058,98,115,213
6745,-1.350869376,0.68018326,048-AJM,-0.335343058,164,354,518
6746,-1.350869376,0.68018326,048-AJP,-0.335343058,154,405,559
6747,-1.350869376,0.68018326,048-AJQ,-0.335343058,138,424,562
6748,-1.350869376,0.68018326,048-AJR,-0.335343058,128,399,527
6749,-1.350869376,0.68018326,048-AJS,-0.335343058,49,564,613
6750,-1.350869376,0.68018326,048-AKD,-0.335343058,187,588,775
6751,-1.350869376,0.68018326,048-AKE,-0.335343058,89,242,331
6752,-1.350869376,0.68018326,048-AJV,-0.335343058,144,293,437
6753,-1.350869376,0.68018326,048-AJW,-0.335343058,146,387,533
6754,-1.350869376,0.68018326,048-AJX,-0.335343058,103,186,289
6755,-1.350869376,0.68018326,048-AJY,-0.335343058,107,445,552
6756,-1.350869376,0.68018326,048-AJZ,-0.335343058,203,322,525
6757,-1.350869376,0.68018326,048-AKA,-0.335343058,52,186,238
6758,-1.350869376,0.68018326,048-AKB,-0.335343058,225,323,548
6759,-1.350869376,0.68018326,048-AKC,-0.335343058,187,331,518
6760,-1.350869376,0.68018326,048-AKJ,-0.335343058,4,245,249
6761,-1.350869376,0.68018326,048-AKK,-0.335343058,1,285,286
6762,-1.350869376,0.68018326,048-AKL,-0.335343058,0,197,197
6763,-1.350869376,0.68018326,048-AKM,-0.335343058,18,464,482
6764,-1.350869376,0.68018326,048-AKN,-0.335343058,7,415,422
6765,-1.350869376,0.68018326,048-AKW,-0.335343058,77,272,349
6766,-1.350869376,0.68018326,048-AKP,-0.335343058,3,272,275
6767,-1.350869376,0.68018326,048-AKQ,-0.335343058,26,380,406
6768,-1.350869376,0.68018326,048-AKR,-0.335343058,2,308,310
6769,-1.350869376,0.68018326,048-AKS,-0.335343058,5,575,580
6770,-1.350869376,0.68018326,048-AKT,-0.335343058,24,233,257
6771,-1.350869376,0.68018326,048-AKU,-0.335343058,5,443,448
6772,-1.350869376,0.68018326,048-AKV,-0.335343058,97,405,502
6773,-1.350869376,0.68018326,048-ALA,-0.335343058,4,401,405
6774,-1.350869376,0.68018326,048-ALB,-0.335343058,6,443,449
6775,-1.350869376,0.68018326,048-ALC,-0.335343058,5,372,377
6776,-1.350869376,0.68018326,048-ALD,-0.335343058,2,477,479
6777,-1.350869376,0.68018326,048-ALM,-0.335343058,0,396,396
6778,-1.350869376,0.68018326,048-ALF,-0.335343058,1,260,261
6779,-1.350869376,0.68018326,048-ALG,-0.335343058,5,256,261
6780,-1.350869376,0.68018326,048-ALH,-0.335343058,3,261,264
6781,-1.350869376,0.68018326,048-ALI,-0.335343058,3,335,338
6782,-1.350869376,0.68018326,048-ALJ,-0.335343058,11,418,429
6783,-1.350869376,0.68018326,048-ALK,-0.335343058,19,472,491
6784,-1.350869376,0.68018326,048-ALL,-0.335343058,20,374,394
6785,-1.350869376,0.68018326,048-ALQ,-0.335343058,57,234,291
6786,-1.350869376,0.68018326,048-ALR,-0.335343058,71,270,341
6787,-1.350869376,0.68018326,048-ALS,-0.335343058,133,379,512
6788,-1.350869376,0.68018326,048-ALT,-0.335343058,115,327,442
6789,-1.350869376,0.68018326,048-ALU,-0.335343058,134,282,416
6790,-1.350869376,0.68018326,048-ALV,-0.335343058,100,261,361
6791,-1.350869376,0.68018326,048-ALW,-0.335343058,64,176,240
6792,-1.350869376,0.68018326,048-ALX,-0.335343058,78,255,333
6793,-1.350869376,0.68018326,048-ALY,-0.335343058,106,339,445
6794,-1.350869376,0.68018326,048-AMF,-0.335343058,33,325,358
6795,-1.350869376,0.68018326,048-AMA,-0.335343058,148,216,364
6796,-1.350869376,0.68018326,048-AMB,-0.335343058,134,297,431
6797,-1.350869376,0.68018326,048-AMC,-0.335343058,157,268,425
6798,-1.350869376,0.68018326,048-AMD,-0.335343058,115,133,248
6799,-1.350869376,0.68018326,048-AME,-0.335343058,119,354,473
6800,-1.350869376,0.68018326,048-AMG,-0.335343058,166,219,385
6801,-1.350869376,0.68018326,048-AMH,-0.335343058,163,192,355
6802,-1.350869376,0.68018326,048-AMI,-0.335343058,196,279,475
6803,-1.350869376,0.68018326,048-AMJ,-0.335343058,115,169,284
6804,-1.350869376,0.68018326,048-AMK,-0.335343058,165,223,388
6805,-1.350869376,0.68018326,048-AMX,-0.335343058,133,348,481
6806,-1.350869376,0.68018326,048-AMM,-0.335343058,286,223,509
6807,-1.350869376,0.68018326,048-AMN,-0.335343058,126,166,292
6808,-1.350869376,0.68018326,048-AMO,-0.335343058,219,189,408
6809,-1.350869376,0.68018326,048-AMP,-0.335343058,115,200,315
6810,-1.350869376,0.68018326,048-AMQ,-0.335343058,96,171,267
6811,-1.350869376,0.68018326,048-AMR,-0.335343058,79,222,301
6812,-1.350869376,0.68018326,048-AMS,-0.335343058,102,181,283
6813,-1.350869376,0.68018326,048-AMT,-0.335343058,287,337,624
6814,-1.350869376,0.68018326,048-AMU,-0.335343058,124,299,423
6815,-1.350869376,0.68018326,048-AMV,-0.335343058,85,210,295
6816,-1.350869376,0.68018326,048-AMW,-0.335343058,123,360,483
6817,-1.350869376,0.68018326,048-AMZ,-0.335343058,116,417,533
6818,-1.350869376,0.68018326,048-ANA,-0.335343058,68,417,485
6819,-1.350869376,0.68018326,048-ANB,-0.335343058,21,157,178
6820,-1.350869376,0.68018326,048-ANJ,-0.335343058,30,174,204
6821,-1.350869376,0.68018326,048-AND,-0.335343058,24,77,101
6822,-1.350869376,0.68018326,048-ANE,-0.335343058,86,397,483
6823,-1.350869376,0.68018326,048-ANF,-0.335343058,88,372,460
6824,-1.350869376,0.68018326,048-ANG,-0.335343058,56,254,310
6825,-1.350869376,0.68018326,048-ANH,-0.335343058,57,266,323
6826,-1.350869376,0.68018326,048-ANK,-0.335343058,75,303,378
6827,-1.350869376,0.68018326,048-ANO,-0.335343058,67,265,332
6828,-1.350869376,0.68018326,048-ANP,-0.335343058,42,224,266
6829,-1.350869376,0.68018326,048-ANQ,-0.335343058,24,297,321
6830,-1.350869376,0.68018326,048-ANR,-0.335343058,86,162,248
6831,-1.350869376,0.68018326,048-ANS,-0.335343058,116,276,392
6832,-1.350869376,0.68018326,048-ANT,-0.335343058,60,202,262
6833,-1.350869376,0.68018326,048-AVQ,-0.335343058,60,241,301
6834,-1.350869376,0.68018326,048-ANV,-0.335343058,120,286,406
6835,-1.350869376,0.68018326,048-ANW,-0.335343058,56,235,291
6836,-1.350869376,0.68018326,048-ANX,-0.335343058,38,221,259
6837,-1.350869376,0.68018326,048-ANY,-0.335343058,71,323,394
6838,-1.350869376,0.68018326,048-ANZ,-0.335343058,63,266,329
6839,-1.350869376,0.68018326,048-AOG,-0.335343058,93,375,468
6840,-1.350869376,0.68018326,048-AOB,-0.335343058,27,153,180
6841,-1.350869376,0.68018326,048-AOC,-0.335343058,43,167,210
6842,-1.350869376,0.68018326,048-AOD,-0.335343058,67,252,319
6843,-1.350869376,0.68018326,048-AOE,-0.335343058,94,328,422
6844,-1.350869376,0.68018326,048-AOH,-0.335343058,50,217,267
6845,-1.350869376,0.68018326,048-ACP,-0.335343058,130,250,380
6846,-1.350869376,0.68018326,048-ACQ,-0.335343058,138,234,372
6847,-1.350869376,0.68018326,048-ACR,-0.335343058,107,168,275
6848,-1.350869376,0.68018326,048-ACS,-0.335343058,118,245,363
6849,-1.350869376,0.68018326,048-ACT,-0.335343058,68,167,235
6850,-1.350869376,0.68018326,048-ACU,-0.335343058,155,256,411
6851,-1.350869376,0.68018326,048-ACV,-0.335343058,245,464,709
6852,-1.350869376,0.68018326,048-ACW,-0.335343058,207,351,558
6853,-1.350869376,0.68018326,048-ACX,-0.335343058,216,470,686
6854,-1.350869376,0.68018326,048-ACY,-0.335343058,216,361,577
6855,-1.350869376,0.68018326,048-ADD,-0.335343058,153,234,387
6856,-1.350869376,0.68018326,048-ADA,-0.335343058,122,327,449
6857,-1.350869376,0.68018326,048-ADB,-0.335343058,250,450,700
6858,-1.350869376,0.68018326,048-ADC,-0.335343058,80,375,455
6859,-1.350869376,0.68018326,048-AOJ,-0.335343058,68,272,340
6860,-1.350869376,0.68018326,048-AOS,-0.335343058,71,498,569
6861,-1.350869376,0.68018326,048-AOL,-0.335343058,53,271,324
6862,-1.350869376,0.68018326,048-AOM,-0.335343058,83,328,411
6863,-1.350869376,0.68018326,048-AON,-0.335343058,75,195,270
6864,-1.350869376,0.68018326,048-AOO,-0.335343058,118,398,516
6865,-1.350869376,0.68018326,048-AOP,-0.335343058,65,285,350
6866,-1.350869376,0.68018326,048-AOQ,-0.335343058,105,351,456
6867,-1.350869376,0.68018326,048-AOT,-0.335343058,33,136,169
6868,-1.350869376,0.68018326,048-AOU,-0.335343058,162,213,375
6869,-1.350869376,0.68018326,048-AOV,-0.335343058,266,323,589
6870,-1.350869376,0.68018326,048-AOW,-0.335343058,121,242,363
6871,-1.350869376,0.68018326,048-AOX,-0.335343058,193,214,407
6872,-1.350869376,0.68018326,048-AOY,-0.335343058,244,382,626
6873,-1.350869376,0.68018326,048-AOZ,-0.335343058,81,145,226
6874,-1.350869376,0.68018326,048-APA,-0.335343058,196,272,468
6875,-1.350869376,0.68018326,048-APB,-0.335343058,120,248,368
6876,-1.350869376,0.68018326,048-APK,-0.335343058,101,205,306
6877,-1.350869376,0.68018326,048-APL,-0.335343058,150,233,383
6878,-1.350869376,0.68018326,048-APE,-0.335343058,161,226,387
6879,-1.350869376,0.68018326,048-APF,-0.335343058,254,327,581
6880,-1.350869376,0.68018326,048-APG,-0.335343058,175,278,453
6881,-1.350869376,0.68018326,048-APH,-0.335343058,214,310,524
6882,-1.350869376,0.68018326,048-API,-0.335343058,107,185,292
6883,-1.350869376,0.68018326,048-APJ,-0.335343058,145,254,399
6884,-1.350869376,0.68018326,048-APP,-0.335343058,130,267,397
6885,-1.350869376,0.68018326,048-APQ,-0.335343058,189,332,521
6886,-1.350869376,0.68018326,048-APR,-0.335343058,135,200,335
6887,-1.350869376,0.68018326,048-APS,-0.335343058,121,180,301
6888,-1.350869376,0.68018326,048-APT,-0.335343058,173,202,375
6889,-1.350869376,0.68018326,048-APU,-0.335343058,131,125,256
6890,-1.350869376,0.68018326,048-APV,-0.335343058,174,215,389
6891,-1.350869376,0.68018326,048-APW,-0.335343058,196,252,448
6892,-1.350869376,0.68018326,048-APX,-0.335343058,144,286,430
6893,-1.350869376,0.68018326,048-APY,-0.335343058,138,237,375
6894,-1.350869376,0.68018326,048-APZ,-0.335343058,121,121,242
6895,-1.350869376,0.68018326,048-AQA,-0.335343058,269,390,659
6896,-1.350869376,0.68018326,048-AQB,-0.335343058,148,191,339
6897,-1.350869376,0.68018326,048-AQC,-0.335343058,251,330,581
6898,-1.350869376,0.68018326,048-AQG,-0.335343058,194,262,456
6899,-1.350869376,0.68018326,048-AQH,-0.335343058,183,285,468
6900,-1.350869376,0.68018326,048-AQI,-0.335343058,182,280,462
6901,-1.350869376,0.68018326,048-AQJ,-0.335343058,159,366,525
6902,-1.350869376,0.68018326,048-AQK,-0.335343058,88,222,310
6903,-1.350869376,0.68018326,048-AQL,-0.335343058,130,302,432
6904,-1.350869376,0.68018326,048-AQM,-0.335343058,76,214,290
6905,-1.350869376,0.68018326,048-AQN,-0.335343058,90,187,277
6906,-1.350869376,0.68018326,048-AQO,-0.335343058,110,306,416
6907,-1.350869376,0.68018326,048-AQP,-0.335343058,128,213,341
6908,-1.350869376,0.68018326,048-AQQ,-0.335343058,172,296,468
6909,-1.350869376,0.68018326,048-AQR,-0.335343058,211,334,545
6910,-1.350869376,0.68018326,048-AQS,-0.335343058,149,325,474
6911,-1.350869376,0.68018326,048-AQT,-0.335343058,183,225,408
6912,-1.350869376,0.68018326,048-AQU,-0.335343058,342,493,835
6913,-1.350869376,0.68018326,048-AQV,-0.335343058,129,216,345
6914,-1.350869376,0.68018326,048-AQW,-0.335343058,128,204,332
6915,-1.350869376,0.68018326,048-AQX,-0.335343058,283,343,626
6916,-1.350869376,0.68018326,048-AQZ,-0.335343058,136,241,377
6917,-1.350869376,0.68018326,048-ARA,-0.335343058,113,291,404
6918,-1.350869376,0.68018326,048-ARB,-0.335343058,206,440,646
6919,-1.350869376,0.68018326,048-ARO,-0.335343058,125,385,510
6920,-1.350869376,0.68018326,048-ARD,-0.335343058,65,241,306
6921,-1.350869376,0.68018326,048-ARE,-0.335343058,124,594,718
6922,-1.350869376,0.68018326,048-ARF,-0.335343058,156,242,398
6923,-1.350869376,0.68018326,048-ARG,-0.335343058,152,217,369
6924,-1.350869376,0.68018326,048-ARH,-0.335343058,132,469,601
6925,-1.350869376,0.68018326,048-ARI,-0.335343058,266,333,599
6926,-1.350869376,0.68018326,048-ARJ,-0.335343058,77,188,265
6927,-1.350869376,0.68018326,048-ARK,-0.335343058,223,328,551
6928,-1.350869376,0.68018326,048-AVY,-0.335343058,144,324,468
6929,-1.350869376,0.68018326,048-ARM,-0.335343058,227,284,511
6930,-1.350869376,0.68018326,048-ARN,-0.335343058,106,251,357
6931,-1.350869376,0.68018326,048-ADG,-0.335343058,46,279,325
6932,-1.350869376,0.68018326,048-ADH,-0.335343058,47,390,437
6933,-1.350869376,0.68018326,048-ADI,-0.335343058,60,204,264
6934,-1.350869376,0.68018326,048-ADQ,-0.335343058,45,328,373
6935,-1.350869376,0.68018326,048-ADK,-0.335343058,108,363,471
6936,-1.350869376,0.68018326,048-ADR,-0.335343058,27,364,391
6937,-1.350869376,0.68018326,048-ADM,-0.335343058,53,333,386
6938,-1.350869376,0.68018326,048-ADP,-0.335343058,27,327,354
6939,-1.350869376,0.68018326,048-ADO,-0.335343058,11,255,266
6940,-1.350869376,0.68018326,048-ADT,-0.335343058,118,226,344
6941,-1.350869376,0.68018326,048-ADU,-0.335343058,181,377,558
6942,-1.350869376,0.68018326,048-ADV,-0.335343058,57,334,391
6943,-1.350869376,0.68018326,048-ADW,-0.335343058,155,280,435
6944,-1.350869376,0.68018326,048-ADX,-0.335343058,76,152,228
6945,-1.350869376,0.68018326,048-ADY,-0.335343058,156,256,412
6946,-1.350869376,0.68018326,048-ADZ,-0.335343058,90,185,275
6947,-1.350869376,0.68018326,048-AEA,-0.335343058,134,197,331
6948,-1.350869376,0.68018326,048-AEC,-0.335343058,75,239,314
6949,-1.350869376,0.68018326,048-AED,-0.335343058,211,369,580
6950,-1.350869376,0.68018326,048-AEE,-0.335343058,165,390,555
6951,-1.350869376,0.68018326,048-AEF,-0.335343058,85,197,282
6952,-1.350869376,0.68018326,048-AEG,-0.335343058,136,304,440
6953,-1.350869376,0.68018326,048-AEH,-0.335343058,143,297,440
6954,-1.350869376,0.68018326,048-AEM,-0.335343058,141,294,435
6955,-1.350869376,0.68018326,048-AEJ,-0.335343058,97,182,279
6956,-1.350869376,0.68018326,048-AEN,-0.335343058,135,317,452
6957,-1.350869376,0.68018326,048-AEL,-0.335343058,116,272,388
6958,-1.350869376,0.68018326,048-AEO,-0.335343058,22,206,228
6959,-1.350869376,0.68018326,048-AEP,-0.335343058,64,416,480
6960,-1.350869376,0.68018326,048-AER,-0.335343058,51,415,466
6961,-1.350869376,0.68018326,048-AES,-0.335343058,42,437,479
6962,-1.350869376,0.68018326,048-AET,-0.335343058,40,258,298
6963,-1.350869376,0.68018326,048-AEU,-0.335343058,34,305,339
6964,-1.350869376,0.68018326,048-AEV,-0.335343058,18,219,237
6965,-1.350869376,0.68018326,048-AEW,-0.335343058,21,283,304
6966,-1.350869376,0.68018326,048-AEX,-0.335343058,34,354,388
6967,-1.350869376,0.68018326,048-AEY,-0.335343058,12,248,260
6968,-1.350869376,0.68018326,048-AEZ,-0.335343058,7,241,248
6969,-1.350869376,0.68018326,048-AFA,-0.335343058,15,369,384
6970,-1.350869376,0.68018326,048-AFB,-0.335343058,16,453,469
6971,-1.350869376,0.68018326,048-AFC,-0.335343058,36,523,559
6972,-1.350869376,0.68018326,048-AFF,-0.335343058,63,253,316
6973,-1.350869376,0.68018326,048-AFG,-0.335343058,50,165,215
6974,-1.350869376,0.68018326,048-AFH,-0.335343058,214,402,616
6975,-1.350869376,0.68018326,048-AFI,-0.335343058,194,507,701
6976,-1.350869376,0.68018326,048-AFJ,-0.335343058,158,448,606
6977,-1.350869376,0.68018326,048-AFK,-0.335343058,163,349,512
6978,-1.350869376,0.68018326,048-AFL,-0.335343058,199,436,635
6979,-1.350869376,0.68018326,048-AFM,-0.335343058,123,408,531
6980,-1.350869376,0.68018326,048-AFN,-0.335343058,236,334,570
6981,-1.350869376,0.68018326,048-AFO,-0.335343058,126,353,479
6982,-1.350869376,0.68018326,048-AFP,-0.335343058,140,215,355
6983,-1.350869376,0.68018326,048-AFQ,-0.335343058,134,257,391
6984,-1.350869376,0.68018326,048-AFR,-0.335343058,181,402,583
6985,-1.350869376,0.68018326,048-AFT,-0.335343058,107,184,291
6986,-1.350869376,0.68018326,048-AFV,-0.335343058,33,273,306
6987,-1.350869376,0.68018326,048-AFW,-0.335343058,67,582,649
6988,-1.350869376,0.68018326,048-AFX,-0.335343058,98,757,855
6989,-1.350869376,0.68018326,048-AFY,-0.335343058,52,300,352
6990,-1.350869376,0.68018326,048-AFZ,-0.335343058,80,120,200
6991,-1.350869376,0.68018326,048-AGA,-0.335343058,94,326,420
6992,-1.350869376,0.68018326,048-AGB,-0.335343058,49,346,395
6993,-1.350869376,0.68018326,048-AGC,-0.335343058,15,405,420
6994,-1.350869376,0.68018326,048-AGD,-0.335343058,26,442,468
6995,-1.350869376,0.68018326,048-AGE,-0.335343058,21,628,649
6996,-1.350869376,0.68018326,048-AGF,-0.335343058,26,137,163
6997,-1.350869376,0.68018326,048-AGG,-0.335343058,52,350,402
6998,-1.350869376,0.68018326,048-AGH,-0.335343058,44,310,354
6999,-1.350869376,0.68018326,048-AGI,-0.335343058,48,524,572
7000,-1.350869376,0.68018326,048-AGJ,-0.335343058,48,489,537
7001,-1.350869376,0.68018326,048-AGK,-0.335343058,19,417,436
7002,-1.350869376,0.68018326,048-AGL,-0.335343058,184,354,538
7003,-1.350869376,0.68018326,048-AGM,-0.335343058,44,472,516
7004,-1.350869376,0.68018326,048-AGN,-0.335343058,200,212,412
7005,-1.350869376,0.68018326,048-AGO,-0.335343058,203,218,421
7006,-1.350869376,0.68018326,048-AGP,-0.335343058,176,378,554
7007,-1.350869376,0.68018326,048-AGZ,-0.335343058,178,237,415
7008,-1.350869376,0.68018326,048-AGR,-0.335343058,227,249,476
7009,-1.350869376,0.68018326,048-AHA,-0.335343058,137,220,357
7010,-1.350869376,0.68018326,048-AGT,-0.335343058,121,180,301
7011,-1.350869376,0.68018326,048-AGU,-0.335343058,92,159,251
7012,-1.350869376,0.68018326,048-AGV,-0.335343058,147,209,356
7013,-1.350869376,0.68018326,048-AGW,-0.335343058,232,244,476
7014,-1.350869376,0.68018326,048-AGX,-0.335343058,168,216,384
7015,-1.350869376,0.68018326,048-AGY,-0.335343058,134,206,340
7016,-1.350869376,0.68018326,048-AHB,-0.335343058,3,404,407
7017,-1.350869376,0.68018326,048-AHC,-0.335343058,5,489,494
7018,-1.350869376,0.68018326,048-AHD,-0.335343058,1,464,465
7019,-1.350869376,0.68018326,048-AHE,-0.335343058,1,252,253
7020,-1.350869376,0.68018326,048-AHF,-0.335343058,5,299,304
7021,-1.350869376,0.68018326,048-AHG,-0.335343058,0,236,236
7022,-1.350869376,0.68018326,048-AHH,-0.335343058,1,373,374
7023,-1.350869376,0.68018326,048-AHI,-0.335343058,6,197,203
7024,-1.350869376,0.68018326,048-AHJ,-0.335343058,55,360,415
7025,-1.350869376,0.68018326,048-AHK,-0.335343058,45,382,427
7026,-1.350869376,0.68018326,048-AHL,-0.335343058,20,711,731
7027,-1.350869376,0.68018326,048-AHM,-0.335343058,4,540,544
7028,-1.350869376,0.68018326,048-AHN,-0.335343058,48,238,286
7029,-1.350869376,0.68018326,048-AHR,-0.335343058,98,310,408
7030,-1.350869376,0.68018326,048-AVZ,-0.335343058,110,431,541
7031,-1.350869376,0.68018326,048-AHT,-0.335343058,120,349,469
7032,-1.350869376,0.68018326,048-AHU,-0.335343058,112,339,451
7033,-1.350869376,0.68018326,048-AHV,-0.335343058,90,293,383
7034,-1.350869376,0.68018326,048-AHW,-0.335343058,100,339,439
7035,-1.350869376,0.68018326,048-AHX,-0.335343058,104,243,347
7036,-1.350869376,0.68018326,048-AHY,-0.335343058,146,332,478
7037,-1.350869376,0.68018326,048-AHZ,-0.335343058,116,267,383
7038,-1.350869376,0.68018326,048-AIA,-0.335343058,126,214,340
7039,-1.350869376,0.68018326,048-AIB,-0.335343058,117,293,410
7040,-1.350869376,0.68018326,048-AIF,-0.335343058,150,311,461
7041,-1.350869376,0.68018326,048-AID,-0.335343058,77,241,318
7042,-1.350869376,0.68018326,048-AIE,-0.335343058,117,407,524
7043,-1.350869376,0.68018326,048-AUN,-0.335343058,196,331,527
7044,-1.350869376,0.68018326,048-AUO,-0.335343058,160,291,451
7045,-1.350869376,0.68018326,048-AUP,-0.335343058,66,212,278
7046,-1.350869376,0.68018326,048-AUQ,-0.335343058,149,232,381
7047,-1.350869376,0.68018326,048-AUR,-0.335343058,413,353,766
7048,-1.350869376,0.68018326,048-AUS,-0.335343058,353,323,676
7049,-1.350869376,0.68018326,048-AUT,-0.335343058,243,189,432
7050,-1.350869376,0.68018326,048-AUU,-0.335343058,372,398,770
7051,-1.350869376,0.68018326,048-AUV,-0.335343058,269,273,542
7052,-1.350869376,0.68018326,048-AUW,-0.335343058,418,361,779
7053,-1.350869376,0.68018326,048-AUX,-0.335343058,429,295,724
7054,-1.350869376,0.68018326,048-AUY,-0.335343058,245,234,479
7055,-1.350869376,0.68018326,048-AUZ,-0.335343058,330,228,558
7056,-1.350869376,0.68018326,048-AVA,-0.335343058,465,361,826
7057,-1.350869376,0.68018326,049-AAM,-0.335343058,321,144,465
7058,-1.350869376,0.68018326,049-AAN,-0.335343058,467,191,658
7059,-1.350869376,0.68018326,049-ABL,-0.335343058,374,184,558
7060,-1.350869376,0.68018326,049-ABM,-0.335343058,407,263,670
7061,-1.350869376,0.68018326,049-AAO,-0.335343058,275,89,364
7062,-1.350869376,0.68018326,049-AAR,-0.335343058,262,179,441
7063,-1.350869376,0.68018326,049-AAS,-0.335343058,194,108,302
7064,-1.350869376,0.68018326,049-AAT,-0.335343058,313,134,447
7065,-1.350869376,0.68018326,049-AAU,-0.335343058,359,148,507
7066,-1.350869376,0.68018326,049-AAV,-0.335343058,277,176,453
7067,-1.350869376,0.68018326,049-AAW,-0.335343058,400,149,549
7068,-1.350869376,0.68018326,049-AAA,-0.335343058,68,64,132
7069,-1.350869376,0.68018326,049-AAB,-0.335343058,105,89,194
7070,-1.350869376,0.68018326,049-AAC,-0.335343058,245,283,528
7071,-1.350869376,0.68018326,049-ABS,-0.335343058,214,171,385
7072,-1.350869376,0.68018326,049-AAD,-0.335343058,124,85,209
7073,-1.350869376,0.68018326,049-AAE,-0.335343058,169,166,335
7074,-1.350869376,0.68018326,049-AAG,-0.335343058,342,241,583
7075,-1.350869376,0.68018326,049-AAH,-0.335343058,224,392,616
7076,-1.350869376,0.68018326,049-AAJ,-0.335343058,48,76,124
7077,-1.350869376,0.68018326,049-AAK,-0.335343058,296,210,506
7078,-1.350869376,0.68018326,049-AAL,-0.335343058,156,145,301
7079,-1.350869376,0.68018326,049-ABJ,-0.335343058,67,47,114
7080,-1.350869376,0.68018326,049-ABB,-0.335343058,406,216,622
7081,-1.350869376,0.68018326,049-ABH,-0.335343058,217,179,396
7082,-1.350869376,0.68018326,049-ABI,-0.335343058,163,86,249
7083,-1.350869376,0.68018326,049-ABC,-0.335343058,167,104,271
7084,-1.350869376,0.68018326,049-ABD,-0.335343058,207,101,308
7085,-1.350869376,0.68018326,049-ABE,-0.335343058,166,44,210
7086,-1.350869376,0.68018326,049-AAP,-0.335343058,383,220,603
7087,-1.350869376,0.68018326,049-AAQ,-0.335343058,481,217,698
7088,-1.350869376,0.68018326,049-ABF,-0.335343058,217,96,313
7089,-1.350869376,0.68018326,049-ABG,-0.335343058,222,99,321
7090,-1.350869376,0.68018326,049-ABK,-0.335343058,246,111,357
7091,-1.350869376,0.68018326,049-ABN,-0.335343058,365,204,569
7092,-1.350869376,0.68018326,049-ABO,-0.335343058,92,45,137
7093,-1.350869376,0.68018326,049-ABP,-0.335343058,83,51,134
7094,-1.350869376,0.68018326,049-ABQ,-0.335343058,229,193,422
7095,-1.350869376,0.68018326,049-ABR,-0.335343058,181,100,281
7096,-1.350869376,0.68018326,049-AAX,-0.335343058,253,217,470
7097,-1.350869376,0.68018326,049-AAY,-0.335343058,300,226,526
7098,-1.350869376,0.68018326,049-AAZ,-0.335343058,280,162,442
7099,-1.350869376,0.68018326,049-ABA,-0.335343058,238,127,365
7100,-1.350869376,0.68018326,050-ASM,-0.335343058,138,224,362
7101,-1.350869376,0.68018326,050-ASN,-0.335343058,202,352,554
7102,-1.350869376,0.68018326,050-AHZ,-0.335343058,129,243,372
7103,-1.350869376,0.68018326,050-AIK,-0.335343058,150,264,414
7104,-1.350869376,0.68018326,050-AIV,-0.335343058,264,354,618
7105,-1.350869376,0.68018326,050-AJG,-0.335343058,216,417,633
7106,-1.350869376,0.68018326,050-AJJ,-0.335343058,226,397,623
7107,-1.350869376,0.68018326,050-AJK,-0.335343058,87,181,268
7108,-1.350869376,0.68018326,050-AJL,-0.335343058,75,173,248
7109,-1.350869376,0.68018326,050-AHE,-0.335343058,165,393,558
7110,-1.350869376,0.68018326,050-AHF,-0.335343058,75,187,262
7111,-1.350869376,0.68018326,050-AHG,-0.335343058,137,296,433
7112,-1.350869376,0.68018326,050-AHH,-0.335343058,133,324,457
7113,-1.350869376,0.68018326,050-ASO,-0.335343058,120,255,375
7114,-1.350869376,0.68018326,050-AHJ,-0.335343058,148,275,423
7115,-1.350869376,0.68018326,050-ASP,-0.335343058,180,277,457
7116,-1.350869376,0.68018326,050-AHL,-0.335343058,267,430,697
7117,-1.350869376,0.68018326,050-AHM,-0.335343058,170,311,481
7118,-1.350869376,0.68018326,050-AHN,-0.335343058,133,285,418
7119,-1.350869376,0.68018326,050-AHP,-0.335343058,139,285,424
7120,-1.350869376,0.68018326,050-ASQ,-0.335343058,155,226,381
7121,-1.350869376,0.68018326,050-AHR,-0.335343058,142,274,416
7122,-1.350869376,0.68018326,050-ASR,-0.335343058,182,213,395
7123,-1.350869376,0.68018326,050-AHT,-0.335343058,82,245,327
7124,-1.350869376,0.68018326,050-AHU,-0.335343058,109,376,485
7125,-1.350869376,0.68018326,050-AHV,-0.335343058,266,432,698
7126,-1.350869376,0.68018326,050-ASS,-0.335343058,259,329,588
7127,-1.350869376,0.68018326,050-AHX,-0.335343058,74,157,231
7128,-1.350869376,0.68018326,050-AHY,-0.335343058,161,423,584
7129,-1.350869376,0.68018326,050-AIA,-0.335343058,204,385,589
7130,-1.350869376,0.68018326,050-AIB,-0.335343058,116,262,378
7131,-1.350869376,0.68018326,050-AIC,-0.335343058,102,271,373
7132,-1.350869376,0.68018326,050-AID,-0.335343058,180,340,520
7133,-1.350869376,0.68018326,050-AIE,-0.335343058,104,304,408
7134,-1.350869376,0.68018326,050-AST,-0.335343058,320,519,839
7135,-1.350869376,0.68018326,050-AIG,-0.335343058,146,296,442
7136,-1.350869376,0.68018326,050-AIH,-0.335343058,129,260,389
7137,-1.350869376,0.68018326,050-AII,-0.335343058,166,421,587
7138,-1.350869376,0.68018326,050-AIJ,-0.335343058,144,284,428
7139,-1.350869376,0.68018326,050-AIL,-0.335343058,82,195,277
7140,-1.350869376,0.68018326,050-AIM,-0.335343058,95,135,230
7141,-1.350869376,0.68018326,050-AIN,-0.335343058,138,457,595
7142,-1.350869376,0.68018326,050-AIO,-0.335343058,95,153,248
7143,-1.350869376,0.68018326,050-AJY,-0.335343058,309,319,628
7144,-1.350869376,0.68018326,050-AKJ,-0.335343058,191,232,423
7145,-1.350869376,0.68018326,050-AKU,-0.335343058,218,283,501
7146,-1.350869376,0.68018326,050-ALF,-0.335343058,162,171,333
7147,-1.350869376,0.68018326,050-ALQ,-0.335343058,86,171,257
7148,-1.350869376,0.68018326,050-AMB,-0.335343058,116,341,457
7149,-1.350869376,0.68018326,050-AMM,-0.335343058,193,390,583
7150,-1.350869376,0.68018326,050-ASW,-0.335343058,130,190,320
7151,-1.350869376,0.68018326,050-AMS,-0.335343058,188,360,548
7152,-1.350869376,0.68018326,050-AJZ,-0.335343058,315,384,699
7153,-1.350869376,0.68018326,050-AKA,-0.335343058,188,334,522
7154,-1.350869376,0.68018326,050-AKB,-0.335343058,244,294,538
7155,-1.350869376,0.68018326,050-ASX,-0.335343058,205,253,458
7156,-1.350869376,0.68018326,050-AKD,-0.335343058,172,301,473
7157,-1.350869376,0.68018326,050-AKE,-0.335343058,137,289,426
7158,-1.350869376,0.68018326,050-AKF,-0.335343058,208,270,478
7159,-1.350869376,0.68018326,050-AKG,-0.335343058,164,213,377
7160,-1.350869376,0.68018326,050-AKH,-0.335343058,170,303,473
7161,-1.350869376,0.68018326,050-ASY,-0.335343058,188,345,533
7162,-1.350869376,0.68018326,050-AKK,-0.335343058,258,278,536
7163,-1.350869376,0.68018326,050-ASZ,-0.335343058,174,207,381
7164,-1.350869376,0.68018326,050-AKM,-0.335343058,217,299,516
7165,-1.350869376,0.68018326,050-AKN,-0.335343058,177,274,451
7166,-1.350869376,0.68018326,050-ATA,-0.335343058,115,148,263
7167,-1.350869376,0.68018326,050-AKP,-0.335343058,361,333,694
7168,-1.350869376,0.68018326,050-ATB,-0.335343058,290,305,595
7169,-1.350869376,0.68018326,050-AKR,-0.335343058,112,182,294
7170,-1.350869376,0.68018326,050-AKS,-0.335343058,200,231,431
7171,-1.350869376,0.68018326,050-AKT,-0.335343058,147,226,373
7172,-1.350869376,0.68018326,050-AKV,-0.335343058,134,212,346
7173,-1.350869376,0.68018326,050-AKW,-0.335343058,107,261,368
7174,-1.350869376,0.68018326,050-AKX,-0.335343058,158,287,445
7175,-1.350869376,0.68018326,050-AKY,-0.335343058,242,307,549
7176,-1.350869376,0.68018326,050-AKZ,-0.335343058,134,236,370
7177,-1.350869376,0.68018326,050-ATC,-0.335343058,237,287,524
7178,-1.350869376,0.68018326,050-ALB,-0.335343058,204,288,492
7179,-1.350869376,0.68018326,050-ALC,-0.335343058,132,242,374
7180,-1.350869376,0.68018326,050-ALD,-0.335343058,157,261,418
7181,-1.350869376,0.68018326,050-ALE,-0.335343058,208,459,667
7182,-1.350869376,0.68018326,050-ALG,-0.335343058,84,221,305
7183,-1.350869376,0.68018326,050-ATD,-0.335343058,213,273,486
7184,-1.350869376,0.68018326,050-ALI,-0.335343058,256,294,550
7185,-1.350869376,0.68018326,050-ALJ,-0.335343058,195,290,485
7186,-1.350869376,0.68018326,050-ALK,-0.335343058,150,273,423
7187,-1.350869376,0.68018326,050-ALL,-0.335343058,245,220,465
7188,-1.350869376,0.68018326,050-ATE,-0.335343058,238,266,504
7189,-1.350869376,0.68018326,050-ALN,-0.335343058,183,248,431
7190,-1.350869376,0.68018326,050-ALO,-0.335343058,263,271,534
7191,-1.350869376,0.68018326,050-ALP,-0.335343058,140,199,339
7192,-1.350869376,0.68018326,050-ALR,-0.335343058,113,209,322
7193,-1.350869376,0.68018326,050-ALS,-0.335343058,192,223,415
7194,-1.350869376,0.68018326,050-APE,-0.335343058,215,171,386
7195,-1.350869376,0.68018326,050-AJV,-0.335343058,184,208,392
7196,-1.350869376,0.68018326,050-AJW,-0.335343058,263,213,476
7197,-1.350869376,0.68018326,050-AJX,-0.335343058,161,158,319
7198,-1.350869376,0.68018326,050-AJM,-0.335343058,265,192,457
7199,-1.350869376,0.68018326,050-AJN,-0.335343058,268,242,510
7200,-1.350869376,0.68018326,050-AJO,-0.335343058,278,208,486
7201,-1.350869376,0.68018326,050-AJP,-0.335343058,496,310,806
7202,-1.350869376,0.68018326,050-AJQ,-0.335343058,333,361,694
7203,-1.350869376,0.68018326,050-AJR,-0.335343058,267,170,437
7204,-1.350869376,0.68018326,050-AJS,-0.335343058,126,176,302
7205,-1.350869376,0.68018326,050-AJT,-0.335343058,160,102,262
7206,-1.350869376,0.68018326,050-AOA,-0.335343058,195,367,562
7207,-1.350869376,0.68018326,050-AAA,-0.335343058,46,241,287
7208,-1.350869376,0.68018326,050-AAB,-0.335343058,25,187,212
7209,-1.350869376,0.68018326,050-AAC,-0.335343058,57,303,360
7210,-1.350869376,0.68018326,050-AAE,-0.335343058,116,279,395
7211,-1.350869376,0.68018326,050-AAF,-0.335343058,111,363,474
7212,-1.350869376,0.68018326,050-AAG,-0.335343058,148,335,483
7213,-1.350869376,0.68018326,050-AAI,-0.335343058,81,295,376
7214,-1.350869376,0.68018326,050-AAJ,-0.335343058,130,460,590
7215,-1.350869376,0.68018326,050-AAM,-0.335343058,89,385,474
7216,-1.350869376,0.68018326,050-AAN,-0.335343058,82,268,350
7217,-1.350869376,0.68018326,050-AAO,-0.335343058,45,258,303
7218,-1.350869376,0.68018326,050-AAS,-0.335343058,198,230,428
7219,-1.350869376,0.68018326,050-AAW,-0.335343058,248,235,483
7220,-1.350869376,0.68018326,050-AAX,-0.335343058,272,249,521
7221,-1.350869376,0.68018326,050-AAY,-0.335343058,266,206,472
7222,-1.350869376,0.68018326,050-AAZ,-0.335343058,303,236,539
7223,-1.350869376,0.68018326,050-ATG,-0.335343058,204,167,371
7224,-1.350869376,0.68018326,050-ABB,-0.335343058,190,233,423
7225,-1.350869376,0.68018326,050-ABC,-0.335343058,237,184,421
7226,-1.350869376,0.68018326,050-ABD,-0.335343058,381,290,671
7227,-1.350869376,0.68018326,050-AAT,-0.335343058,229,219,448
7228,-1.350869376,0.68018326,050-AMT,-0.335343058,360,255,615
7229,-1.350869376,0.68018326,050-AMV,-0.335343058,236,280,516
7230,-1.350869376,0.68018326,050-AMW,-0.335343058,375,335,710
7231,-1.350869376,0.68018326,050-AMX,-0.335343058,349,302,651
7232,-1.350869376,0.68018326,050-AMY,-0.335343058,348,300,648
7233,-1.350869376,0.68018326,050-AMZ,-0.335343058,465,327,792
7234,-1.350869376,0.68018326,050-ANA,-0.335343058,386,196,582
7235,-1.350869376,0.68018326,050-ATH,-0.335343058,309,243,552
7236,-1.350869376,0.68018326,050-AND,-0.335343058,105,234,339
7237,-1.350869376,0.68018326,050-ANE,-0.335343058,218,288,506
7238,-1.350869376,0.68018326,050-ANG,-0.335343058,297,315,612
7239,-1.350869376,0.68018326,050-ANH,-0.335343058,157,137,294
7240,-1.350869376,0.68018326,050-ANI,-0.335343058,196,221,417
7241,-1.350869376,0.68018326,050-ANJ,-0.335343058,343,181,524
7242,-1.350869376,0.68018326,050-ANK,-0.335343058,374,229,603
7243,-1.350869376,0.68018326,050-ANL,-0.335343058,263,199,462
7244,-1.350869376,0.68018326,050-ANP,-0.335343058,298,216,514
7245,-1.350869376,0.68018326,050-ANQ,-0.335343058,282,152,434
7246,-1.350869376,0.68018326,050-ANR,-0.335343058,303,195,498
7247,-1.350869376,0.68018326,050-ANS,-0.335343058,193,124,317
7248,-1.350869376,0.68018326,050-ANU,-0.335343058,238,270,508
7249,-1.350869376,0.68018326,050-ANV,-0.335343058,203,175,378
7250,-1.350869376,0.68018326,050-ANW,-0.335343058,176,178,354
7251,-1.350869376,0.68018326,050-AOV,-0.335343058,126,200,326
7252,-1.350869376,0.68018326,050-AOW,-0.335343058,126,229,355
7253,-1.350869376,0.68018326,050-ANX,-0.335343058,234,291,525
7254,-1.350869376,0.68018326,050-ANY,-0.335343058,233,276,509
7255,-1.350869376,0.68018326,050-ANZ,-0.335343058,200,221,421
7256,-1.350869376,0.68018326,050-APS,-0.335343058,193,310,503
7257,-1.350869376,0.68018326,050-APT,-0.335343058,188,251,439
7258,-1.350869376,0.68018326,050-AOC,-0.335343058,238,306,544
7259,-1.350869376,0.68018326,050-AON,-0.335343058,175,210,385
7260,-1.350869376,0.68018326,050-AOO,-0.335343058,141,227,368
7261,-1.350869376,0.68018326,050-AOP,-0.335343058,226,253,479
7262,-1.350869376,0.68018326,050-AOQ,-0.335343058,462,312,774
7263,-1.350869376,0.68018326,050-AOR,-0.335343058,133,259,392
7264,-1.350869376,0.68018326,050-AOS,-0.335343058,266,347,613
7265,-1.350869376,0.68018326,050-AOT,-0.335343058,151,222,373
7266,-1.350869376,0.68018326,050-AOU,-0.335343058,169,223,392
7267,-1.350869376,0.68018326,050-ASL,-0.335343058,222,218,440
7268,-1.350869376,0.68018326,050-AOE,-0.335343058,194,192,386
7269,-1.350869376,0.68018326,050-AOF,-0.335343058,202,232,434
7270,-1.350869376,0.68018326,050-AOG,-0.335343058,238,190,428
7271,-1.350869376,0.68018326,050-AOH,-0.335343058,461,436,897
7272,-1.350869376,0.68018326,050-AOI,-0.335343058,159,145,304
7273,-1.350869376,0.68018326,050-AOJ,-0.335343058,344,216,560
7274,-1.350869376,0.68018326,050-AOY,-0.335343058,152,179,331
7275,-1.350869376,0.68018326,050-AOZ,-0.335343058,232,245,477
7276,-1.350869376,0.68018326,050-APA,-0.335343058,225,222,447
7277,-1.350869376,0.68018326,050-APB,-0.335343058,233,169,402
7278,-1.350869376,0.68018326,050-APV,-0.335343058,111,203,314
7279,-1.350869376,0.68018326,050-APW,-0.335343058,150,186,336
7280,-1.350869376,0.68018326,050-APX,-0.335343058,223,262,485
7281,-1.350869376,0.68018326,050-APY,-0.335343058,180,239,419
7282,-1.350869376,0.68018326,050-APZ,-0.335343058,227,173,400
7283,-1.350869376,0.68018326,050-APF,-0.335343058,226,147,373
7284,-1.350869376,0.68018326,050-APG,-0.335343058,55,94,149
7285,-1.350869376,0.68018326,050-APH,-0.335343058,250,155,405
7286,-1.350869376,0.68018326,050-API,-0.335343058,254,223,477
7287,-1.350869376,0.68018326,050-APJ,-0.335343058,330,281,611
7288,-1.350869376,0.68018326,050-APK,-0.335343058,341,270,611
7289,-1.350869376,0.68018326,050-APL,-0.335343058,251,159,410
7290,-1.350869376,0.68018326,050-APM,-0.335343058,203,228,431
7291,-1.350869376,0.68018326,050-APN,-0.335343058,304,340,644
7292,-1.350869376,0.68018326,050-APO,-0.335343058,178,210,388
7293,-1.350869376,0.68018326,050-APP,-0.335343058,226,212,438
7294,-1.350869376,0.68018326,050-AQA,-0.335343058,64,156,220
7295,-1.350869376,0.68018326,050-ABF,-0.335343058,66,175,241
7296,-1.350869376,0.68018326,050-AQB,-0.335343058,94,180,274
7297,-1.350869376,0.68018326,050-AQC,-0.335343058,62,141,203
7298,-1.350869376,0.68018326,050-ABJ,-0.335343058,108,224,332
7299,-1.350869376,0.68018326,050-ABK,-0.335343058,80,248,328
7300,-1.350869376,0.68018326,050-AQD,-0.335343058,97,246,343
7301,-1.350869376,0.68018326,050-AQE,-0.335343058,98,268,366
7302,-1.350869376,0.68018326,050-ABO,-0.335343058,91,282,373
7303,-1.350869376,0.68018326,050-ABP,-0.335343058,193,336,529
7304,-1.350869376,0.68018326,050-ABQ,-0.335343058,146,337,483
7305,-1.350869376,0.68018326,050-ABT,-0.335343058,99,258,357
7306,-1.350869376,0.68018326,050-ABU,-0.335343058,134,282,416
7307,-1.350869376,0.68018326,050-AQF,-0.335343058,142,280,422
7308,-1.350869376,0.68018326,050-AQG,-0.335343058,104,242,346
7309,-1.350869376,0.68018326,050-ANT,-0.335343058,64,83,147
7310,-1.350869376,0.68018326,050-ABY,-0.335343058,58,368,426
7311,-1.350869376,0.68018326,050-ABZ,-0.335343058,3,465,468
7312,-1.350869376,0.68018326,050-ASI,-0.335343058,15,181,196
7313,-1.350869376,0.68018326,050-ACB,-0.335343058,27,422,449
7314,-1.350869376,0.68018326,050-ACC,-0.335343058,29,272,301
7315,-1.350869376,0.68018326,050-ASJ,-0.335343058,21,582,603
7316,-1.350869376,0.68018326,050-ASK,-0.335343058,3,356,359
7317,-1.350869376,0.68018326,050-ACK,-0.335343058,19,286,305
7318,-1.350869376,0.68018326,050-ACL,-0.335343058,36,501,537
7319,-1.350869376,0.68018326,050-ACM,-0.335343058,14,244,258
7320,-1.350869376,0.68018326,050-ACN,-0.335343058,23,482,505
7321,-1.350869376,0.68018326,050-ACO,-0.335343058,22,561,583
7322,-1.350869376,0.68018326,050-ASG,-0.335343058,10,190,200
7323,-1.350869376,0.68018326,050-ACQ,-0.335343058,12,496,508
7324,-1.350869376,0.68018326,050-ACR,-0.335343058,2,298,300
7325,-1.350869376,0.68018326,050-ASH,-0.335343058,20,536,556
7326,-1.350869376,0.68018326,050-ACT,-0.335343058,18,300,318
7327,-1.350869376,0.68018326,050-ADD,-0.335343058,57,373,430
7328,-1.350869376,0.68018326,050-ARX,-0.335343058,27,213,240
7329,-1.350869376,0.68018326,050-ARY,-0.335343058,48,345,393
7330,-1.350869376,0.68018326,050-ARZ,-0.335343058,3,233,236
7331,-1.350869376,0.68018326,050-ASA,-0.335343058,8,339,347
7332,-1.350869376,0.68018326,050-ASB,-0.335343058,74,457,531
7333,-1.350869376,0.68018326,050-ASC,-0.335343058,54,285,339
7334,-1.350869376,0.68018326,050-ADK,-0.335343058,57,434,491
7335,-1.350869376,0.68018326,050-ASD,-0.335343058,12,332,344
7336,-1.350869376,0.68018326,050-ASE,-0.335343058,83,544,627
7337,-1.350869376,0.68018326,050-ADU,-0.335343058,121,259,380
7338,-1.350869376,0.68018326,050-ARL,-0.335343058,142,331,473
7339,-1.350869376,0.68018326,050-ADW,-0.335343058,94,374,468
7340,-1.350869376,0.68018326,050-ARM,-0.335343058,78,243,321
7341,-1.350869376,0.68018326,050-ARN,-0.335343058,121,334,455
7342,-1.350869376,0.68018326,050-ARO,-0.335343058,102,208,310
7343,-1.350869376,0.68018326,050-ARP,-0.335343058,86,279,365
7344,-1.350869376,0.68018326,050-ARQ,-0.335343058,157,355,512
7345,-1.350869376,0.68018326,050-ARR,-0.335343058,105,314,419
7346,-1.350869376,0.68018326,050-ARS,-0.335343058,72,268,340
7347,-1.350869376,0.68018326,050-ART,-0.335343058,69,297,366
7348,-1.350869376,0.68018326,050-ARU,-0.335343058,118,277,395
7349,-1.350869376,0.68018326,050-ARV,-0.335343058,164,318,482
7350,-1.350869376,0.68018326,050-AQX,-0.335343058,133,298,431
7351,-1.350869376,0.68018326,050-AQY,-0.335343058,266,413,679
7352,-1.350869376,0.68018326,050-AQZ,-0.335343058,155,289,444
7353,-1.350869376,0.68018326,050-ARA,-0.335343058,115,220,335
7354,-1.350869376,0.68018326,050-ARB,-0.335343058,155,315,470
7355,-1.350869376,0.68018326,050-AEX,-0.335343058,23,368,391
7356,-1.350869376,0.68018326,050-ARC,-0.335343058,15,289,304
7357,-1.350869376,0.68018326,050-ARD,-0.335343058,19,300,319
7358,-1.350869376,0.68018326,050-ARE,-0.335343058,30,435,465
7359,-1.350869376,0.68018326,050-ARF,-0.335343058,14,299,313
7360,-1.350869376,0.68018326,050-ARG,-0.335343058,124,297,421
7361,-1.350869376,0.68018326,050-ARH,-0.335343058,182,253,435
7362,-1.350869376,0.68018326,050-ARI,-0.335343058,8,371,379
7363,-1.350869376,0.68018326,050-ARJ,-0.335343058,22,294,316
7364,-1.350869376,0.68018326,050-AFP,-0.335343058,27,228,255
7365,-1.350869376,0.68018326,050-AQR,-0.335343058,29,242,271
7366,-1.350869376,0.68018326,050-AFR,-0.335343058,13,368,381
7367,-1.350869376,0.68018326,050-AFS,-0.335343058,27,343,370
7368,-1.350869376,0.68018326,050-AQS,-0.335343058,37,352,389
7369,-1.350869376,0.68018326,050-AQT,-0.335343058,21,224,245
7370,-1.350869376,0.68018326,050-AQU,-0.335343058,7,266,273
7371,-1.350869376,0.68018326,050-AFW,-0.335343058,84,257,341
7372,-1.350869376,0.68018326,050-AQV,-0.335343058,70,306,376
7373,-1.350869376,0.68018326,050-AQW,-0.335343058,11,324,335
7374,-1.350869376,0.68018326,050-AQH,-0.335343058,61,284,345
7375,-1.350869376,0.68018326,050-AQI,-0.335343058,55,393,448
7376,-1.350869376,0.68018326,050-AQJ,-0.335343058,52,313,365
7377,-1.350869376,0.68018326,050-AGJ,-0.335343058,124,297,421
7378,-1.350869376,0.68018326,050-AGK,-0.335343058,67,250,317
7379,-1.350869376,0.68018326,050-AQK,-0.335343058,41,207,248
7380,-1.350869376,0.68018326,050-AQL,-0.335343058,136,398,534
7381,-1.350869376,0.68018326,050-AGN,-0.335343058,94,252,346
7382,-1.350869376,0.68018326,050-AQM,-0.335343058,83,209,292
7383,-1.350869376,0.68018326,050-AGP,-0.335343058,54,358,412
7384,-1.350869376,0.68018326,050-AQN,-0.335343058,85,261,346
7385,-1.350869376,0.68018326,050-AQO,-0.335343058,143,233,376
7386,-1.350869376,0.68018326,050-AGS,-0.335343058,111,228,339
7387,-1.350869376,0.68018326,051-ABT,-0.335343058,196,120,316
7388,-1.350869376,0.68018326,051-ABU,-0.335343058,215,147,362
7389,-1.350869376,0.68018326,051-ABV,-0.335343058,185,112,297
7390,-1.350869376,0.68018326,051-ABW,-0.335343058,133,133,266
7391,-1.350869376,0.68018326,051-ABX,-0.335343058,179,132,311
7392,-1.350869376,0.68018326,051-ABY,-0.335343058,273,199,472
7393,-1.350869376,0.68018326,051-ABZ,-0.335343058,221,101,322
7394,-1.350869376,0.68018326,051-ACB,-0.335343058,164,106,270
7395,-1.350869376,0.68018326,051-ACC,-0.335343058,198,124,322
7396,-1.350869376,0.68018326,051-ACD,-0.335343058,162,101,263
7397,-1.350869376,0.68018326,051-ACA,-0.335343058,140,78,218
7398,-1.350869376,0.68018326,051-ACF,-0.335343058,300,175,475
7399,-1.350869376,0.68018326,051-ACE,-0.335343058,99,76,175
7400,-1.350869376,0.68018326,051-ACR,-0.335343058,184,121,305
7401,-1.350869376,0.68018326,051-AAA,-0.335343058,81,159,240
7402,-1.350869376,0.68018326,051-AAB,-0.335343058,84,163,247
7403,-1.350869376,0.68018326,051-AAC,-0.335343058,153,198,351
7404,-1.350869376,0.68018326,051-AAD,-0.335343058,172,265,437
7405,-1.350869376,0.68018326,051-AAE,-0.335343058,137,184,321
7406,-1.350869376,0.68018326,051-AAH,-0.335343058,72,227,299
7407,-1.350869376,0.68018326,051-AAI,-0.335343058,90,151,241
7408,-1.350869376,0.68018326,051-AAJ,-0.335343058,92,163,255
7409,-1.350869376,0.68018326,051-AAK,-0.335343058,118,153,271
7410,-1.350869376,0.68018326,051-AAN,-0.335343058,129,187,316
7411,-1.350869376,0.68018326,051-AAO,-0.335343058,81,183,264
7412,-1.350869376,0.68018326,051-AAP,-0.335343058,108,157,265
7413,-1.350869376,0.68018326,051-AAQ,-0.335343058,110,216,326
7414,-1.350869376,0.68018326,051-AAR,-0.335343058,151,160,311
7415,-1.350869376,0.68018326,051-AAS,-0.335343058,112,129,241
7416,-1.350869376,0.68018326,051-AAT,-0.335343058,189,191,380
7417,-1.350869376,0.68018326,051-AAU,-0.335343058,64,107,171
7418,-1.350869376,0.68018326,051-AAV,-0.335343058,84,128,212
7419,-1.350869376,0.68018326,051-AAW,-0.335343058,111,122,233
7420,-1.350869376,0.68018326,051-AAX,-0.335343058,109,128,237
7421,-1.350869376,0.68018326,051-AAY,-0.335343058,153,198,351
7422,-1.350869376,0.68018326,051-AAZ,-0.335343058,188,166,354
7423,-1.350869376,0.68018326,051-ABA,-0.335343058,161,169,330
7424,-1.350869376,0.68018326,051-ABB,-0.335343058,145,196,341
7425,-1.350869376,0.68018326,051-ABC,-0.335343058,124,176,300
7426,-1.350869376,0.68018326,051-ABD,-0.335343058,75,132,207
7427,-1.350869376,0.68018326,051-ABE,-0.335343058,89,91,180
7428,-1.350869376,0.68018326,051-ABF,-0.335343058,135,168,303
7429,-1.350869376,0.68018326,051-ABG,-0.335343058,183,183,366
7430,-1.350869376,0.68018326,051-ABH,-0.335343058,165,194,359
7431,-1.350869376,0.68018326,051-ABI,-0.335343058,159,129,288
7432,-1.350869376,0.68018326,051-ABJ,-0.335343058,351,238,589
7433,-1.350869376,0.68018326,051-ABK,-0.335343058,251,176,427
7434,-1.350869376,0.68018326,051-ABL,-0.335343058,208,163,371
7435,-1.350869376,0.68018326,051-ABM,-0.335343058,160,184,344
7436,-1.350869376,0.68018326,051-ABN,-0.335343058,224,212,436
7437,-1.350869376,0.68018326,051-ABO,-0.335343058,210,160,370
7438,-1.350869376,0.68018326,051-ABP,-0.335343058,240,185,425
7439,-1.350869376,0.68018326,051-ABQ,-0.335343058,287,238,525
7440,-1.350869376,0.68018326,051-ABR,-0.335343058,100,112,212
7441,-1.350869376,0.68018326,051-ACG,-0.335343058,261,205,466
7442,-1.350869376,0.68018326,051-ACH,-0.335343058,319,220,539
7443,-1.350869376,0.68018326,051-ACI,-0.335343058,213,126,339
7444,-1.350869376,0.68018326,051-ACJ,-0.335343058,205,103,308
7445,-1.350869376,0.68018326,051-ACK,-0.335343058,215,111,326
7446,-1.350869376,0.68018326,051-ACL,-0.335343058,141,99,240
7447,-1.350869376,0.68018326,051-ACM,-0.335343058,150,203,353
7448,-1.350869376,0.68018326,051-ACN,-0.335343058,171,175,346
7449,-1.350869376,0.68018326,051-ACO,-0.335343058,276,188,464
7450,-1.350869376,0.68018326,051-ACP,-0.335343058,176,116,292
7451,-1.350869376,0.68018326,051-ACQ,-0.335343058,123,102,225
7452,-1.350869376,0.68018326,051-ACS,-0.335343058,198,94,292
7453,-1.350869376,0.68018326,051-ACT,-0.335343058,225,173,398
7454,-1.350869376,0.68018326,051-ACU,-0.335343058,353,188,541
7455,-1.350869376,0.68018326,051-ACV,-0.335343058,340,246,586
7456,-1.350869376,0.68018326,051-ACW,-0.335343058,189,91,280
7457,-1.350869376,0.68018326,051-ACX,-0.335343058,284,169,453
7458,-1.350869376,0.68018326,051-ACY,-0.335343058,317,144,461
7459,-1.350869376,0.68018326,051-ACZ,-0.335343058,271,173,444
7460,-1.350869376,0.68018326,051-ADA,-0.335343058,363,181,544
7461,-1.350869376,0.68018326,051-ADC,-0.335343058,178,145,323
7462,-1.350869376,0.68018326,051-ADD,-0.335343058,126,106,232
7463,-1.350869376,0.68018326,051-ADE,-0.335343058,269,138,407
7464,-1.350869376,0.68018326,051-ADF,-0.335343058,276,92,368
7465,-1.350869376,0.68018326,051-ADG,-0.335343058,194,101,295
7466,-1.350869376,0.68018326,051-ADH,-0.335343058,227,132,359
7467,-1.350869376,0.68018326,051-ADI,-0.335343058,224,93,317
7468,-1.350869376,0.68018326,051-ADJ,-0.335343058,244,165,409
7469,-1.350869376,0.68018326,051-ADL,-0.335343058,332,150,482
7470,-1.350869376,0.68018326,051-ADK,-0.335343058,90,77,167
7471,-1.350869376,0.68018326,052-AAA,-0.335343058,284,310,594
7472,-1.350869376,0.68018326,052-AAB,-0.335343058,321,331,652
7473,-1.350869376,0.68018326,052-AAC,-0.335343058,229,263,492
7474,-1.350869376,0.68018326,052-AAD,-0.335343058,300,293,593
7475,-1.350869376,0.68018326,052-AAE,-0.335343058,309,341,650
7476,-1.350869376,0.68018326,052-AAF,-0.335343058,284,226,510
7477,-1.350869376,0.68018326,052-AAG,-0.335343058,442,368,810
7478,-1.350869376,0.68018326,052-AAI,-0.335343058,294,373,667
7479,-1.350869376,0.68018326,052-AAJ,-0.335343058,229,213,442
7480,-1.350869376,0.68018326,052-AAK,-0.335343058,232,321,553
7481,-1.350869376,0.68018326,052-AAL,-0.335343058,261,303,564
7482,-1.350869376,0.68018326,052-AAM,-0.335343058,216,274,490
7483,-1.350869376,0.68018326,052-AAN,-0.335343058,212,253,465
7484,-1.350869376,0.68018326,052-AAO,-0.335343058,266,291,557
7485,-1.350869376,0.68018326,052-AFU,-0.335343058,84,137,221
7486,-1.350869376,0.68018326,052-AAP,-0.335343058,244,317,561
7487,-1.350869376,0.68018326,052-AAQ,-0.335343058,203,233,436
7488,-1.350869376,0.68018326,052-AAR,-0.335343058,423,337,760
7489,-1.350869376,0.68018326,052-AAS,-0.335343058,250,320,570
7490,-1.350869376,0.68018326,052-AAT,-0.335343058,165,225,390
7491,-1.350869376,0.68018326,052-AAU,-0.335343058,237,243,480
7492,-1.350869376,0.68018326,052-AAV,-0.335343058,157,146,303
7493,-1.350869376,0.68018326,052-AFV,-0.335343058,290,292,582
7494,-1.350869376,0.68018326,052-AAW,-0.335343058,291,401,692
7495,-1.350869376,0.68018326,052-AAX,-0.335343058,378,398,776
7496,-1.350869376,0.68018326,052-AAY,-0.335343058,138,207,345
7497,-1.350869376,0.68018326,052-AAZ,-0.335343058,138,197,335
7498,-1.350869376,0.68018326,052-ABA,-0.335343058,298,291,589
7499,-1.350869376,0.68018326,052-ABB,-0.335343058,239,229,468
7500,-1.350869376,0.68018326,052-ABC,-0.335343058,333,371,704
7501,-1.350869376,0.68018326,052-ABD,-0.335343058,157,173,330
7502,-1.350869376,0.68018326,052-ACY,-0.335343058,435,412,847
7503,-1.350869376,0.68018326,052-ACZ,-0.335343058,452,398,850
7504,-1.350869376,0.68018326,052-ADA,-0.335343058,418,447,865
7505,-1.350869376,0.68018326,052-ADB,-0.335343058,353,364,717
7506,-1.350869376,0.68018326,052-ADC,-0.335343058,454,309,763
7507,-1.350869376,0.68018326,052-AGA,-0.335343058,403,365,768
7508,-1.350869376,0.68018326,052-ADD,-0.335343058,368,293,661
7509,-1.350869376,0.68018326,052-ADE,-0.335343058,366,233,599
7510,-1.350869376,0.68018326,052-AEI,-0.335343058,286,243,529
7511,-1.350869376,0.68018326,052-AFN,-0.335343058,100,108,208
7512,-1.350869376,0.68018326,052-ADF,-0.335343058,392,248,640
7513,-1.350869376,0.68018326,052-ADG,-0.335343058,401,284,685
7514,-1.350869376,0.68018326,052-ADH,-0.335343058,469,281,750
7515,-1.350869376,0.68018326,052-ADI,-0.335343058,373,196,569
7516,-1.350869376,0.68018326,052-ADJ,-0.335343058,279,197,476
7517,-1.350869376,0.68018326,052-ADK,-0.335343058,245,197,442
7518,-1.350869376,0.68018326,052-ADL,-0.335343058,296,225,521
7519,-1.350869376,0.68018326,052-ADM,-0.335343058,225,132,357
7520,-1.350869376,0.68018326,052-ADP,-0.335343058,267,186,453
7521,-1.350869376,0.68018326,052-ADQ,-0.335343058,326,219,545
7522,-1.350869376,0.68018326,052-ADU,-0.335343058,276,190,466
7523,-1.350869376,0.68018326,052-ADV,-0.335343058,371,213,584
7524,-1.350869376,0.68018326,052-ADW,-0.335343058,455,298,753
7525,-1.350869376,0.68018326,052-ADX,-0.335343058,358,186,544
7526,-1.350869376,0.68018326,052-ADY,-0.335343058,454,231,685
7527,-1.350869376,0.68018326,052-ADZ,-0.335343058,361,180,541
7528,-1.350869376,0.68018326,052-AEA,-0.335343058,220,143,363
7529,-1.350869376,0.68018326,052-AEB,-0.335343058,279,190,469
7530,-1.350869376,0.68018326,052-AEC,-0.335343058,287,259,546
7531,-1.350869376,0.68018326,052-AED,-0.335343058,166,180,346
7532,-1.350869376,0.68018326,052-AEE,-0.335343058,242,210,452
7533,-1.350869376,0.68018326,052-AEF,-0.335343058,308,285,593
7534,-1.350869376,0.68018326,052-AEG,-0.335343058,428,308,736
7535,-1.350869376,0.68018326,052-AEH,-0.335343058,344,278,622
7536,-1.350869376,0.68018326,052-AEJ,-0.335343058,326,291,617
7537,-1.350869376,0.68018326,052-AEK,-0.335343058,245,225,470
7538,-1.350869376,0.68018326,052-AEL,-0.335343058,417,301,718
7539,-1.350869376,0.68018326,052-AEM,-0.335343058,436,359,795
7540,-1.350869376,0.68018326,052-AEN,-0.335343058,498,382,880
7541,-1.350869376,0.68018326,052-AEO,-0.335343058,351,272,623
7542,-1.350869376,0.68018326,052-AEP,-0.335343058,354,271,625
7543,-1.350869376,0.68018326,052-ADR,-0.335343058,149,193,342
7544,-1.350869376,0.68018326,052-ADS,-0.335343058,192,163,355
7545,-1.350869376,0.68018326,052-ADT,-0.335343058,251,253,504
7546,-1.350869376,0.68018326,052-ABE,-0.335343058,175,268,443
7547,-1.350869376,0.68018326,052-ABF,-0.335343058,187,394,581
7548,-1.350869376,0.68018326,052-ABG,-0.335343058,360,424,784
7549,-1.350869376,0.68018326,052-ABH,-0.335343058,243,248,491
7550,-1.350869376,0.68018326,052-AFX,-0.335343058,211,152,363
7551,-1.350869376,0.68018326,052-ABI,-0.335343058,259,235,494
7552,-1.350869376,0.68018326,052-ABJ,-0.335343058,148,247,395
7553,-1.350869376,0.68018326,052-ABK,-0.335343058,344,227,571
7554,-1.350869376,0.68018326,052-ABL,-0.335343058,358,298,656
7555,-1.350869376,0.68018326,052-ABM,-0.335343058,403,307,710
7556,-1.350869376,0.68018326,052-ABN,-0.335343058,138,169,307
7557,-1.350869376,0.68018326,052-ABP,-0.335343058,265,294,559
7558,-1.350869376,0.68018326,052-ABQ,-0.335343058,200,227,427
7559,-1.350869376,0.68018326,052-ABR,-0.335343058,173,203,376
7560,-1.350869376,0.68018326,052-ABS,-0.335343058,244,228,472
7561,-1.350869376,0.68018326,052-ABT,-0.335343058,281,270,551
7562,-1.350869376,0.68018326,052-ABU,-0.335343058,562,416,978
7563,-1.350869376,0.68018326,052-ABW,-0.335343058,169,280,449
7564,-1.350869376,0.68018326,052-ABX,-0.335343058,286,236,522
7565,-1.350869376,0.68018326,052-ABY,-0.335343058,263,250,513
7566,-1.350869376,0.68018326,052-ABZ,-0.335343058,383,330,713
7567,-1.350869376,0.68018326,052-ACA,-0.335343058,407,336,743
7568,-1.350869376,0.68018326,052-ACB,-0.335343058,461,330,791
7569,-1.350869376,0.68018326,052-AEQ,-0.335343058,458,252,710
7570,-1.350869376,0.68018326,052-AER,-0.335343058,349,228,577
7571,-1.350869376,0.68018326,052-AES,-0.335343058,445,437,882
7572,-1.350869376,0.68018326,052-AET,-0.335343058,379,253,632
7573,-1.350869376,0.68018326,052-AEU,-0.335343058,423,310,733
7574,-1.350869376,0.68018326,052-AEV,-0.335343058,232,177,409
7575,-1.350869376,0.68018326,052-AEW,-0.335343058,323,255,578
7576,-1.350869376,0.68018326,052-AEX,-0.335343058,423,417,840
7577,-1.350869376,0.68018326,052-AEY,-0.335343058,363,263,626
7578,-1.350869376,0.68018326,052-AEZ,-0.335343058,904,421,1325
7579,-1.350869376,0.68018326,052-AFA,-0.335343058,713,399,1112
7580,-1.350869376,0.68018326,052-AFB,-0.335343058,386,341,727
7581,-1.350869376,0.68018326,052-AFC,-0.335343058,440,295,735
7582,-1.350869376,0.68018326,052-AFY,-0.335343058,390,242,632
7583,-1.350869376,0.68018326,052-AFZ,-0.335343058,438,274,712
7584,-1.350869376,0.68018326,052-ADN,-0.335343058,292,259,551
7585,-1.350869376,0.68018326,052-ADO,-0.335343058,333,281,614
7586,-1.350869376,0.68018326,052-AFD,-0.335343058,513,381,894
7587,-1.350869376,0.68018326,052-AFE,-0.335343058,456,268,724
7588,-1.350869376,0.68018326,052-AFF,-0.335343058,457,301,758
7589,-1.350869376,0.68018326,052-AFG,-0.335343058,324,231,555
7590,-1.350869376,0.68018326,052-AFH,-0.335343058,456,391,847
7591,-1.350869376,0.68018326,052-AFI,-0.335343058,149,171,320
7592,-1.350869376,0.68018326,052-ACD,-0.335343058,341,344,685
7593,-1.350869376,0.68018326,052-ACE,-0.335343058,255,275,530
7594,-1.350869376,0.68018326,052-ACF,-0.335343058,369,333,702
7595,-1.350869376,0.68018326,052-ACG,-0.335343058,221,173,394
7596,-1.350869376,0.68018326,052-AFW,-0.335343058,418,282,700
7597,-1.350869376,0.68018326,052-ACJ,-0.335343058,237,194,431
7598,-1.350869376,0.68018326,052-ACK,-0.335343058,318,252,570
7599,-1.350869376,0.68018326,052-ACL,-0.335343058,150,146,296
7600,-1.350869376,0.68018326,052-ACM,-0.335343058,450,306,756
7601,-1.350869376,0.68018326,052-ACN,-0.335343058,319,235,554
7602,-1.350869376,0.68018326,052-ACO,-0.335343058,241,154,395
7603,-1.350869376,0.68018326,052-ACP,-0.335343058,391,361,752
7604,-1.350869376,0.68018326,052-ACQ,-0.335343058,160,199,359
7605,-1.350869376,0.68018326,052-ACR,-0.335343058,181,277,458
7606,-1.350869376,0.68018326,052-ACS,-0.335343058,523,448,971
7607,-1.350869376,0.68018326,052-ACT,-0.335343058,142,170,312
7608,-1.350869376,0.68018326,052-ACU,-0.335343058,378,313,691
7609,-1.350869376,0.68018326,052-ACV,-0.335343058,285,174,459
7610,-1.350869376,0.68018326,052-ACW,-0.335343058,168,199,367
7611,-1.350869376,0.68018326,052-ACX,-0.335343058,242,247,489
7612,-1.350869376,0.68018326,052-AFJ,-0.335343058,415,314,729
7613,-1.350869376,0.68018326,052-AFK,-0.335343058,332,228,560
7614,-1.350869376,0.68018326,052-AFL,-0.335343058,274,229,503
7615,-1.350869376,0.68018326,052-AFM,-0.335343058,371,212,583
7616,-1.350869376,0.68018326,052-AFQ,-0.335343058,491,261,752
7617,-1.350869376,0.68018326,052-AFO,-0.335343058,332,289,621
7618,-1.350869376,0.68018326,052-AFP,-0.335343058,439,366,805
7619,-1.350869376,0.68018326,052-AFR,-0.335343058,301,260,561
7620,-1.350869376,0.68018326,052-AFS,-0.335343058,248,189,437
7621,-1.350869376,0.68018326,052-AFT,-0.335343058,451,403,854
7622,-1.350869376,0.68018326,053-AAA,-0.335343058,330,261,591
7623,-1.350869376,0.68018326,053-AAO,-0.335343058,161,121,282
7624,-1.350869376,0.68018326,053-AAE,-0.335343058,296,274,570
7625,-1.350869376,0.68018326,053-AAC,-0.335343058,428,185,613
7626,-1.350869376,0.68018326,053-AAK,-0.335343058,200,155,355
7627,-1.350869376,0.68018326,053-AAP,-0.335343058,196,113,309
7628,-1.350869376,0.68018326,053-AAF,-0.335343058,225,157,382
7629,-1.350869376,0.68018326,053-AAG,-0.335343058,199,123,322
7630,-1.350869376,0.68018326,053-AAS,-0.335343058,142,136,278
7631,-1.350869376,0.68018326,053-AAT,-0.335343058,175,178,353
7632,-1.350869376,0.68018326,053-AAR,-0.335343058,170,142,312
7633,-1.350869376,0.68018326,053-AAY,-0.335343058,207,153,360
7634,-1.350869376,0.68018326,053-AAH,-0.335343058,265,137,402
7635,-1.350869376,0.68018326,053-AAJ,-0.335343058,331,158,489
7636,-1.350869376,0.68018326,053-AAU,-0.335343058,85,98,183
7637,-1.350869376,0.68018326,053-AAV,-0.335343058,160,134,294
7638,-1.350869376,0.68018326,053-AAW,-0.335343058,66,74,140
7639,-1.350869376,0.68018326,053-AAZ,-0.335343058,279,139,418
7640,-1.350869376,0.68018326,053-ABA,-0.335343058,226,91,317
7641,-1.350869376,0.68018326,053-AAQ,-0.335343058,161,85,246
7642,-1.350869376,0.68018326,053-AAL,-0.335343058,124,84,208
7643,-1.350869376,0.68018326,053-AAN,-0.335343058,225,175,400
7644,-1.350869376,0.68018326,053-AAX,-0.335343058,243,269,512
7645,-1.350869376,0.68018326,053-AAI,-0.335343058,219,146,365
7646,-1.350869376,0.68018326,053-ABB,-0.335343058,225,163,388
7647,-1.350869376,0.68018326,053-AAD,-0.335343058,435,179,614
7648,-1.350869376,0.68018326,053-AAM,-0.335343058,242,164,406
7649,-1.350869376,0.68018326,054-AAK,-0.335343058,209,83,292
7650,-1.350869376,0.68018326,054-AAL,-0.335343058,401,109,510
7651,-1.350869376,0.68018326,054-AAM,-0.335343058,500,111,611
7652,-1.350869376,0.68018326,054-AAA,-0.335343058,282,139,421
7653,-1.350869376,0.68018326,054-AAB,-0.335343058,375,189,564
7654,-1.350869376,0.68018326,054-AAC,-0.335343058,427,251,678
7655,-1.350869376,0.68018326,054-AAD,-0.335343058,175,124,299
7656,-1.350869376,0.68018326,054-AAE,-0.335343058,248,176,424
7657,-1.350869376,0.68018326,054-AAF,-0.335343058,161,106,267
7658,-1.350869376,0.68018326,054-AAG,-0.335343058,187,189,376
7659,-1.350869376,0.68018326,054-AAH,-0.335343058,232,210,442
7660,-1.350869376,0.68018326,054-AAI,-0.335343058,274,243,517
7661,-1.350869376,0.68018326,054-AAJ,-0.335343058,442,263,705
7662,-1.350869376,0.68018326,054-AAS,-0.335343058,430,159,589
7663,-1.350869376,0.68018326,054-AAN,-0.335343058,448,172,620
7664,-1.350869376,0.68018326,054-AAO,-0.335343058,320,140,460
7665,-1.350869376,0.68018326,054-AAQ,-0.335343058,335,142,477
7666,-1.350869376,0.68018326,054-ABT,-0.335343058,565,178,743
7667,-1.350869376,0.68018326,054-AAT,-0.335343058,451,162,613
7668,-1.350869376,0.68018326,054-ABF,-0.335343058,310,130,440
7669,-1.350869376,0.68018326,054-ABG,-0.335343058,258,170,428
7670,-1.350869376,0.68018326,054-AAW,-0.335343058,573,245,818
7671,-1.350869376,0.68018326,054-AAX,-0.335343058,360,146,506
7672,-1.350869376,0.68018326,054-ABN,-0.335343058,502,180,682
7673,-1.350869376,0.68018326,054-AAY,-0.335343058,460,67,527
7674,-1.350869376,0.68018326,054-AAZ,-0.335343058,365,55,420
7675,-1.350869376,0.68018326,054-ABU,-0.335343058,403,71,474
7676,-1.350869376,0.68018326,054-ABE,-0.335343058,400,155,555
7677,-1.350869376,0.68018326,054-ABI,-0.335343058,317,128,445
7678,-1.350869376,0.68018326,054-ABL,-0.335343058,645,161,806
7679,-1.350869376,0.68018326,054-ABM,-0.335343058,785,121,906
7680,-1.350869376,0.68018326,054-ABQ,-0.335343058,462,219,681
7681,-1.350869376,0.68018326,054-ABO,-0.335343058,567,96,663
7682,-1.350869376,0.68018326,054-AAU,-0.335343058,307,209,516
7683,-1.350869376,0.68018326,054-ABC,-0.335343058,604,171,775
7684,-1.350869376,0.68018326,054-ABD,-0.335343058,408,98,506
7685,-1.350869376,0.68018326,054-ABS,-0.335343058,466,98,564
7686,-1.350869376,0.68018326,054-ABH,-0.335343058,446,187,633
7687,-1.350869376,0.68018326,055-ABP,-0.335343058,564,223,787
7688,-1.350869376,0.68018326,055-ABQ,-0.335343058,803,379,1182
7689,-1.350869376,0.68018326,055-ABR,-0.335343058,511,247,758
7690,-1.350869376,0.68018326,055-ABS,-0.335343058,377,143,520
7691,-1.350869376,0.68018326,055-ACJ,-0.335343058,245,200,445
7692,-1.350869376,0.68018326,055-ABT,-0.335343058,560,200,760
7693,-1.350869376,0.68018326,055-ABU,-0.335343058,334,146,480
7694,-1.350869376,0.68018326,055-ABV,-0.335343058,200,96,296
7695,-1.350869376,0.68018326,055-ABY,-0.335343058,373,131,504
7696,-1.350869376,0.68018326,055-ABW,-0.335343058,341,149,490
7697,-1.350869376,0.68018326,055-ABX,-0.335343058,685,274,959
7698,-1.350869376,0.68018326,055-ABZ,-0.335343058,401,140,541
7699,-1.350869376,0.68018326,055-ACK,-0.335343058,319,184,503
7700,-1.350869376,0.68018326,055-ACL,-0.335343058,424,260,684
7701,-1.350869376,0.68018326,055-ACA,-0.335343058,676,272,948
7702,-1.350869376,0.68018326,055-ACT,-0.335343058,447,193,640
7703,-1.350869376,0.68018326,055-ACB,-0.335343058,673,284,957
7704,-1.350869376,0.68018326,055-ACU,-0.335343058,377,174,551
7705,-1.350869376,0.68018326,055-ACC,-0.335343058,497,231,728
7706,-1.350869376,0.68018326,055-ACE,-0.335343058,446,225,671
7707,-1.350869376,0.68018326,055-ACD,-0.335343058,394,152,546
7708,-1.350869376,0.68018326,055-ACF,-0.335343058,667,242,909
7709,-1.350869376,0.68018326,055-ACG,-0.335343058,609,224,833
7710,-1.350869376,0.68018326,055-ACH,-0.335343058,527,226,753
7711,-1.350869376,0.68018326,055-ACI,-0.335343058,465,160,625
7712,-1.350869376,0.68018326,055-ACM,-0.335343058,500,201,701
7713,-1.350869376,0.68018326,055-ACN,-0.335343058,420,140,560
7714,-1.350869376,0.68018326,055-AAA,-0.335343058,153,213,366
7715,-1.350869376,0.68018326,055-AAB,-0.335343058,231,308,539
7716,-1.350869376,0.68018326,055-AAC,-0.335343058,203,194,397
7717,-1.350869376,0.68018326,055-AAD,-0.335343058,277,269,546
7718,-1.350869376,0.68018326,055-AAE,-0.335343058,232,267,499
7719,-1.350869376,0.68018326,055-AAF,-0.335343058,328,296,624
7720,-1.350869376,0.68018326,055-AAG,-0.335343058,406,336,742
7721,-1.350869376,0.68018326,055-AAH,-0.335343058,268,196,464
7722,-1.350869376,0.68018326,055-AAI,-0.335343058,239,230,469
7723,-1.350869376,0.68018326,055-AAJ,-0.335343058,298,255,553
7724,-1.350869376,0.68018326,055-AAK,-0.335343058,252,184,436
7725,-1.350869376,0.68018326,055-AAL,-0.335343058,222,206,428
7726,-1.350869376,0.68018326,055-AAM,-0.335343058,230,223,453
7727,-1.350869376,0.68018326,055-AAN,-0.335343058,618,291,909
7728,-1.350869376,0.68018326,055-AAO,-0.335343058,356,232,588
7729,-1.350869376,0.68018326,055-AAP,-0.335343058,499,250,749
7730,-1.350869376,0.68018326,055-ACO,-0.335343058,496,184,680
7731,-1.350869376,0.68018326,055-ACV,-0.335343058,397,132,529
7732,-1.350869376,0.68018326,055-ACP,-0.335343058,766,384,1150
7733,-1.350869376,0.68018326,055-ACQ,-0.335343058,477,206,683
7734,-1.350869376,0.68018326,055-ACR,-0.335343058,351,174,525
7735,-1.350869376,0.68018326,055-AAQ,-0.335343058,364,231,595
7736,-1.350869376,0.68018326,055-AAR,-0.335343058,339,261,600
7737,-1.350869376,0.68018326,055-AAS,-0.335343058,818,282,1100
7738,-1.350869376,0.68018326,055-AAT,-0.335343058,472,247,719
7739,-1.350869376,0.68018326,055-AAU,-0.335343058,536,274,810
7740,-1.350869376,0.68018326,055-AAV,-0.335343058,436,217,653
7741,-1.350869376,0.68018326,055-AAW,-0.335343058,674,224,898
7742,-1.350869376,0.68018326,055-AAX,-0.335343058,230,202,432
7743,-1.350869376,0.68018326,055-AAY,-0.335343058,210,192,402
7744,-1.350869376,0.68018326,055-AAZ,-0.335343058,290,159,449
7745,-1.350869376,0.68018326,055-ABA,-0.335343058,401,247,648
7746,-1.350869376,0.68018326,055-ABB,-0.335343058,353,287,640
7747,-1.350869376,0.68018326,055-ABC,-0.335343058,424,248,672
7748,-1.350869376,0.68018326,055-ABD,-0.335343058,256,280,536
7749,-1.350869376,0.68018326,055-ABE,-0.335343058,300,198,498
7750,-1.350869376,0.68018326,055-ABF,-0.335343058,374,214,588
7751,-1.350869376,0.68018326,055-ADB,-0.335343058,408,222,630
7752,-1.350869376,0.68018326,055-ABG,-0.335343058,162,207,369
7753,-1.350869376,0.68018326,055-ABH,-0.335343058,310,302,612
7754,-1.350869376,0.68018326,055-ABI,-0.335343058,251,253,504
7755,-1.350869376,0.68018326,055-ABJ,-0.335343058,305,213,518
7756,-1.350869376,0.68018326,055-ADC,-0.335343058,714,329,1043
7757,-1.350869376,0.68018326,055-ABL,-0.335343058,249,197,446
7758,-1.350869376,0.68018326,055-ABM,-0.335343058,243,224,467
7759,-1.350869376,0.68018326,055-ABN,-0.335343058,535,388,923
7760,-1.350869376,0.68018326,055-ABO,-0.335343058,219,200,419
7761,-1.350869376,0.68018326,055-ADD,-0.335343058,470,186,656
7762,-1.350869376,0.68018326,055-ACS,-0.335343058,644,282,926
7763,-1.350869376,0.68018326,055-ACW,-0.335343058,424,163,587
7764,-1.350869376,0.68018326,055-ADA,-0.335343058,634,336,970
7765,-1.350869376,0.68018326,055-ACX,-0.335343058,445,252,697
7766,-1.350869376,0.68018326,055-ACY,-0.335343058,611,288,899
7767,-1.350869376,0.68018326,055-ACZ,-0.335343058,467,219,686
7768,-1.350869376,0.68018326,056-AAA,-0.335343058,118,188,306
7769,-1.350869376,0.68018326,056-AAY,-0.335343058,50,75,125
7770,-1.350869376,0.68018326,056-AAB,-0.335343058,73,92,165
7771,-1.350869376,0.68018326,056-AAC,-0.335343058,85,52,137
7772,-1.350869376,0.68018326,056-AAD,-0.335343058,132,146,278
7773,-1.350869376,0.68018326,056-AAE,-0.335343058,117,186,303
7774,-1.350869376,0.68018326,056-AAU,-0.335343058,48,90,138
7775,-1.350869376,0.68018326,056-AAK,-0.335343058,117,95,212
7776,-1.350869376,0.68018326,056-AAL,-0.335343058,104,113,217
7777,-1.350869376,0.68018326,056-AAM,-0.335343058,110,114,224
7778,-1.350869376,0.68018326,056-AAN,-0.335343058,107,182,289
7779,-1.350869376,0.68018326,056-AAO,-0.335343058,124,112,236
7780,-1.350869376,0.68018326,056-AAP,-0.335343058,85,125,210
7781,-1.350869376,0.68018326,056-AAQ,-0.335343058,137,126,263
7782,-1.350869376,0.68018326,056-AAR,-0.335343058,119,143,262
7783,-1.350869376,0.68018326,056-AAS,-0.335343058,103,113,216
7784,-1.350869376,0.68018326,056-AAT,-0.335343058,95,130,225
7785,-1.350869376,0.68018326,056-AAV,-0.335343058,135,156,291
7786,-1.350869376,0.68018326,056-AAW,-0.335343058,62,70,132
7787,-1.350869376,0.68018326,056-AAH,-0.335343058,88,135,223
7788,-1.350869376,0.68018326,056-AAI,-0.335343058,141,172,313
7789,-1.350869376,0.68018326,056-AAJ,-0.335343058,111,138,249
7790,-1.350869376,0.68018326,056-AAX,-0.335343058,132,202,334
7791,-1.350869376,0.68018326,056-AAZ,-0.335343058,235,223,458
7792,-1.350869376,0.68018326,056-ABA,-0.335343058,103,122,225
7793,-1.350869376,0.68018326,056-ABB,-0.335343058,103,127,230
7794,-1.350869376,0.68018326,056-ABC,-0.335343058,79,101,180
7795,-1.350869376,0.68018326,056-AAG,-0.335343058,153,177,330
7796,-1.350869376,0.68018326,057-ATJ,-0.335343058,475,530,1005
7797,-1.350869376,0.68018326,057-ATK,-0.335343058,272,325,597
7798,-1.350869376,0.68018326,057-ATL,-0.335343058,603,308,911
7799,-1.350869376,0.68018326,057-ATM,-0.335343058,470,117,587
7800,-1.350869376,0.68018326,057-ATN,-0.335343058,338,185,523
7801,-1.350869376,0.68018326,057-ASU,-0.335343058,376,266,642
7802,-1.350869376,0.68018326,057-ASV,-0.335343058,347,251,598
7803,-1.350869376,0.68018326,057-ASW,-0.335343058,329,266,595
7804,-1.350869376,0.68018326,057-ASX,-0.335343058,606,396,1002
7805,-1.350869376,0.68018326,057-ASZ,-0.335343058,437,239,676
7806,-1.350869376,0.68018326,057-ATA,-0.335343058,353,231,584
7807,-1.350869376,0.68018326,057-ATB,-0.335343058,446,162,608
7808,-1.350869376,0.68018326,057-ATC,-0.335343058,356,221,577
7809,-1.350869376,0.68018326,057-ATD,-0.335343058,306,308,614
7810,-1.350869376,0.68018326,057-AAA,-0.335343058,221,342,563
7811,-1.350869376,0.68018326,057-AAB,-0.335343058,204,215,419
7812,-1.350869376,0.68018326,057-AAC,-0.335343058,418,188,606
7813,-1.350869376,0.68018326,057-AAD,-0.335343058,594,321,915
7814,-1.350869376,0.68018326,057-AAE,-0.335343058,370,419,789
7815,-1.350869376,0.68018326,057-AAF,-0.335343058,272,131,403
7816,-1.350869376,0.68018326,057-AAG,-0.335343058,497,163,660
7817,-1.350869376,0.68018326,057-AAH,-0.335343058,426,141,567
7818,-1.350869376,0.68018326,057-AAI,-0.335343058,309,169,478
7819,-1.350869376,0.68018326,057-AAK,-0.335343058,154,156,310
7820,-1.350869376,0.68018326,057-AAL,-0.335343058,517,286,803
7821,-1.350869376,0.68018326,057-AAM,-0.335343058,340,161,501
7822,-1.350869376,0.68018326,057-AAO,-0.335343058,432,38,470
7823,-1.350869376,0.68018326,057-AAP,-0.335343058,328,462,790
7824,-1.350869376,0.68018326,057-AAQ,-0.335343058,191,166,357
7825,-1.350869376,0.68018326,057-AAR,-0.335343058,306,518,824
7826,-1.350869376,0.68018326,057-AAS,-0.335343058,528,383,911
7827,-1.350869376,0.68018326,057-AAT,-0.335343058,236,263,499
7828,-1.350869376,0.68018326,057-AAU,-0.335343058,397,424,821
7829,-1.350869376,0.68018326,057-AAV,-0.335343058,413,294,707
7830,-1.350869376,0.68018326,057-AAX,-0.335343058,321,185,506
7831,-1.350869376,0.68018326,057-AAY,-0.335343058,254,246,500
7832,-1.350869376,0.68018326,057-AAZ,-0.335343058,368,292,660
7833,-1.350869376,0.68018326,057-ABA,-0.335343058,375,309,684
7834,-1.350869376,0.68018326,057-ABB,-0.335343058,816,446,1262
7835,-1.350869376,0.68018326,057-ATF,-0.335343058,393,273,666
7836,-1.350869376,0.68018326,057-ATG,-0.335343058,474,461,935
7837,-1.350869376,0.68018326,057-ATH,-0.335343058,314,473,787
7838,-1.350869376,0.68018326,057-ATI,-0.335343058,345,561,906
7839,-1.350869376,0.68018326,057-AWT,-0.335343058,429,290,719
7840,-1.350869376,0.68018326,057-AWU,-0.335343058,346,393,739
7841,-1.350869376,0.68018326,057-AWV,-0.335343058,476,396,872
7842,-1.350869376,0.68018326,057-AWW,-0.335343058,189,486,675
7843,-1.350869376,0.68018326,057-AWX,-0.335343058,203,336,539
7844,-1.350869376,0.68018326,057-AWY,-0.335343058,208,506,714
7845,-1.350869376,0.68018326,057-AWZ,-0.335343058,279,621,900
7846,-1.350869376,0.68018326,057-AXA,-0.335343058,241,398,639
7847,-1.350869376,0.68018326,057-AXB,-0.335343058,268,357,625
7848,-1.350869376,0.68018326,057-AXC,-0.335343058,189,301,490
7849,-1.350869376,0.68018326,057-AXD,-0.335343058,185,234,419
7850,-1.350869376,0.68018326,057-AXE,-0.335343058,317,231,548
7851,-1.350869376,0.68018326,057-AXF,-0.335343058,225,177,402
7852,-1.350869376,0.68018326,057-AXH,-0.335343058,192,269,461
7853,-1.350869376,0.68018326,057-AYY,-0.335343058,220,179,399
7854,-1.350869376,0.68018326,057-ABC,-0.335343058,406,186,592
7855,-1.350869376,0.68018326,057-ABD,-0.335343058,106,227,333
7856,-1.350869376,0.68018326,057-ABE,-0.335343058,53,318,371
7857,-1.350869376,0.68018326,057-ABF,-0.335343058,60,183,243
7858,-1.350869376,0.68018326,057-ABG,-0.335343058,87,174,261
7859,-1.350869376,0.68018326,057-ABH,-0.335343058,101,293,394
7860,-1.350869376,0.68018326,057-ABI,-0.335343058,102,217,319
7861,-1.350869376,0.68018326,057-ABK,-0.335343058,76,231,307
7862,-1.350869376,0.68018326,057-ABL,-0.335343058,119,268,387
7863,-1.350869376,0.68018326,057-AEH,-0.335343058,288,259,547
7864,-1.350869376,0.68018326,057-AEJ,-0.335343058,211,347,558
7865,-1.350869376,0.68018326,057-AEK,-0.335343058,352,286,638
7866,-1.350869376,0.68018326,057-AEM,-0.335343058,293,307,600
7867,-1.350869376,0.68018326,057-AEN,-0.335343058,293,236,529
7868,-1.350869376,0.68018326,057-AEQ,-0.335343058,133,290,423
7869,-1.350869376,0.68018326,057-AER,-0.335343058,217,249,466
7870,-1.350869376,0.68018326,057-AET,-0.335343058,181,315,496
7871,-1.350869376,0.68018326,057-AEU,-0.335343058,258,180,438
7872,-1.350869376,0.68018326,057-AEV,-0.335343058,228,309,537
7873,-1.350869376,0.68018326,057-AEW,-0.335343058,125,228,353
7874,-1.350869376,0.68018326,057-AEY,-0.335343058,135,156,291
7875,-1.350869376,0.68018326,057-AEZ,-0.335343058,100,249,349
7876,-1.350869376,0.68018326,057-AFA,-0.335343058,146,114,260
7877,-1.350869376,0.68018326,057-AFC,-0.335343058,285,310,595
7878,-1.350869376,0.68018326,057-AFE,-0.335343058,146,277,423
7879,-1.350869376,0.68018326,057-AFF,-0.335343058,199,251,450
7880,-1.350869376,0.68018326,057-AFG,-0.335343058,171,229,400
7881,-1.350869376,0.68018326,057-AFH,-0.335343058,6,267,273
7882,-1.350869376,0.68018326,057-AFI,-0.335343058,1,260,261
7883,-1.350869376,0.68018326,057-AFJ,-0.335343058,9,205,214
7884,-1.350869376,0.68018326,057-AFM,-0.335343058,6,498,504
7885,-1.350869376,0.68018326,057-AFO,-0.335343058,22,387,409
7886,-1.350869376,0.68018326,057-AFP,-0.335343058,5,61,66
7887,-1.350869376,0.68018326,057-AFQ,-0.335343058,7,463,470
7888,-1.350869376,0.68018326,057-AFR,-0.335343058,2,392,394
7889,-1.350869376,0.68018326,057-AFS,-0.335343058,0,325,325
7890,-1.350869376,0.68018326,057-AFT,-0.335343058,3,324,327
7891,-1.350869376,0.68018326,057-AFV,-0.335343058,20,110,130
7892,-1.350869376,0.68018326,057-AFW,-0.335343058,12,556,568
7893,-1.350869376,0.68018326,057-AFX,-0.335343058,9,409,418
7894,-1.350869376,0.68018326,057-AFY,-0.335343058,6,284,290
7895,-1.350869376,0.68018326,057-AFZ,-0.335343058,12,318,330
7896,-1.350869376,0.68018326,057-AGA,-0.335343058,5,667,672
7897,-1.350869376,0.68018326,057-AGD,-0.335343058,10,572,582
7898,-1.350869376,0.68018326,057-AGF,-0.335343058,13,614,627
7899,-1.350869376,0.68018326,057-AGG,-0.335343058,28,580,608
7900,-1.350869376,0.68018326,057-AGH,-0.335343058,21,315,336
7901,-1.350869376,0.68018326,057-AGI,-0.335343058,14,577,591
7902,-1.350869376,0.68018326,057-AGJ,-0.335343058,13,321,334
7903,-1.350869376,0.68018326,057-AGK,-0.335343058,8,610,618
7904,-1.350869376,0.68018326,057-AGL,-0.335343058,15,424,439
7905,-1.350869376,0.68018326,057-AGM,-0.335343058,22,607,629
7906,-1.350869376,0.68018326,057-AGN,-0.335343058,8,507,515
7907,-1.350869376,0.68018326,057-AGO,-0.335343058,72,335,407
7908,-1.350869376,0.68018326,057-AGQ,-0.335343058,18,448,466
7909,-1.350869376,0.68018326,057-AGR,-0.335343058,44,320,364
7910,-1.350869376,0.68018326,057-AGS,-0.335343058,40,548,588
7911,-1.350869376,0.68018326,057-AGT,-0.335343058,33,285,318
7912,-1.350869376,0.68018326,057-AGU,-0.335343058,29,337,366
7913,-1.350869376,0.68018326,057-AGV,-0.335343058,65,164,229
7914,-1.350869376,0.68018326,057-AGZ,-0.335343058,35,451,486
7915,-1.350869376,0.68018326,057-AHA,-0.335343058,67,249,316
7916,-1.350869376,0.68018326,057-AHB,-0.335343058,50,306,356
7917,-1.350869376,0.68018326,057-AHC,-0.335343058,133,255,388
7918,-1.350869376,0.68018326,057-AHE,-0.335343058,23,527,550
7919,-1.350869376,0.68018326,057-AHF,-0.335343058,57,246,303
7920,-1.350869376,0.68018326,057-AHG,-0.335343058,65,248,313
7921,-1.350869376,0.68018326,057-AHH,-0.335343058,2,300,302
7922,-1.350869376,0.68018326,057-AHI,-0.335343058,2,318,320
7923,-1.350869376,0.68018326,057-AHJ,-0.335343058,3,371,374
7924,-1.350869376,0.68018326,057-AHK,-0.335343058,5,259,264
7925,-1.350869376,0.68018326,057-AHM,-0.335343058,4,370,374
7926,-1.350869376,0.68018326,057-AHN,-0.335343058,4,495,499
7927,-1.350869376,0.68018326,057-ABM,-0.335343058,182,372,554
7928,-1.350869376,0.68018326,057-ABN,-0.335343058,129,254,383
7929,-1.350869376,0.68018326,057-AYZ,-0.335343058,90,198,288
7930,-1.350869376,0.68018326,057-ABP,-0.335343058,94,166,260
7931,-1.350869376,0.68018326,057-ABQ,-0.335343058,168,286,454
7932,-1.350869376,0.68018326,057-ABR,-0.335343058,251,236,487
7933,-1.350869376,0.68018326,057-AHO,-0.335343058,282,150,432
7934,-1.350869376,0.68018326,057-AHP,-0.335343058,177,187,364
7935,-1.350869376,0.68018326,057-AHQ,-0.335343058,205,544,749
7936,-1.350869376,0.68018326,057-AHR,-0.335343058,258,452,710
7937,-1.350869376,0.68018326,057-AHT,-0.335343058,218,479,697
7938,-1.350869376,0.68018326,057-AHU,-0.335343058,187,357,544
7939,-1.350869376,0.68018326,057-AHV,-0.335343058,255,367,622
7940,-1.350869376,0.68018326,057-AHW,-0.335343058,19,367,386
7941,-1.350869376,0.68018326,057-AHX,-0.335343058,7,508,515
7942,-1.350869376,0.68018326,057-AHY,-0.335343058,13,243,256
7943,-1.350869376,0.68018326,057-AHZ,-0.335343058,4,349,353
7944,-1.350869376,0.68018326,057-AIA,-0.335343058,7,362,369
7945,-1.350869376,0.68018326,057-AID,-0.335343058,4,457,461
7946,-1.350869376,0.68018326,057-AIE,-0.335343058,21,587,608
7947,-1.350869376,0.68018326,057-AIF,-0.335343058,3,126,129
7948,-1.350869376,0.68018326,057-AIH,-0.335343058,6,220,226
7949,-1.350869376,0.68018326,057-AII,-0.335343058,9,160,169
7950,-1.350869376,0.68018326,057-AIJ,-0.335343058,45,301,346
7951,-1.350869376,0.68018326,057-AIK,-0.335343058,46,215,261
7952,-1.350869376,0.68018326,057-ABU,-0.335343058,141,245,386
7953,-1.350869376,0.68018326,057-ABV,-0.335343058,189,210,399
7954,-1.350869376,0.68018326,057-ABW,-0.335343058,417,180,597
7955,-1.350869376,0.68018326,057-ABX,-0.335343058,216,123,339
7956,-1.350869376,0.68018326,057-ABY,-0.335343058,66,143,209
7957,-1.350869376,0.68018326,057-ABZ,-0.335343058,151,209,360
7958,-1.350869376,0.68018326,057-ACA,-0.335343058,132,170,302
7959,-1.350869376,0.68018326,057-ACB,-0.335343058,166,269,435
7960,-1.350869376,0.68018326,057-ACC,-0.335343058,124,228,352
7961,-1.350869376,0.68018326,057-ACD,-0.335343058,235,242,477
7962,-1.350869376,0.68018326,057-ACE,-0.335343058,126,216,342
7963,-1.350869376,0.68018326,057-ACF,-0.335343058,7,168,175
7964,-1.350869376,0.68018326,057-ACG,-0.335343058,577,287,864
7965,-1.350869376,0.68018326,057-ACH,-0.335343058,160,166,326
7966,-1.350869376,0.68018326,057-ACI,-0.335343058,337,237,574
7967,-1.350869376,0.68018326,057-ACJ,-0.335343058,599,154,753
7968,-1.350869376,0.68018326,057-AYT,-0.335343058,388,269,657
7969,-1.350869376,0.68018326,057-ACK,-0.335343058,94,194,288
7970,-1.350869376,0.68018326,057-ACL,-0.335343058,73,99,172
7971,-1.350869376,0.68018326,057-ACM,-0.335343058,31,177,208
7972,-1.350869376,0.68018326,057-ACO,-0.335343058,81,172,253
7973,-1.350869376,0.68018326,057-ACP,-0.335343058,39,119,158
7974,-1.350869376,0.68018326,057-ACQ,-0.335343058,70,155,225
7975,-1.350869376,0.68018326,057-ACR,-0.335343058,14,215,229
7976,-1.350869376,0.68018326,057-ACT,-0.335343058,24,133,157
7977,-1.350869376,0.68018326,057-ACU,-0.335343058,4,222,226
7978,-1.350869376,0.68018326,057-ACV,-0.335343058,10,232,242
7979,-1.350869376,0.68018326,057-ACW,-0.335343058,54,170,224
7980,-1.350869376,0.68018326,057-ACX,-0.335343058,38,84,122
7981,-1.350869376,0.68018326,057-ADA,-0.335343058,11,164,175
7982,-1.350869376,0.68018326,057-ADB,-0.335343058,5,151,156
7983,-1.350869376,0.68018326,057-ADC,-0.335343058,2,213,215
7984,-1.350869376,0.68018326,057-ADD,-0.335343058,3,141,144
7985,-1.350869376,0.68018326,057-ADF,-0.335343058,5,224,229
7986,-1.350869376,0.68018326,057-ADG,-0.335343058,13,164,177
7987,-1.350869376,0.68018326,057-ADJ,-0.335343058,6,220,226
7988,-1.350869376,0.68018326,057-ADK,-0.335343058,17,225,242
7989,-1.350869376,0.68018326,057-ADL,-0.335343058,6,169,175
7990,-1.350869376,0.68018326,057-ADO,-0.335343058,256,205,461
7991,-1.350869376,0.68018326,057-ADP,-0.335343058,209,404,613
7992,-1.350869376,0.68018326,057-ADQ,-0.335343058,107,392,499
7993,-1.350869376,0.68018326,057-ADS,-0.335343058,181,266,447
7994,-1.350869376,0.68018326,057-ADT,-0.335343058,160,492,652
7995,-1.350869376,0.68018326,057-ADU,-0.335343058,123,320,443
7996,-1.350869376,0.68018326,057-ADW,-0.335343058,189,341,530
7997,-1.350869376,0.68018326,057-ADX,-0.335343058,181,172,353
7998,-1.350869376,0.68018326,057-ADY,-0.335343058,220,303,523
7999,-1.350869376,0.68018326,057-ADZ,-0.335343058,158,438,596
8000,-1.350869376,0.68018326,057-AEA,-0.335343058,300,448,748
8001,-1.350869376,0.68018326,057-AEC,-0.335343058,224,163,387
8002,-1.350869376,0.68018326,057-.00,-0.335343058,243,118,361
8003,-1.350869376,0.68018326,057-AEE,-0.335343058,281,122,403
8004,-1.350869376,0.68018326,057-AEF,-0.335343058,207,248,455
8005,-1.350869376,0.68018326,057-AIM,-0.335343058,415,384,799
8006,-1.350869376,0.68018326,057-AIN,-0.335343058,398,473,871
8007,-1.350869376,0.68018326,057-AIO,-0.335343058,285,183,468
8008,-1.350869376,0.68018326,057-AIP,-0.335343058,265,605,870
8009,-1.350869376,0.68018326,057-AIQ,-0.335343058,214,335,549
8010,-1.350869376,0.68018326,057-AIR,-0.335343058,514,431,945
8011,-1.350869376,0.68018326,057-AIS,-0.335343058,293,363,656
8012,-1.350869376,0.68018326,057-AIT,-0.335343058,192,364,556
8013,-1.350869376,0.68018326,057-AIV,-0.335343058,355,245,600
8014,-1.350869376,0.68018326,057-AIX,-0.335343058,346,269,615
8015,-1.350869376,0.68018326,057-AIY,-0.335343058,179,281,460
8016,-1.350869376,0.68018326,057-AIZ,-0.335343058,369,415,784
8017,-1.350869376,0.68018326,057-AZE,-0.335343058,289,469,758
8018,-1.350869376,0.68018326,057-AUZ,-0.335343058,371,263,634
8019,-1.350869376,0.68018326,057-ATO,-0.335343058,299,303,602
8020,-1.350869376,0.68018326,057-ATP,-0.335343058,384,268,652
8021,-1.350869376,0.68018326,057-ATQ,-0.335343058,531,235,766
8022,-1.350869376,0.68018326,057-ATR,-0.335343058,284,279,563
8023,-1.350869376,0.68018326,057-ATS,-0.335343058,407,157,564
8024,-1.350869376,0.68018326,057-ATU,-0.335343058,279,156,435
8025,-1.350869376,0.68018326,057-ATV,-0.335343058,462,174,636
8026,-1.350869376,0.68018326,057-ATW,-0.335343058,345,253,598
8027,-1.350869376,0.68018326,057-ATX,-0.335343058,210,191,401
8028,-1.350869376,0.68018326,057-ATZ,-0.335343058,257,286,543
8029,-1.350869376,0.68018326,057-AUA,-0.335343058,45,267,312
8030,-1.350869376,0.68018326,057-AUB,-0.335343058,140,181,321
8031,-1.350869376,0.68018326,057-AUC,-0.335343058,44,283,327
8032,-1.350869376,0.68018326,057-AUD,-0.335343058,225,300,525
8033,-1.350869376,0.68018326,057-AUE,-0.335343058,195,317,512
8034,-1.350869376,0.68018326,057-AUF,-0.335343058,100,201,301
8035,-1.350869376,0.68018326,057-AUG,-0.335343058,79,262,341
8036,-1.350869376,0.68018326,057-AUH,-0.335343058,99,271,370
8037,-1.350869376,0.68018326,057-AUI,-0.335343058,207,273,480
8038,-1.350869376,0.68018326,057-AUJ,-0.335343058,36,245,281
8039,-1.350869376,0.68018326,057-AUK,-0.335343058,227,296,523
8040,-1.350869376,0.68018326,057-AUL,-0.335343058,25,172,197
8041,-1.350869376,0.68018326,057-AUM,-0.335343058,175,259,434
8042,-1.350869376,0.68018326,057-AUN,-0.335343058,139,450,589
8043,-1.350869376,0.68018326,057-AUO,-0.335343058,143,218,361
8044,-1.350869376,0.68018326,057-AUQ,-0.335343058,99,149,248
8045,-1.350869376,0.68018326,057-AUR,-0.335343058,52,153,205
8046,-1.350869376,0.68018326,057-AUT,-0.335343058,84,190,274
8047,-1.350869376,0.68018326,057-AUU,-0.335343058,208,69,277
8048,-1.350869376,0.68018326,057-AUW,-0.335343058,82,157,239
8049,-1.350869376,0.68018326,057-AUX,-0.335343058,156,181,337
8050,-1.350869376,0.68018326,057-AUY,-0.335343058,49,181,230
8051,-1.350869376,0.68018326,057-AJA,-0.335343058,297,182,479
8052,-1.350869376,0.68018326,057-AJB,-0.335343058,305,105,410
8053,-1.350869376,0.68018326,057-AJC,-0.335343058,298,157,455
8054,-1.350869376,0.68018326,057-AJD,-0.335343058,493,297,790
8055,-1.350869376,0.68018326,057-AJE,-0.335343058,185,392,577
8056,-1.350869376,0.68018326,057-AJF,-0.335343058,348,462,810
8057,-1.350869376,0.68018326,057-AJG,-0.335343058,428,234,662
8058,-1.350869376,0.68018326,057-AJI,-0.335343058,268,395,663
8059,-1.350869376,0.68018326,057-AJJ,-0.335343058,362,211,573
8060,-1.350869376,0.68018326,057-AJK,-0.335343058,369,716,1085
8061,-1.350869376,0.68018326,057-AJL,-0.335343058,229,161,390
8062,-1.350869376,0.68018326,057-AJM,-0.335343058,176,206,382
8063,-1.350869376,0.68018326,057-AJN,-0.335343058,158,115,273
8064,-1.350869376,0.68018326,057-AJO,-0.335343058,319,277,596
8065,-1.350869376,0.68018326,057-AJP,-0.335343058,250,186,436
8066,-1.350869376,0.68018326,057-AJQ,-0.335343058,368,336,704
8067,-1.350869376,0.68018326,057-AJR,-0.335343058,141,125,266
8068,-1.350869376,0.68018326,057-AJS,-0.335343058,253,189,442
8069,-1.350869376,0.68018326,057-AJU,-0.335343058,342,270,612
8070,-1.350869376,0.68018326,057-AJV,-0.335343058,341,230,571
8071,-1.350869376,0.68018326,057-AJW,-0.335343058,283,300,583
8072,-1.350869376,0.68018326,057-AJY,-0.335343058,222,162,384
8073,-1.350869376,0.68018326,057-AKA,-0.335343058,214,193,407
8074,-1.350869376,0.68018326,057-AKB,-0.335343058,317,197,514
8075,-1.350869376,0.68018326,057-AKD,-0.335343058,243,197,440
8076,-1.350869376,0.68018326,057-AKF,-0.335343058,282,322,604
8077,-1.350869376,0.68018326,057-AKH,-0.335343058,273,182,455
8078,-1.350869376,0.68018326,057-AKI,-0.335343058,121,191,312
8079,-1.350869376,0.68018326,057-AKJ,-0.335343058,380,322,702
8080,-1.350869376,0.68018326,057-AKK,-0.335343058,629,199,828
8081,-1.350869376,0.68018326,057-AKM,-0.335343058,201,263,464
8082,-1.350869376,0.68018326,057-AKN,-0.335343058,147,128,275
8083,-1.350869376,0.68018326,057-AKO,-0.335343058,206,212,418
8084,-1.350869376,0.68018326,057-AKP,-0.335343058,286,245,531
8085,-1.350869376,0.68018326,057-AVA,-0.335343058,320,248,568
8086,-1.350869376,0.68018326,057-AVB,-0.335343058,183,133,316
8087,-1.350869376,0.68018326,057-AVC,-0.335343058,282,249,531
8088,-1.350869376,0.68018326,057-AVD,-0.335343058,311,157,468
8089,-1.350869376,0.68018326,057-AVE,-0.335343058,444,233,677
8090,-1.350869376,0.68018326,057-AVF,-0.335343058,449,160,609
8091,-1.350869376,0.68018326,057-AVG,-0.335343058,230,313,543
8092,-1.350869376,0.68018326,057-AVH,-0.335343058,36,151,187
8093,-1.350869376,0.68018326,057-AVI,-0.335343058,35,386,421
8094,-1.350869376,0.68018326,057-AVJ,-0.335343058,233,296,529
8095,-1.350869376,0.68018326,057-AVK,-0.335343058,54,243,297
8096,-1.350869376,0.68018326,057-AVL,-0.335343058,79,198,277
8097,-1.350869376,0.68018326,057-AVM,-0.335343058,10,232,242
8098,-1.350869376,0.68018326,057-AKQ,-0.335343058,110,305,415
8099,-1.350869376,0.68018326,057-AKR,-0.335343058,194,217,411
8100,-1.350869376,0.68018326,057-AKS,-0.335343058,178,219,397
8101,-1.350869376,0.68018326,057-AKT,-0.335343058,181,278,459
8102,-1.350869376,0.68018326,057-AKU,-0.335343058,258,348,606
8103,-1.350869376,0.68018326,057-AKV,-0.335343058,387,242,629
8104,-1.350869376,0.68018326,057-AKW,-0.335343058,163,252,415
8105,-1.350869376,0.68018326,057-AKY,-0.335343058,198,354,552
8106,-1.350869376,0.68018326,057-AKZ,-0.335343058,381,230,611
8107,-1.350869376,0.68018326,057-ALA,-0.335343058,264,317,581
8108,-1.350869376,0.68018326,057-ALB,-0.335343058,411,157,568
8109,-1.350869376,0.68018326,057-ALD,-0.335343058,219,167,386
8110,-1.350869376,0.68018326,057-ALE,-0.335343058,209,178,387
8111,-1.350869376,0.68018326,057-ALF,-0.335343058,238,164,402
8112,-1.350869376,0.68018326,057-ALG,-0.335343058,250,194,444
8113,-1.350869376,0.68018326,057-ALH,-0.335343058,352,211,563
8114,-1.350869376,0.68018326,057-ALI,-0.335343058,223,184,407
8115,-1.350869376,0.68018326,057-ALJ,-0.335343058,333,249,582
8116,-1.350869376,0.68018326,057-ALK,-0.335343058,321,334,655
8117,-1.350869376,0.68018326,057-ALL,-0.335343058,291,131,422
8118,-1.350869376,0.68018326,057-ALN,-0.335343058,412,360,772
8119,-1.350869376,0.68018326,057-ALO,-0.335343058,218,187,405
8120,-1.350869376,0.68018326,057-ALP,-0.335343058,336,182,518
8121,-1.350869376,0.68018326,057-ALQ,-0.335343058,381,148,529
8122,-1.350869376,0.68018326,057-ALR,-0.335343058,412,208,620
8123,-1.350869376,0.68018326,057-ALS,-0.335343058,197,465,662
8124,-1.350869376,0.68018326,057-ALV,-0.335343058,416,535,951
8125,-1.350869376,0.68018326,057-ALY,-0.335343058,222,479,701
8126,-1.350869376,0.68018326,057-ALZ,-0.335343058,211,714,925
8127,-1.350869376,0.68018326,057-AMA,-0.335343058,220,597,817
8128,-1.350869376,0.68018326,057-AMB,-0.335343058,358,645,1003
8129,-1.350869376,0.68018326,057-AMC,-0.335343058,91,407,498
8130,-1.350869376,0.68018326,057-AMD,-0.335343058,259,573,832
8131,-1.350869376,0.68018326,057-AME,-0.335343058,363,658,1021
8132,-1.350869376,0.68018326,057-AMF,-0.335343058,346,368,714
8133,-1.350869376,0.68018326,057-AMH,-0.335343058,337,571,908
8134,-1.350869376,0.68018326,057-AMI,-0.335343058,423,666,1089
8135,-1.350869376,0.68018326,057-AMK,-0.335343058,418,330,748
8136,-1.350869376,0.68018326,057-AML,-0.335343058,467,427,894
8137,-1.350869376,0.68018326,057-AMM,-0.335343058,348,582,930
8138,-1.350869376,0.68018326,057-AMO,-0.335343058,388,288,676
8139,-1.350869376,0.68018326,057-AMQ,-0.335343058,418,212,630
8140,-1.350869376,0.68018326,057-AMV,-0.335343058,419,216,635
8141,-1.350869376,0.68018326,057-AMX,-0.335343058,276,253,529
8142,-1.350869376,0.68018326,057-AMY,-0.335343058,273,520,793
8143,-1.350869376,0.68018326,057-AMZ,-0.335343058,204,423,627
8144,-1.350869376,0.68018326,057-ANA,-0.335343058,414,283,697
8145,-1.350869376,0.68018326,057-ANB,-0.335343058,241,410,651
8146,-1.350869376,0.68018326,057-ANC,-0.335343058,217,488,705
8147,-1.350869376,0.68018326,057-AND,-0.335343058,264,280,544
8148,-1.350869376,0.68018326,057-ANE,-0.335343058,149,187,336
8149,-1.350869376,0.68018326,057-ANF,-0.335343058,244,225,469
8150,-1.350869376,0.68018326,057-ANG,-0.335343058,200,243,443
8151,-1.350869376,0.68018326,057-ANH,-0.335343058,181,249,430
8152,-1.350869376,0.68018326,057-ANI,-0.335343058,328,263,591
8153,-1.350869376,0.68018326,057-ANK,-0.335343058,381,307,688
8154,-1.350869376,0.68018326,057-ANL,-0.335343058,120,248,368
8155,-1.350869376,0.68018326,057-ANM,-0.335343058,386,261,647
8156,-1.350869376,0.68018326,057-ANP,-0.335343058,228,142,370
8157,-1.350869376,0.68018326,057-ANS,-0.335343058,307,194,501
8158,-1.350869376,0.68018326,057-ANT,-0.335343058,190,198,388
8159,-1.350869376,0.68018326,057-AVP,-0.335343058,222,164,386
8160,-1.350869376,0.68018326,057-AZB,-0.335343058,206,227,433
8161,-1.350869376,0.68018326,057-AVQ,-0.335343058,230,312,542
8162,-1.350869376,0.68018326,057-AZC,-0.335343058,92,163,255
8163,-1.350869376,0.68018326,057-AVR,-0.335343058,470,261,731
8164,-1.350869376,0.68018326,057-AZD,-0.335343058,536,314,850
8165,-1.350869376,0.68018326,057-AVS,-0.335343058,313,243,556
8166,-1.350869376,0.68018326,057-AVT,-0.335343058,441,189,630
8167,-1.350869376,0.68018326,057-AVU,-0.335343058,326,134,460
8168,-1.350869376,0.68018326,057-AVV,-0.335343058,179,133,312
8169,-1.350869376,0.68018326,057-AVW,-0.335343058,202,298,500
8170,-1.350869376,0.68018326,057-AVX,-0.335343058,201,352,553
8171,-1.350869376,0.68018326,057-AVY,-0.335343058,184,156,340
8172,-1.350869376,0.68018326,057-AVZ,-0.335343058,189,262,451
8173,-1.350869376,0.68018326,057-AWA,-0.335343058,431,168,599
8174,-1.350869376,0.68018326,057-AWC,-0.335343058,188,155,343
8175,-1.350869376,0.68018326,057-AWD,-0.335343058,385,234,619
8176,-1.350869376,0.68018326,057-AWE,-0.335343058,152,113,265
8177,-1.350869376,0.68018326,057-AWF,-0.335343058,180,130,310
8178,-1.350869376,0.68018326,057-AWG,-0.335343058,271,233,504
8179,-1.350869376,0.68018326,057-AWH,-0.335343058,552,207,759
8180,-1.350869376,0.68018326,057-AWI,-0.335343058,201,281,482
8181,-1.350869376,0.68018326,057-AWJ,-0.335343058,221,270,491
8182,-1.350869376,0.68018326,057-AWK,-0.335343058,445,228,673
8183,-1.350869376,0.68018326,057-AWL,-0.335343058,385,140,525
8184,-1.350869376,0.68018326,057-AWM,-0.335343058,342,278,620
8185,-1.350869376,0.68018326,057-AWN,-0.335343058,539,119,658
8186,-1.350869376,0.68018326,057-AYU,-0.335343058,361,183,544
8187,-1.350869376,0.68018326,057-ANU,-0.335343058,438,258,696
8188,-1.350869376,0.68018326,057-ANV,-0.335343058,207,230,437
8189,-1.350869376,0.68018326,057-ANW,-0.335343058,293,280,573
8190,-1.350869376,0.68018326,057-ANX,-0.335343058,384,176,560
8191,-1.350869376,0.68018326,057-ANY,-0.335343058,250,316,566
8192,-1.350869376,0.68018326,057-ANZ,-0.335343058,248,229,477
8193,-1.350869376,0.68018326,057-AOA,-0.335343058,244,89,333
8194,-1.350869376,0.68018326,057-AOB,-0.335343058,197,322,519
8195,-1.350869376,0.68018326,057-AOC,-0.335343058,142,232,374
8196,-1.350869376,0.68018326,057-AOD,-0.335343058,362,207,569
8197,-1.350869376,0.68018326,057-AOE,-0.335343058,346,249,595
8198,-1.350869376,0.68018326,057-AOF,-0.335343058,257,144,401
8199,-1.350869376,0.68018326,057-AOG,-0.335343058,290,388,678
8200,-1.350869376,0.68018326,057-AOI,-0.335343058,391,182,573
8201,-1.350869376,0.68018326,057-AYV,-0.335343058,225,204,429
8202,-1.350869376,0.68018326,057-AOJ,-0.335343058,357,147,504
8203,-1.350869376,0.68018326,057-AOK,-0.335343058,316,147,463
8204,-1.350869376,0.68018326,057-AON,-0.335343058,458,204,662
8205,-1.350869376,0.68018326,057-AOO,-0.335343058,417,320,737
8206,-1.350869376,0.68018326,057-AYW,-0.335343058,462,151,613
8207,-1.350869376,0.68018326,057-AOP,-0.335343058,108,211,319
8208,-1.350869376,0.68018326,057-AOQ,-0.335343058,200,287,487
8209,-1.350869376,0.68018326,057-AOR,-0.335343058,125,124,249
8210,-1.350869376,0.68018326,057-AOS,-0.335343058,274,190,464
8211,-1.350869376,0.68018326,057-AOT,-0.335343058,324,198,522
8212,-1.350869376,0.68018326,057-AOU,-0.335343058,134,184,318
8213,-1.350869376,0.68018326,057-AYX,-0.335343058,180,164,344
8214,-1.350869376,0.68018326,057-AOV,-0.335343058,218,187,405
8215,-1.350869376,0.68018326,057-AOW,-0.335343058,311,150,461
8216,-1.350869376,0.68018326,057-AOX,-0.335343058,212,138,350
8217,-1.350869376,0.68018326,057-AOY,-0.335343058,184,213,397
8218,-1.350869376,0.68018326,057-AOZ,-0.335343058,234,235,469
8219,-1.350869376,0.68018326,057-APA,-0.335343058,270,183,453
8220,-1.350869376,0.68018326,057-APB,-0.335343058,314,207,521
8221,-1.350869376,0.68018326,057-APD,-0.335343058,290,202,492
8222,-1.350869376,0.68018326,057-APF,-0.335343058,287,136,423
8223,-1.350869376,0.68018326,057-APG,-0.335343058,261,220,481
8224,-1.350869376,0.68018326,057-APH,-0.335343058,262,231,493
8225,-1.350869376,0.68018326,057-AWO,-0.335343058,294,209,503
8226,-1.350869376,0.68018326,057-API,-0.335343058,245,222,467
8227,-1.350869376,0.68018326,057-AWQ,-0.335343058,413,197,610
8228,-1.350869376,0.68018326,057-AWR,-0.335343058,473,92,565
8229,-1.350869376,0.68018326,057-AWS,-0.335343058,499,174,673
8230,-1.350869376,0.68018326,057-ATE,-0.335343058,193,133,326
8231,-1.350869376,0.68018326,057-APJ,-0.335343058,416,232,648
8232,-1.350869376,0.68018326,057-APK,-0.335343058,270,254,524
8233,-1.350869376,0.68018326,057-APL,-0.335343058,266,131,397
8234,-1.350869376,0.68018326,057-APM,-0.335343058,304,375,679
8235,-1.350869376,0.68018326,057-APN,-0.335343058,269,221,490
8236,-1.350869376,0.68018326,057-APP,-0.335343058,318,245,563
8237,-1.350869376,0.68018326,057-APQ,-0.335343058,226,186,412
8238,-1.350869376,0.68018326,057-APR,-0.335343058,296,155,451
8239,-1.350869376,0.68018326,057-APS,-0.335343058,308,219,527
8240,-1.350869376,0.68018326,057-APT,-0.335343058,198,364,562
8241,-1.350869376,0.68018326,057-APU,-0.335343058,275,353,628
8242,-1.350869376,0.68018326,057-APY,-0.335343058,260,358,618
8243,-1.350869376,0.68018326,057-APZ,-0.335343058,233,245,478
8244,-1.350869376,0.68018326,057-AQA,-0.335343058,248,216,464
8245,-1.350869376,0.68018326,057-AQB,-0.335343058,246,200,446
8246,-1.350869376,0.68018326,057-AQC,-0.335343058,239,162,401
8247,-1.350869376,0.68018326,057-AQD,-0.335343058,450,205,655
8248,-1.350869376,0.68018326,057-AQF,-0.335343058,385,217,602
8249,-1.350869376,0.68018326,057-AQH,-0.335343058,129,194,323
8250,-1.350869376,0.68018326,057-AQI,-0.335343058,133,202,335
8251,-1.350869376,0.68018326,057-AQJ,-0.335343058,103,370,473
8252,-1.350869376,0.68018326,057-AQK,-0.335343058,24,278,302
8253,-1.350869376,0.68018326,057-AQL,-0.335343058,32,164,196
8254,-1.350869376,0.68018326,057-AQM,-0.335343058,49,315,364
8255,-1.350869376,0.68018326,057-AQN,-0.335343058,108,252,360
8256,-1.350869376,0.68018326,057-AQO,-0.335343058,29,256,285
8257,-1.350869376,0.68018326,057-AQQ,-0.335343058,75,217,292
8258,-1.350869376,0.68018326,057-AQR,-0.335343058,52,294,346
8259,-1.350869376,0.68018326,057-AQS,-0.335343058,65,209,274
8260,-1.350869376,0.68018326,057-AQT,-0.335343058,226,170,396
8261,-1.350869376,0.68018326,057-AQU,-0.335343058,48,366,414
8262,-1.350869376,0.68018326,057-AQV,-0.335343058,34,449,483
8263,-1.350869376,0.68018326,057-AQW,-0.335343058,20,172,192
8264,-1.350869376,0.68018326,057-AQX,-0.335343058,58,218,276
8265,-1.350869376,0.68018326,057-AQY,-0.335343058,97,387,484
8266,-1.350869376,0.68018326,057-AQZ,-0.335343058,147,279,426
8267,-1.350869376,0.68018326,057-ARA,-0.335343058,272,275,547
8268,-1.350869376,0.68018326,057-ARB,-0.335343058,66,299,365
8269,-1.350869376,0.68018326,057-ARC,-0.335343058,164,155,319
8270,-1.350869376,0.68018326,057-ARD,-0.335343058,67,234,301
8271,-1.350869376,0.68018326,057-ARE,-0.335343058,9,240,249
8272,-1.350869376,0.68018326,057-ARF,-0.335343058,51,164,215
8273,-1.350869376,0.68018326,057-ARG,-0.335343058,50,332,382
8274,-1.350869376,0.68018326,057-ARH,-0.335343058,17,312,329
8275,-1.350869376,0.68018326,057-ARI,-0.335343058,306,134,440
8276,-1.350869376,0.68018326,057-ARJ,-0.335343058,459,256,715
8277,-1.350869376,0.68018326,057-ARK,-0.335343058,453,211,664
8278,-1.350869376,0.68018326,057-ARL,-0.335343058,244,160,404
8279,-1.350869376,0.68018326,057-ARM,-0.335343058,442,325,767
8280,-1.350869376,0.68018326,057-ARN,-0.335343058,225,232,457
8281,-1.350869376,0.68018326,057-ARO,-0.335343058,161,163,324
8282,-1.350869376,0.68018326,057-ARP,-0.335343058,341,261,602
8283,-1.350869376,0.68018326,057-ARQ,-0.335343058,265,108,373
8284,-1.350869376,0.68018326,057-ARR,-0.335343058,348,232,580
8285,-1.350869376,0.68018326,057-.00,-0.335343058,361,123,484
8286,-1.350869376,0.68018326,057-ART,-0.335343058,284,182,466
8287,-1.350869376,0.68018326,057-ARU,-0.335343058,430,126,556
8288,-1.350869376,0.68018326,057-ARV,-0.335343058,411,154,565
8289,-1.350869376,0.68018326,057-ARX,-0.335343058,488,217,705
8290,-1.350869376,0.68018326,057-AZA,-0.335343058,413,160,573
8291,-1.350869376,0.68018326,057-ARZ,-0.335343058,519,235,754
8292,-1.350869376,0.68018326,057-ASA,-0.335343058,184,156,340
8293,-1.350869376,0.68018326,057-ASB,-0.335343058,463,234,697
8294,-1.350869376,0.68018326,057-ASC,-0.335343058,305,217,522
8295,-1.350869376,0.68018326,057-ASD,-0.335343058,204,425,629
8296,-1.350869376,0.68018326,057-ASE,-0.335343058,218,256,474
8297,-1.350869376,0.68018326,057-ASF,-0.335343058,301,200,501
8298,-1.350869376,0.68018326,057-ASG,-0.335343058,363,145,508
8299,-1.350869376,0.68018326,057-ASH,-0.335343058,277,184,461
8300,-1.350869376,0.68018326,057-ASI,-0.335343058,238,257,495
8301,-1.350869376,0.68018326,057-ASJ,-0.335343058,323,346,669
8302,-1.350869376,0.68018326,057-ASK,-0.335343058,335,204,539
8303,-1.350869376,0.68018326,057-ASN,-0.335343058,260,166,426
8304,-1.350869376,0.68018326,057-ASO,-0.335343058,225,271,496
8305,-1.350869376,0.68018326,057-ASP,-0.335343058,274,272,546
8306,-1.350869376,0.68018326,057-ASQ,-0.335343058,178,175,353
8307,-1.350869376,0.68018326,057-ASS,-0.335343058,251,159,410
8308,-1.350869376,0.68018326,057-AST,-0.335343058,105,344,449
8309,-1.350869376,0.68018326,057-AXI,-0.335343058,392,302,694
8310,-1.350869376,0.68018326,057-AXJ,-0.335343058,378,154,532
8311,-1.350869376,0.68018326,057-AXK,-0.335343058,234,244,478
8312,-1.350869376,0.68018326,057-AXL,-0.335343058,442,248,690
8313,-1.350869376,0.68018326,057-AXM,-0.335343058,394,189,583
8314,-1.350869376,0.68018326,057-AXN,-0.335343058,348,153,501
8315,-1.350869376,0.68018326,057-AXO,-0.335343058,222,266,488
8316,-1.350869376,0.68018326,057-AXP,-0.335343058,390,168,558
8317,-1.350869376,0.68018326,057-AXQ,-0.335343058,303,259,562
8318,-1.350869376,0.68018326,057-AXR,-0.335343058,523,144,667
8319,-1.350869376,0.68018326,057-AXS,-0.335343058,342,102,444
8320,-1.350869376,0.68018326,057-AXT,-0.335343058,310,252,562
8321,-1.350869376,0.68018326,057-AXU,-0.335343058,336,212,548
8322,-1.350869376,0.68018326,057-AXW,-0.335343058,415,196,611
8323,-1.350869376,0.68018326,057-AXX,-0.335343058,200,271,471
8324,-1.350869376,0.68018326,057-AXY,-0.335343058,290,234,524
8325,-1.350869376,0.68018326,057-AXZ,-0.335343058,509,178,687
8326,-1.350869376,0.68018326,057-AYA,-0.335343058,437,127,564
8327,-1.350869376,0.68018326,057-AYB,-0.335343058,377,242,619
8328,-1.350869376,0.68018326,057-AYC,-0.335343058,441,201,642
8329,-1.350869376,0.68018326,057-AYD,-0.335343058,582,299,881
8330,-1.350869376,0.68018326,057-AYE,-0.335343058,489,236,725
8331,-1.350869376,0.68018326,057-AZF,-0.335343058,118,167,285
8332,-1.350869376,0.68018326,057-AYF,-0.335343058,497,322,819
8333,-1.350869376,0.68018326,057-AYH,-0.335343058,325,322,647
8334,-1.350869376,0.68018326,057-AYI,-0.335343058,298,115,413
8335,-1.350869376,0.68018326,057-AYJ,-0.335343058,244,218,462
8336,-1.350869376,0.68018326,057-AYL,-0.335343058,420,241,661
8337,-1.350869376,0.68018326,057-AYM,-0.335343058,363,180,543
8338,-1.350869376,0.68018326,057-AYN,-0.335343058,347,166,513
8339,-1.350869376,0.68018326,057-AYO,-0.335343058,213,296,509
8340,-1.350869376,0.68018326,057-AYP,-0.335343058,307,210,517
8341,-1.350869376,0.68018326,057-AYQ,-0.335343058,440,376,816
8342,-1.350869376,0.68018326,057-AYR,-0.335343058,267,266,533
8343,-1.350869376,0.68018326,057-AYS,-0.335343058,348,393,741
8344,-1.350869376,0.68018326,058-AAC,-0.335343058,84,94,178
8345,-1.350869376,0.68018326,058-AAD,-0.335343058,183,136,319
8346,-1.350869376,0.68018326,058-AAL,-0.335343058,202,293,495
8347,-1.350869376,0.68018326,058-AAA,-0.335343058,181,185,366
8348,-1.350869376,0.68018326,058-AAF,-0.335343058,327,348,675
8349,-1.350869376,0.68018326,058-AAI,-0.335343058,447,340,787
8350,-1.350869376,0.68018326,058-AAP,-0.335343058,376,244,620
8351,-1.350869376,0.68018326,058-AAQ,-0.335343058,254,222,476
8352,-1.350869376,0.68018326,058-AAN,-0.335343058,278,179,457
8353,-1.350869376,0.68018326,058-AAS,-0.335343058,179,135,314
8354,-1.350869376,0.68018326,058-AAU,-0.335343058,478,398,876
8355,-1.350869376,0.68018326,058-AAB,-0.335343058,310,169,479
8356,-1.350869376,0.68018326,058-AAW,-0.335343058,141,223,364
8357,-1.350869376,0.68018326,059-AAA,-0.335343058,387,233,620
8358,-1.350869376,0.68018326,059-AAC,-0.335343058,505,250,755
8359,-1.350869376,0.68018326,059-AAD,-0.335343058,301,175,476
8360,-1.350869376,0.68018326,059-AAE,-0.335343058,372,226,598
8361,-1.350869376,0.68018326,059-AAF,-0.335343058,224,170,394
8362,-1.350869376,0.68018326,059-AAG,-0.335343058,212,154,366
8363,-1.350869376,0.68018326,059-AAH,-0.335343058,323,152,475
8364,-1.350869376,0.68018326,059-AAI,-0.335343058,248,152,400
8365,-1.350869376,0.68018326,059-AAJ,-0.335343058,432,233,665
8366,-1.350869376,0.68018326,059-AAK,-0.335343058,490,265,755
8367,-1.350869376,0.68018326,059-AAM,-0.335343058,127,86,213
8368,-1.350869376,0.68018326,059-AAL,-0.335343058,472,282,754
8369,-1.350869376,0.68018326,059-AAN,-0.335343058,218,102,320
8370,-1.350869376,0.68018326,059-AAO,-0.335343058,263,146,409
8371,-1.350869376,0.68018326,059-AAP,-0.335343058,293,139,432
8372,-1.350869376,0.68018326,059-AAV,-0.335343058,315,191,506
8373,-1.350869376,0.68018326,059-ABJ,-0.335343058,384,270,654
8374,-1.350869376,0.68018326,059-AAW,-0.335343058,205,186,391
8375,-1.350869376,0.68018326,059-AAX,-0.335343058,288,198,486
8376,-1.350869376,0.68018326,059-AAQ,-0.335343058,185,153,338
8377,-1.350869376,0.68018326,059-AAR,-0.335343058,226,198,424
8378,-1.350869376,0.68018326,059-AAS,-0.335343058,289,231,520
8379,-1.350869376,0.68018326,059-AAT,-0.335343058,183,135,318
8380,-1.350869376,0.68018326,059-AAY,-0.335343058,349,177,526
8381,-1.350869376,0.68018326,059-AAZ,-0.335343058,222,166,388
8382,-1.350869376,0.68018326,059-ABA,-0.335343058,250,135,385
8383,-1.350869376,0.68018326,059-ABB,-0.335343058,163,124,287
8384,-1.350869376,0.68018326,059-ABC,-0.335343058,416,252,668
8385,-1.350869376,0.68018326,059-ABD,-0.335343058,301,166,467
8386,-1.350869376,0.68018326,059-ABE,-0.335343058,266,137,403
8387,-1.350869376,0.68018326,059-ABF,-0.335343058,401,194,595
8388,-1.350869376,0.68018326,059-ABH,-0.335343058,381,272,653
8389,-1.350869376,0.68018326,059-ABI,-0.335343058,376,227,603
8390,-1.350869376,0.68018326,060-AAX,-0.335343058,145,51,196
8391,-1.350869376,0.68018326,060-AAY,-0.335343058,182,133,315
8392,-1.350869376,0.68018326,060-AAZ,-0.335343058,165,133,298
8393,-1.350869376,0.68018326,060-ABA,-0.335343058,101,108,209
8394,-1.350869376,0.68018326,060-ABB,-0.335343058,459,322,781
8395,-1.350869376,0.68018326,060-ABC,-0.335343058,189,192,381
8396,-1.350869376,0.68018326,060-ABV,-0.335343058,219,212,431
8397,-1.350869376,0.68018326,060-ABW,-0.335343058,229,172,401
8398,-1.350869376,0.68018326,060-ADD,-0.335343058,329,268,597
8399,-1.350869376,0.68018326,060-ABD,-0.335343058,383,241,624
8400,-1.350869376,0.68018326,060-ABE,-0.335343058,317,259,576
8401,-1.350869376,0.68018326,060-ABF,-0.335343058,212,248,460
8402,-1.350869376,0.68018326,060-ABG,-0.335343058,309,195,504
8403,-1.350869376,0.68018326,060-ABH,-0.335343058,250,147,397
8404,-1.350869376,0.68018326,060-ABI,-0.335343058,191,159,350
8405,-1.350869376,0.68018326,060-ABJ,-0.335343058,256,171,427
8406,-1.350869376,0.68018326,060-ABK,-0.335343058,418,243,661
8407,-1.350869376,0.68018326,060-ABL,-0.335343058,273,228,501
8408,-1.350869376,0.68018326,060-ABM,-0.335343058,229,171,400
8409,-1.350869376,0.68018326,060-ABT,-0.335343058,279,237,516
8410,-1.350869376,0.68018326,060-ACF,-0.335343058,233,195,428
8411,-1.350869376,0.68018326,060-ABN,-0.335343058,231,158,389
8412,-1.350869376,0.68018326,060-ABP,-0.335343058,305,153,458
8413,-1.350869376,0.68018326,060-ABQ,-0.335343058,264,200,464
8414,-1.350869376,0.68018326,060-ABR,-0.335343058,310,249,559
8415,-1.350869376,0.68018326,060-ABS,-0.335343058,390,187,577
8416,-1.350869376,0.68018326,060-ACG,-0.335343058,127,90,217
8417,-1.350869376,0.68018326,060-ABU,-0.335343058,319,224,543
8418,-1.350869376,0.68018326,060-ABX,-0.335343058,346,244,590
8419,-1.350869376,0.68018326,060-ABY,-0.335343058,360,273,633
8420,-1.350869376,0.68018326,060-ABZ,-0.335343058,111,80,191
8421,-1.350869376,0.68018326,060-ACA,-0.335343058,59,19,78
8422,-1.350869376,0.68018326,060-ACB,-0.335343058,137,73,210
8423,-1.350869376,0.68018326,060-ACH,-0.335343058,298,276,574
8424,-1.350869376,0.68018326,060-ACC,-0.335343058,428,357,785
8425,-1.350869376,0.68018326,060-ACD,-0.335343058,410,318,728
8426,-1.350869376,0.68018326,060-ACE,-0.335343058,460,264,724
8427,-1.350869376,0.68018326,060-ACX,-0.335343058,139,135,274
8428,-1.350869376,0.68018326,060-ACY,-0.335343058,272,248,520
8429,-1.350869376,0.68018326,060-ACV,-0.335343058,383,220,603
8430,-1.350869376,0.68018326,060-ACK,-0.335343058,349,181,530
8431,-1.350869376,0.68018326,060-ACL,-0.335343058,549,288,837
8432,-1.350869376,0.68018326,060-ABO,-0.335343058,156,161,317
8433,-1.350869376,0.68018326,060-ACM,-0.335343058,172,69,241
8434,-1.350869376,0.68018326,060-ACI,-0.335343058,331,240,571
8435,-1.350869376,0.68018326,060-ACT,-0.335343058,200,249,449
8436,-1.350869376,0.68018326,060-ACU,-0.335343058,112,142,254
8437,-1.350869376,0.68018326,060-ACN,-0.335343058,290,138,428
8438,-1.350869376,0.68018326,060-ACO,-0.335343058,345,216,561
8439,-1.350869376,0.68018326,060-ACP,-0.335343058,270,299,569
8440,-1.350869376,0.68018326,060-ACQ,-0.335343058,262,265,527
8441,-1.350869376,0.68018326,060-ACR,-0.335343058,198,123,321
8442,-1.350869376,0.68018326,060-ACS,-0.335343058,136,173,309
8443,-1.350869376,0.68018326,060-ACW,-0.335343058,226,126,352
8444,-1.350869376,0.68018326,060-ACZ,-0.335343058,327,241,568
8445,-1.350869376,0.68018326,060-ADA,-0.335343058,323,215,538
8446,-1.350869376,0.68018326,060-ADB,-0.335343058,250,184,434
8447,-1.350869376,0.68018326,060-ADC,-0.335343058,147,146,293
8448,-1.350869376,0.68018326,060-ADE,-0.335343058,227,218,445
8449,-1.350869376,0.68018326,060-ADF,-0.335343058,394,253,647
8450,-1.350869376,0.68018326,060-ADG,-0.335343058,429,274,703
8451,-1.350869376,0.68018326,060-ACJ,-0.335343058,314,202,516
8452,-1.350869376,0.68018326,060-AAA,-0.335343058,109,179,288
8453,-1.350869376,0.68018326,060-AAB,-0.335343058,110,149,259
8454,-1.350869376,0.68018326,060-AAC,-0.335343058,94,183,277
8455,-1.350869376,0.68018326,060-AAD,-0.335343058,121,133,254
8456,-1.350869376,0.68018326,060-AAE,-0.335343058,134,186,320
8457,-1.350869376,0.68018326,060-AAF,-0.335343058,169,234,403
8458,-1.350869376,0.68018326,060-AAG,-0.335343058,116,200,316
8459,-1.350869376,0.68018326,060-AAH,-0.335343058,114,266,380
8460,-1.350869376,0.68018326,060-AAI,-0.335343058,122,268,390
8461,-1.350869376,0.68018326,060-AAJ,-0.335343058,81,280,361
8462,-1.350869376,0.68018326,060-AAK,-0.335343058,49,351,400
8463,-1.350869376,0.68018326,060-AAL,-0.335343058,136,310,446
8464,-1.350869376,0.68018326,060-AAM,-0.335343058,140,348,488
8465,-1.350869376,0.68018326,060-AAN,-0.335343058,223,288,511
8466,-1.350869376,0.68018326,060-AAO,-0.335343058,201,242,443
8467,-1.350869376,0.68018326,060-AAP,-0.335343058,252,197,449
8468,-1.350869376,0.68018326,060-AAQ,-0.335343058,177,192,369
8469,-1.350869376,0.68018326,060-AAR,-0.335343058,219,189,408
8470,-1.350869376,0.68018326,060-ADH,-0.335343058,217,314,531
8471,-1.350869376,0.68018326,060-AAS,-0.335343058,250,269,519
8472,-1.350869376,0.68018326,060-AAT,-0.335343058,248,253,501
8473,-1.350869376,0.68018326,060-AAU,-0.335343058,236,257,493
8474,-1.350869376,0.68018326,060-AAV,-0.335343058,307,186,493
8475,-1.350869376,0.68018326,061-AAN,-0.335343058,63,49,112
8476,-1.350869376,0.68018326,061-AAA,-0.335343058,155,108,263
8477,-1.350869376,0.68018326,061-AAO,-0.335343058,33,81,114
8478,-1.350869376,0.68018326,061-AAB,-0.335343058,45,27,72
8479,-1.350869376,0.68018326,061-AAC,-0.335343058,246,155,401
8480,-1.350869376,0.68018326,061-AAT,-0.335343058,145,88,233
8481,-1.350869376,0.68018326,061-AAU,-0.335343058,159,114,273
8482,-1.350869376,0.68018326,061-AAV,-0.335343058,110,90,200
8483,-1.350869376,0.68018326,061-AAW,-0.335343058,146,118,264
8484,-1.350869376,0.68018326,061-AAD,-0.335343058,147,80,227
8485,-1.350869376,0.68018326,061-AAF,-0.335343058,156,89,245
8486,-1.350869376,0.68018326,061-AAG,-0.335343058,40,27,67
8487,-1.350869376,0.68018326,061-AAR,-0.335343058,175,113,288
8488,-1.350869376,0.68018326,061-AAH,-0.335343058,85,58,143
8489,-1.350869376,0.68018326,061-AAI,-0.335343058,113,114,227
8490,-1.350869376,0.68018326,061-AAJ,-0.335343058,125,88,213
8491,-1.350869376,0.68018326,061-AAK,-0.335343058,60,26,86
8492,-1.350869376,0.68018326,061-AAP,-0.335343058,186,142,328
8493,-1.350869376,0.68018326,061-AAL,-0.335343058,134,75,209
8494,-1.350869376,0.68018326,061-AAQ,-0.335343058,267,228,495
8495,-1.350869376,0.68018326,061-AAS,-0.335343058,262,157,419
8496,-1.350869376,0.68018326,061-AAE,-0.335343058,44,35,79
8497,-1.350869376,0.68018326,061-AAX,-0.335343058,185,97,282
8498,-1.350869376,0.68018326,061-AAY,-0.335343058,95,71,166
8499,-1.350869376,0.68018326,061-AAZ,-0.335343058,68,96,164
8500,-1.350869376,0.68018326,061-AAM,-0.335343058,40,44,84
8501,-1.350869376,0.68018326,061-ABA,-0.335343058,166,104,270
8502,-1.350869376,0.68018326,062-AAA,-0.335343058,117,251,368
8503,-1.350869376,0.68018326,062-AAC,-0.335343058,184,143,327
8504,-1.350869376,0.68018326,062-AAD,-0.335343058,103,188,291
8505,-1.350869376,0.68018326,062-AAF,-0.335343058,204,304,508
8506,-1.350869376,0.68018326,062-AAH,-0.335343058,116,232,348
8507,-1.350869376,0.68018326,062-AAI,-0.335343058,154,237,391
8508,-1.350869376,0.68018326,062-AAL,-0.335343058,111,235,346
8509,-1.350869376,0.68018326,062-AAK,-0.335343058,123,213,336
8510,-1.350869376,0.68018326,062-AAR,-0.335343058,44,73,117
8511,-1.350869376,0.68018326,062-AAO,-0.335343058,325,319,644
8512,-1.350869376,0.68018326,062-AAM,-0.335343058,248,340,588
8513,-1.350869376,0.68018326,062-AAP,-0.335343058,305,429,734
8514,-1.350869376,0.68018326,062-AAT,-0.335343058,324,406,730
8515,-1.350869376,0.68018326,062-AAX,-0.335343058,47,108,155
8516,-1.350869376,0.68018326,062-AAU,-0.335343058,309,394,703
8517,-1.350869376,0.68018326,062-AAW,-0.335343058,264,296,560
8518,-1.350869376,0.68018326,062-AAY,-0.335343058,245,351,596
8519,-1.350869376,0.68018326,062-AAZ,-0.335343058,245,325,570
8520,-1.350869376,0.68018326,062-ABB,-0.335343058,305,173,478
8521,-1.350869376,0.68018326,062-ABC,-0.335343058,353,208,561
8522,-1.350869376,0.68018326,062-ABG,-0.335343058,393,290,683
8523,-1.350869376,0.68018326,062-ABF,-0.335343058,388,241,629
8524,-1.350869376,0.68018326,062-ABO,-0.335343058,251,381,632
8525,-1.350869376,0.68018326,062-ABP,-0.335343058,223,293,516
8526,-1.350869376,0.68018326,062-ABH,-0.335343058,350,337,687
8527,-1.350869376,0.68018326,062-ABL,-0.335343058,344,458,802
8528,-1.350869376,0.68018326,062-ACA,-0.335343058,296,274,570
8529,-1.350869376,0.68018326,062-ABT,-0.335343058,285,324,609
8530,-1.350869376,0.68018326,062-ABX,-0.335343058,305,270,575
8531,-1.350869376,0.68018326,062-ABW,-0.335343058,277,275,552
8532,-1.350869376,0.68018326,062-ABR,-0.335343058,325,307,632
8533,-1.350869376,0.68018326,062-ACC,-0.335343058,221,322,543
8534,-1.350869376,0.68018326,062-ACH,-0.335343058,215,240,455
8535,-1.350869376,0.68018326,062-ACJ,-0.335343058,158,168,326
8536,-1.350869376,0.68018326,062-ACE,-0.335343058,272,248,520
8537,-1.350869376,0.68018326,062-ACG,-0.335343058,249,194,443
8538,-1.350869376,0.68018326,062-ACL,-0.335343058,177,188,365
8539,-1.350869376,0.68018326,062-ACM,-0.335343058,145,191,336
8540,-1.350869376,0.68018326,062-ACQ,-0.335343058,274,260,534
8541,-1.350869376,0.68018326,062-ACV,-0.335343058,215,232,447
8542,-1.350869376,0.68018326,062-ACW,-0.335343058,234,308,542
8543,-1.350869376,0.68018326,062-ACY,-0.335343058,156,267,423
8544,-1.350869376,0.68018326,062-ACU,-0.335343058,355,411,766
8545,-1.350869376,0.68018326,062-ACS,-0.335343058,384,345,729
8546,-1.350869376,0.68018326,063-AAM,-0.335343058,355,394,749
8547,-1.350869376,0.68018326,063-AAB,-0.335343058,346,326,672
8548,-1.350869376,0.68018326,063-AAC,-0.335343058,260,125,385
8549,-1.350869376,0.68018326,063-AAE,-0.335343058,237,151,388
8550,-1.350869376,0.68018326,063-AAF,-0.335343058,380,270,650
8551,-1.350869376,0.68018326,063-AAG,-0.335343058,190,146,336
8552,-1.350869376,0.68018326,063-AAJ,-0.335343058,390,303,693
8553,-1.350869376,0.68018326,063-AAO,-0.335343058,363,293,656
8554,-1.350869376,0.68018326,063-AAP,-0.335343058,267,165,432
8555,-1.350869376,0.68018326,063-AAQ,-0.335343058,250,130,380
8556,-1.350869376,0.68018326,063-AAU,-0.335343058,325,219,544
8557,-1.350869376,0.68018326,063-AAX,-0.335343058,311,177,488
8558,-1.350869376,0.68018326,063-AAY,-0.335343058,403,251,654
8559,-1.350869376,0.68018326,063-ABD,-0.335343058,323,266,589
8560,-1.350869376,0.68018326,063-ABE,-0.335343058,238,299,537
8561,-1.350869376,0.68018326,063-AAV,-0.335343058,196,232,428
8562,-1.350869376,0.68018326,063-AAR,-0.335343058,246,300,546
8563,-1.350869376,0.68018326,063-ABG,-0.335343058,237,118,355
8564,-1.350869376,0.68018326,064-AAA,-0.335343058,193,199,392
8565,-1.350869376,0.68018326,064-AAB,-0.335343058,117,115,232
8566,-1.350869376,0.68018326,064-ABT,-0.335343058,334,170,504
8567,-1.350869376,0.68018326,064-AAE,-0.335343058,50,62,112
8568,-1.350869376,0.68018326,064-AAU,-0.335343058,87,148,235
8569,-1.350869376,0.68018326,064-AAJ,-0.335343058,79,129,208
8570,-1.350869376,0.68018326,064-AAK,-0.335343058,135,177,312
8571,-1.350869376,0.68018326,064-AAL,-0.335343058,101,234,335
8572,-1.350869376,0.68018326,064-AAN,-0.335343058,50,33,83
8573,-1.350869376,0.68018326,064-AAI,-0.335343058,161,165,326
8574,-1.350869376,0.68018326,064-ABF,-0.335343058,27,43,70
8575,-1.350869376,0.68018326,064-AAM,-0.335343058,265,114,379
8576,-1.350869376,0.68018326,064-AAO,-0.335343058,400,204,604
8577,-1.350869376,0.68018326,064-AAP,-0.335343058,223,229,452
8578,-1.350869376,0.68018326,064-AAR,-0.335343058,280,182,462
8579,-1.350869376,0.68018326,064-AAQ,-0.335343058,132,153,285
8580,-1.350869376,0.68018326,064-AAS,-0.335343058,318,186,504
8581,-1.350869376,0.68018326,064-AAG,-0.335343058,164,225,389
8582,-1.350869376,0.68018326,064-AAT,-0.335343058,189,99,288
8583,-1.350869376,0.68018326,064-AAV,-0.335343058,180,197,377
8584,-1.350869376,0.68018326,064-ABM,-0.335343058,101,207,308
8585,-1.350869376,0.68018326,064-ABN,-0.335343058,109,164,273
8586,-1.350869376,0.68018326,064-ABO,-0.335343058,125,180,305
8587,-1.350869376,0.68018326,064-ABP,-0.335343058,55,73,128
8588,-1.350869376,0.68018326,064-ABQ,-0.335343058,85,125,210
8589,-1.350869376,0.68018326,064-ABR,-0.335343058,125,137,262
8590,-1.350869376,0.68018326,064-ABS,-0.335343058,96,133,229
8591,-1.350869376,0.68018326,064-AAF,-0.335343058,107,149,256
8592,-1.350869376,0.68018326,064-AAX,-0.335343058,151,212,363
8593,-1.350869376,0.68018326,064-AAY,-0.335343058,313,352,665
8594,-1.350869376,0.68018326,064-AAZ,-0.335343058,204,226,430
8595,-1.350869376,0.68018326,064-ABA,-0.335343058,246,172,418
8596,-1.350869376,0.68018326,064-ABB,-0.335343058,268,161,429
8597,-1.350869376,0.68018326,064-ABC,-0.335343058,335,206,541
8598,-1.350869376,0.68018326,064-AAC,-0.335343058,142,154,296
8599,-1.350869376,0.68018326,064-AAD,-0.335343058,161,184,345
8600,-1.350869376,0.68018326,064-AAW,-0.335343058,2,9,11
8601,-1.350869376,0.68018326,064-AAH,-0.335343058,142,172,314
8602,-1.350869376,0.68018326,064-ABG,-0.335343058,74,111,185
8603,-1.350869376,0.68018326,064-ABH,-0.335343058,86,157,243
8604,-1.350869376,0.68018326,064-ABD,-0.335343058,179,113,292
8605,-1.350869376,0.68018326,064-ABE,-0.335343058,160,174,334
8606,-1.350869376,0.68018326,064-ABI,-0.335343058,350,174,524
8607,-1.350869376,0.68018326,064-ABU,-0.335343058,153,131,284
8608,-1.350869376,0.68018326,064-ABK,-0.335343058,156,120,276
8609,-1.350869376,0.68018326,064-ABJ,-0.335343058,311,201,512
8610,-1.350869376,0.68018326,065-ABA,-0.335343058,248,160,408
8611,-1.350869376,0.68018326,065-ABB,-0.335343058,543,281,824
8612,-1.350869376,0.68018326,065-ABC,-0.335343058,206,133,339
8613,-1.350869376,0.68018326,065-AAA,-0.335343058,379,275,654
8614,-1.350869376,0.68018326,065-AAB,-0.335343058,187,182,369
8615,-1.350869376,0.68018326,065-AAC,-0.335343058,422,247,669
8616,-1.350869376,0.68018326,065-AAD,-0.335343058,253,185,438
8617,-1.350869376,0.68018326,065-AAE,-0.335343058,145,134,279
8618,-1.350869376,0.68018326,065-AAF,-0.335343058,248,195,443
8619,-1.350869376,0.68018326,065-AAG,-0.335343058,239,149,388
8620,-1.350869376,0.68018326,065-AAH,-0.335343058,180,191,371
8621,-1.350869376,0.68018326,065-AAI,-0.335343058,232,157,389
8622,-1.350869376,0.68018326,065-AAJ,-0.335343058,125,87,212
8623,-1.350869376,0.68018326,065-AAK,-0.335343058,107,129,236
8624,-1.350869376,0.68018326,065-AAL,-0.335343058,99,102,201
8625,-1.350869376,0.68018326,065-AAM,-0.335343058,95,133,228
8626,-1.350869376,0.68018326,065-AAN,-0.335343058,164,151,315
8627,-1.350869376,0.68018326,065-AAO,-0.335343058,101,157,258
8628,-1.350869376,0.68018326,065-AAP,-0.335343058,177,100,277
8629,-1.350869376,0.68018326,065-AAQ,-0.335343058,218,113,331
8630,-1.350869376,0.68018326,065-AAR,-0.335343058,374,238,612
8631,-1.350869376,0.68018326,065-AAS,-0.335343058,340,167,507
8632,-1.350869376,0.68018326,065-AAT,-0.335343058,357,204,561
8633,-1.350869376,0.68018326,065-AAU,-0.335343058,302,128,430
8634,-1.350869376,0.68018326,065-AAV,-0.335343058,182,153,335
8635,-1.350869376,0.68018326,065-AAX,-0.335343058,406,282,688
8636,-1.350869376,0.68018326,065-AAY,-0.335343058,417,309,726
8637,-1.350869376,0.68018326,065-AAW,-0.335343058,183,186,369
8638,-1.350869376,0.68018326,065-ABQ,-0.335343058,404,227,631
8639,-1.350869376,0.68018326,065-ABI,-0.335343058,269,146,415
8640,-1.350869376,0.68018326,065-ABD,-0.335343058,372,188,560
8641,-1.350869376,0.68018326,065-ACA,-0.335343058,442,225,667
8642,-1.350869376,0.68018326,065-ABG,-0.335343058,403,200,603
8643,-1.350869376,0.68018326,065-ABJ,-0.335343058,135,115,250
8644,-1.350869376,0.68018326,065-ABK,-0.335343058,143,118,261
8645,-1.350869376,0.68018326,065-ABL,-0.335343058,415,246,661
8646,-1.350869376,0.68018326,065-ABM,-0.335343058,279,176,455
8647,-1.350869376,0.68018326,065-ABN,-0.335343058,313,254,567
8648,-1.350869376,0.68018326,065-ABO,-0.335343058,382,286,668
8649,-1.350869376,0.68018326,065-ACC,-0.335343058,358,177,535
8650,-1.350869376,0.68018326,065-ACB,-0.335343058,533,398,931
8651,-1.350869376,0.68018326,065-ABT,-0.335343058,474,257,731
8652,-1.350869376,0.68018326,065-ABU,-0.335343058,511,245,756
8653,-1.350869376,0.68018326,065-ABV,-0.335343058,519,253,772
8654,-1.350869376,0.68018326,065-ABW,-0.335343058,361,138,499
8655,-1.350869376,0.68018326,065-ABX,-0.335343058,436,195,631
8656,-1.350869376,0.68018326,065-ABY,-0.335343058,399,208,607
8657,-1.350869376,0.68018326,065-ABZ,-0.335343058,151,97,248
8658,-1.350869376,0.68018326,066-AAH,-0.335343058,274,265,539
8659,-1.350869376,0.68018326,066-AAI,-0.335343058,89,69,158
8660,-1.350869376,0.68018326,066-AAJ,-0.335343058,325,404,729
8661,-1.350869376,0.68018326,066-AAK,-0.335343058,160,224,384
8662,-1.350869376,0.68018326,066-AAL,-0.335343058,93,211,304
8663,-1.350869376,0.68018326,066-AAN,-0.335343058,222,224,446
8664,-1.350869376,0.68018326,066-AAO,-0.335343058,210,230,440
8665,-1.350869376,0.68018326,066-AAP,-0.335343058,466,365,831
8666,-1.350869376,0.68018326,066-AAQ,-0.335343058,494,465,959
8667,-1.350869376,0.68018326,066-AAR,-0.335343058,839,717,1556
8668,-1.350869376,0.68018326,066-AAS,-0.335343058,126,149,275
8669,-1.350869376,0.68018326,066-AAX,-0.335343058,422,424,846
8670,-1.350869376,0.68018326,066-AAT,-0.335343058,270,264,534
8671,-1.350869376,0.68018326,066-AAU,-0.335343058,227,272,499
8672,-1.350869376,0.68018326,066-AAV,-0.335343058,289,250,539
8673,-1.350869376,0.68018326,066-AAW,-0.335343058,333,293,626
8674,-1.350869376,0.68018326,066-AAA,-0.335343058,234,168,402
8675,-1.350869376,0.68018326,066-AAB,-0.335343058,144,129,273
8676,-1.350869376,0.68018326,066-AAC,-0.335343058,223,227,450
8677,-1.350869376,0.68018326,066-AAD,-0.335343058,100,107,207
8678,-1.350869376,0.68018326,066-AAE,-0.335343058,108,98,206
8679,-1.350869376,0.68018326,066-AAF,-0.335343058,146,143,289
8680,-1.350869376,0.68018326,066-AAG,-0.335343058,193,204,397
8681,-1.350869376,0.68018326,066-AAM,-0.335343058,175,131,306
8682,-1.350869376,0.68018326,067-ACQ,-0.335343058,337,271,608
8683,-1.350869376,0.68018326,067-ACR,-0.335343058,353,287,640
8684,-1.350869376,0.68018326,067-AAA,-0.335343058,165,232,397
8685,-1.350869376,0.68018326,067-AAB,-0.335343058,279,203,482
8686,-1.350869376,0.68018326,067-AAC,-0.335343058,445,289,734
8687,-1.350869376,0.68018326,067-AAD,-0.335343058,369,276,645
8688,-1.350869376,0.68018326,067-AAE,-0.335343058,328,178,506
8689,-1.350869376,0.68018326,067-AAF,-0.335343058,324,274,598
8690,-1.350869376,0.68018326,067-AGN,-0.335343058,443,335,778
8691,-1.350869376,0.68018326,067-AAG,-0.335343058,482,297,779
8692,-1.350869376,0.68018326,067-AAH,-0.335343058,531,362,893
8693,-1.350869376,0.68018326,067-AAJ,-0.335343058,328,235,563
8694,-1.350869376,0.68018326,067-AAK,-0.335343058,304,158,462
8695,-1.350869376,0.68018326,067-AAL,-0.335343058,429,266,695
8696,-1.350869376,0.68018326,067-AAM,-0.335343058,435,294,729
8697,-1.350869376,0.68018326,067-AAN,-0.335343058,373,303,676
8698,-1.350869376,0.68018326,067-ADL,-0.335343058,91,160,251
8699,-1.350869376,0.68018326,067-ACT,-0.335343058,314,422,736
8700,-1.350869376,0.68018326,067-ACU,-0.335343058,287,421,708
8701,-1.350869376,0.68018326,067-ACV,-0.335343058,436,535,971
8702,-1.350869376,0.68018326,067-ACW,-0.335343058,334,287,621
8703,-1.350869376,0.68018326,067-ACX,-0.335343058,402,362,764
8704,-1.350869376,0.68018326,067-ACY,-0.335343058,339,413,752
8705,-1.350869376,0.68018326,067-ACZ,-0.335343058,309,301,610
8706,-1.350869376,0.68018326,067-ADE,-0.335343058,210,201,411
8707,-1.350869376,0.68018326,067-ADF,-0.335343058,136,212,348
8708,-1.350869376,0.68018326,067-ADG,-0.335343058,262,248,510
8709,-1.350869376,0.68018326,067-ADH,-0.335343058,380,323,703
8710,-1.350869376,0.68018326,067-ADJ,-0.335343058,362,334,696
8711,-1.350869376,0.68018326,067-ADK,-0.335343058,388,276,664
8712,-1.350869376,0.68018326,067-ADM,-0.335343058,258,288,546
8713,-1.350869376,0.68018326,067-ADN,-0.335343058,299,463,762
8714,-1.350869376,0.68018326,067-ADO,-0.335343058,231,330,561
8715,-1.350869376,0.68018326,067-ADP,-0.335343058,142,343,485
8716,-1.350869376,0.68018326,067-ADQ,-0.335343058,204,384,588
8717,-1.350869376,0.68018326,067-ADU,-0.335343058,308,331,639
8718,-1.350869376,0.68018326,067-ADV,-0.335343058,329,363,692
8719,-1.350869376,0.68018326,067-ADX,-0.335343058,345,347,692
8720,-1.350869376,0.68018326,067-ADY,-0.335343058,231,284,515
8721,-1.350869376,0.68018326,067-AEA,-0.335343058,349,350,699
8722,-1.350869376,0.68018326,067-AEB,-0.335343058,425,293,718
8723,-1.350869376,0.68018326,067-ADZ,-0.335343058,128,383,511
8724,-1.350869376,0.68018326,067-AAO,-0.335343058,276,547,823
8725,-1.350869376,0.68018326,067-AAP,-0.335343058,129,475,604
8726,-1.350869376,0.68018326,067-AAQ,-0.335343058,131,346,477
8727,-1.350869376,0.68018326,067-AGJ,-0.335343058,190,408,598
8728,-1.350869376,0.68018326,067-AAT,-0.335343058,278,514,792
8729,-1.350869376,0.68018326,067-AAU,-0.335343058,179,395,574
8730,-1.350869376,0.68018326,067-AAV,-0.335343058,184,414,598
8731,-1.350869376,0.68018326,067-AAW,-0.335343058,134,406,540
8732,-1.350869376,0.68018326,067-AAZ,-0.335343058,113,442,555
8733,-1.350869376,0.68018326,067-ABA,-0.335343058,111,347,458
8734,-1.350869376,0.68018326,067-ABB,-0.335343058,90,256,346
8735,-1.350869376,0.68018326,067-ABC,-0.335343058,103,269,372
8736,-1.350869376,0.68018326,067-ABE,-0.335343058,188,602,790
8737,-1.350869376,0.68018326,067-AGK,-0.335343058,58,242,300
8738,-1.350869376,0.68018326,067-ABG,-0.335343058,94,328,422
8739,-1.350869376,0.68018326,067-ABH,-0.335343058,105,331,436
8740,-1.350869376,0.68018326,067-AGL,-0.335343058,187,751,938
8741,-1.350869376,0.68018326,067-ABJ,-0.335343058,90,300,390
8742,-1.350869376,0.68018326,067-ABK,-0.335343058,139,412,551
8743,-1.350869376,0.68018326,067-ABL,-0.335343058,98,231,329
8744,-1.350869376,0.68018326,067-AGM,-0.335343058,136,475,611
8745,-1.350869376,0.68018326,067-AED,-0.335343058,388,281,669
8746,-1.350869376,0.68018326,067-AEE,-0.335343058,374,317,691
8747,-1.350869376,0.68018326,067-AEF,-0.335343058,324,282,606
8748,-1.350869376,0.68018326,067-AEG,-0.335343058,353,216,569
8749,-1.350869376,0.68018326,067-AEJ,-0.335343058,257,251,508
8750,-1.350869376,0.68018326,067-AEL,-0.335343058,272,246,518
8751,-1.350869376,0.68018326,067-AEN,-0.335343058,308,335,643
8752,-1.350869376,0.68018326,067-AEO,-0.335343058,342,304,646
8753,-1.350869376,0.68018326,067-AEQ,-0.335343058,251,162,413
8754,-1.350869376,0.68018326,067-AER,-0.335343058,286,256,542
8755,-1.350869376,0.68018326,067-AGP,-0.335343058,258,248,506
8756,-1.350869376,0.68018326,067-AET,-0.335343058,219,218,437
8757,-1.350869376,0.68018326,067-AEU,-0.335343058,207,236,443
8758,-1.350869376,0.68018326,067-AEV,-0.335343058,325,352,677
8759,-1.350869376,0.68018326,067-AEW,-0.335343058,345,269,614
8760,-1.350869376,0.68018326,067-AEX,-0.335343058,358,339,697
8761,-1.350869376,0.68018326,067-AEY,-0.335343058,374,321,695
8762,-1.350869376,0.68018326,067-ABN,-0.335343058,169,311,480
8763,-1.350869376,0.68018326,067-ABO,-0.335343058,127,283,410
8764,-1.350869376,0.68018326,067-ABQ,-0.335343058,141,274,415
8765,-1.350869376,0.68018326,067-ABR,-0.335343058,261,364,625
8766,-1.350869376,0.68018326,067-ABS,-0.335343058,177,302,479
8767,-1.350869376,0.68018326,067-ABV,-0.335343058,172,295,467
8768,-1.350869376,0.68018326,067-ABW,-0.335343058,205,288,493
8769,-1.350869376,0.68018326,067-ABX,-0.335343058,244,437,681
8770,-1.350869376,0.68018326,067-ACA,-0.335343058,136,277,413
8771,-1.350869376,0.68018326,067-ACB,-0.335343058,268,367,635
8772,-1.350869376,0.68018326,067-AFB,-0.335343058,275,315,590
8773,-1.350869376,0.68018326,067-AFC,-0.335343058,168,380,548
8774,-1.350869376,0.68018326,067-AFD,-0.335343058,174,302,476
8775,-1.350869376,0.68018326,067-AFE,-0.335343058,205,288,493
8776,-1.350869376,0.68018326,067-AFF,-0.335343058,315,439,754
8777,-1.350869376,0.68018326,067-AFG,-0.335343058,241,373,614
8778,-1.350869376,0.68018326,067-AFH,-0.335343058,387,368,755
8779,-1.350869376,0.68018326,067-AFL,-0.335343058,435,463,898
8780,-1.350869376,0.68018326,067-AFM,-0.335343058,291,279,570
8781,-1.350869376,0.68018326,067-AFN,-0.335343058,260,276,536
8782,-1.350869376,0.68018326,067-AFO,-0.335343058,189,229,418
8783,-1.350869376,0.68018326,067-AFP,-0.335343058,350,226,576
8784,-1.350869376,0.68018326,067-AFQ,-0.335343058,346,281,627
8785,-1.350869376,0.68018326,067-AFR,-0.335343058,374,350,724
8786,-1.350869376,0.68018326,067-AFS,-0.335343058,317,327,644
8787,-1.350869376,0.68018326,067-AFT,-0.335343058,330,257,587
8788,-1.350869376,0.68018326,067-AFU,-0.335343058,271,294,565
8789,-1.350869376,0.68018326,067-AFV,-0.335343058,387,345,732
8790,-1.350869376,0.68018326,067-ACD,-0.335343058,213,264,477
8791,-1.350869376,0.68018326,067-ACE,-0.335343058,243,327,570
8792,-1.350869376,0.68018326,067-AGQ,-0.335343058,230,333,563
8793,-1.350869376,0.68018326,067-AGS,-0.335343058,293,325,618
8794,-1.350869376,0.68018326,067-ACG,-0.335343058,319,481,800
8795,-1.350869376,0.68018326,067-ACH,-0.335343058,168,305,473
8796,-1.350869376,0.68018326,067-ACI,-0.335343058,308,448,756
8797,-1.350869376,0.68018326,067-ACK,-0.335343058,177,255,432
8798,-1.350869376,0.68018326,067-ACL,-0.335343058,328,326,654
8799,-1.350869376,0.68018326,067-AGR,-0.335343058,270,327,597
8800,-1.350869376,0.68018326,067-ACN,-0.335343058,268,223,491
8801,-1.350869376,0.68018326,067-ACO,-0.335343058,283,318,601
8802,-1.350869376,0.68018326,067-ACP,-0.335343058,212,309,521
8803,-1.350869376,0.68018326,067-AFX,-0.335343058,376,322,698
8804,-1.350869376,0.68018326,067-AFY,-0.335343058,366,292,658
8805,-1.350869376,0.68018326,067-AFZ,-0.335343058,413,264,677
8806,-1.350869376,0.68018326,067-AGA,-0.335343058,349,315,664
8807,-1.350869376,0.68018326,067-AGB,-0.335343058,356,330,686
8808,-1.350869376,0.68018326,067-AGE,-0.335343058,72,77,149
8809,-1.350869376,0.68018326,067-AGF,-0.335343058,199,173,372
8810,-1.350869376,0.68018326,067-AGG,-0.335343058,205,264,469
8811,-1.350869376,0.68018326,067-AGH,-0.335343058,114,231,345
8812,-1.350869376,0.68018326,067-AGI,-0.335343058,167,319,486
8813,-1.350869376,0.68018326,068-ABM,-0.335343058,154,83,237
8814,-1.350869376,0.68018326,068-ABN,-0.335343058,220,123,343
8815,-1.350869376,0.68018326,068-ABO,-0.335343058,140,126,266
8816,-1.350869376,0.68018326,068-AAV,-0.335343058,153,63,216
8817,-1.350869376,0.68018326,068-AAI,-0.335343058,201,102,303
8818,-1.350869376,0.68018326,068-AAA,-0.335343058,291,168,459
8819,-1.350869376,0.68018326,068-AAB,-0.335343058,347,191,538
8820,-1.350869376,0.68018326,068-AAC,-0.335343058,225,122,347
8821,-1.350869376,0.68018326,068-AAD,-0.335343058,389,234,623
8822,-1.350869376,0.68018326,068-AAE,-0.335343058,225,183,408
8823,-1.350869376,0.68018326,068-AAF,-0.335343058,215,143,358
8824,-1.350869376,0.68018326,068-AAG,-0.335343058,334,254,588
8825,-1.350869376,0.68018326,068-AAH,-0.335343058,293,213,506
8826,-1.350869376,0.68018326,068-ABH,-0.335343058,158,96,254
8827,-1.350869376,0.68018326,068-AAJ,-0.335343058,192,82,274
8828,-1.350869376,0.68018326,068-AAK,-0.335343058,599,299,898
8829,-1.350869376,0.68018326,068-AAL,-0.335343058,558,284,842
8830,-1.350869376,0.68018326,068-AAN,-0.335343058,490,242,732
8831,-1.350869376,0.68018326,068-AAO,-0.335343058,308,139,447
8832,-1.350869376,0.68018326,068-AAM,-0.335343058,274,165,439
8833,-1.350869376,0.68018326,068-AAQ,-0.335343058,414,168,582
8834,-1.350869376,0.68018326,068-AAS,-0.335343058,321,154,475
8835,-1.350869376,0.68018326,068-AAW,-0.335343058,307,138,445
8836,-1.350869376,0.68018326,068-AAX,-0.335343058,377,213,590
8837,-1.350869376,0.68018326,068-AAY,-0.335343058,372,159,531
8838,-1.350869376,0.68018326,068-AAZ,-0.335343058,221,119,340
8839,-1.350869376,0.68018326,068-ABC,-0.335343058,276,134,410
8840,-1.350869376,0.68018326,068-ABD,-0.335343058,489,164,653
8841,-1.350869376,0.68018326,068-ABE,-0.335343058,260,105,365
8842,-1.350869376,0.68018326,068-AAT,-0.335343058,335,184,519
8843,-1.350869376,0.68018326,068-AAU,-0.335343058,243,120,363
8844,-1.350869376,0.68018326,068-ABG,-0.335343058,410,161,571
8845,-1.350869376,0.68018326,068-ABA,-0.335343058,173,129,302
8846,-1.350869376,0.68018326,068-ABB,-0.335343058,178,167,345
8847,-1.350869376,0.68018326,068-ABK,-0.335343058,335,163,498
8848,-1.350869376,0.68018326,068-ABL,-0.335343058,360,126,486
8849,-1.350869376,0.68018326,068-ABP,-0.335343058,414,156,570
8850,-1.350869376,0.68018326,068-ABQ,-0.335343058,402,187,589
8851,-1.350869376,0.68018326,068-AAR,-0.335343058,287,103,390
8852,-1.350869376,0.68018326,068-ABS,-0.335343058,317,133,450
8853,-1.350869376,0.68018326,068-ABT,-0.335343058,408,168,576
8854,-1.350869376,0.68018326,068-ABR,-0.335343058,152,106,258
8855,-1.350869376,0.68018326,068-ABF,-0.335343058,250,172,422
8856,-1.350869376,0.68018326,068-AAP,-0.335343058,381,181,562
8857,-1.350869376,0.68018326,068-ABI,-0.335343058,114,77,191
8858,-1.350869376,0.68018326,069-AAB,-0.335343058,562,144,706
8859,-1.350869376,0.68018326,069-ABH,-0.335343058,458,214,672
8860,-1.350869376,0.68018326,069-ABJ,-0.335343058,280,82,362
8861,-1.350869376,0.68018326,069-AAM,-0.335343058,279,219,498
8862,-1.350869376,0.68018326,069-AAS,-0.335343058,407,165,572
8863,-1.350869376,0.68018326,069-AAC,-0.335343058,611,186,797
8864,-1.350869376,0.68018326,069-AAF,-0.335343058,393,138,531
8865,-1.350869376,0.68018326,069-AAG,-0.335343058,343,118,461
8866,-1.350869376,0.68018326,069-AAH,-0.335343058,444,197,641
8867,-1.350869376,0.68018326,069-ABR,-0.335343058,525,187,712
8868,-1.350869376,0.68018326,069-ABW,-0.335343058,265,157,422
8869,-1.350869376,0.68018326,069-ABX,-0.335343058,233,190,423
8870,-1.350869376,0.68018326,069-AAK,-0.335343058,273,136,409
8871,-1.350869376,0.68018326,069-AAL,-0.335343058,295,102,397
8872,-1.350869376,0.68018326,069-AAN,-0.335343058,380,149,529
8873,-1.350869376,0.68018326,069-AAO,-0.335343058,432,226,658
8874,-1.350869376,0.68018326,069-AAU,-0.335343058,338,177,515
8875,-1.350869376,0.68018326,069-AAV,-0.335343058,340,200,540
8876,-1.350869376,0.68018326,069-AAX,-0.335343058,205,139,344
8877,-1.350869376,0.68018326,069-AAY,-0.335343058,270,162,432
8878,-1.350869376,0.68018326,069-AAZ,-0.335343058,286,117,403
8879,-1.350869376,0.68018326,069-AAQ,-0.335343058,288,126,414
8880,-1.350869376,0.68018326,069-AAR,-0.335343058,327,123,450
8881,-1.350869376,0.68018326,069-AAT,-0.335343058,413,135,548
8882,-1.350869376,0.68018326,069-AAP,-0.335343058,359,191,550
8883,-1.350869376,0.68018326,069-ABA,-0.335343058,421,184,605
8884,-1.350869376,0.68018326,069-ABM,-0.335343058,452,192,644
8885,-1.350869376,0.68018326,069-ABE,-0.335343058,361,161,522
8886,-1.350869376,0.68018326,069-ABF,-0.335343058,312,63,375
8887,-1.350869376,0.68018326,069-ABG,-0.335343058,511,98,609
8888,-1.350869376,0.68018326,069-ABK,-0.335343058,510,123,633
8889,-1.350869376,0.68018326,069-ABO,-0.335343058,530,147,677
8890,-1.350869376,0.68018326,069-ABQ,-0.335343058,360,110,470
8891,-1.350869376,0.68018326,069-ABS,-0.335343058,335,98,433
8892,-1.350869376,0.68018326,069-ABT,-0.335343058,274,125,399
8893,-1.350869376,0.68018326,070-ACH,-0.335343058,253,140,393
8894,-1.350869376,0.68018326,070-ACI,-0.335343058,224,91,315
8895,-1.350869376,0.68018326,070-ACK,-0.335343058,357,191,548
8896,-1.350869376,0.68018326,070-ACL,-0.335343058,550,278,828
8897,-1.350869376,0.68018326,070-ACN,-0.335343058,423,258,681
8898,-1.350869376,0.68018326,070-ACO,-0.335343058,493,224,717
8899,-1.350869376,0.68018326,070-ACQ,-0.335343058,448,234,682
8900,-1.350869376,0.68018326,070-ACR,-0.335343058,636,281,917
8901,-1.350869376,0.68018326,070-ACS,-0.335343058,313,147,460
8902,-1.350869376,0.68018326,070-ACT,-0.335343058,469,182,651
8903,-1.350869376,0.68018326,070-AEI,-0.335343058,576,315,891
8904,-1.350869376,0.68018326,070-AEJ,-0.335343058,500,185,685
8905,-1.350869376,0.68018326,070-AEK,-0.335343058,229,126,355
8906,-1.350869376,0.68018326,070-AEL,-0.335343058,466,286,752
8907,-1.350869376,0.68018326,070-ACU,-0.335343058,227,169,396
8908,-1.350869376,0.68018326,070-ACV,-0.335343058,34,16,50
8909,-1.350869376,0.68018326,070-ACW,-0.335343058,291,189,480
8910,-1.350869376,0.68018326,070-ACY,-0.335343058,370,336,706
8911,-1.350869376,0.68018326,070-ACZ,-0.335343058,244,137,381
8912,-1.350869376,0.68018326,070-ADA,-0.335343058,342,240,582
8913,-1.350869376,0.68018326,070-ADB,-0.335343058,172,173,345
8914,-1.350869376,0.68018326,070-ADC,-0.335343058,233,163,396
8915,-1.350869376,0.68018326,070-ADD,-0.335343058,274,204,478
8916,-1.350869376,0.68018326,070-ADE,-0.335343058,235,223,458
8917,-1.350869376,0.68018326,070-ADG,-0.335343058,417,324,741
8918,-1.350869376,0.68018326,070-AAA,-0.335343058,315,386,701
8919,-1.350869376,0.68018326,070-AAD,-0.335343058,473,314,787
8920,-1.350869376,0.68018326,070-AAE,-0.335343058,357,262,619
8921,-1.350869376,0.68018326,070-AAF,-0.335343058,487,344,831
8922,-1.350869376,0.68018326,070-AAH,-0.335343058,445,169,614
8923,-1.350869376,0.68018326,070-AAI,-0.335343058,354,344,698
8924,-1.350869376,0.68018326,070-AAJ,-0.335343058,361,196,557
8925,-1.350869376,0.68018326,070-AEY,-0.335343058,266,144,410
8926,-1.350869376,0.68018326,070-AAK,-0.335343058,236,220,456
8927,-1.350869376,0.68018326,070-AAL,-0.335343058,241,324,565
8928,-1.350869376,0.68018326,070-AAN,-0.335343058,428,271,699
8929,-1.350869376,0.68018326,070-AAP,-0.335343058,364,266,630
8930,-1.350869376,0.68018326,070-AAQ,-0.335343058,232,268,500
8931,-1.350869376,0.68018326,070-AAR,-0.335343058,301,245,546
8932,-1.350869376,0.68018326,070-AAS,-0.335343058,349,256,605
8933,-1.350869376,0.68018326,070-AAW,-0.335343058,418,470,888
8934,-1.350869376,0.68018326,070-AAX,-0.335343058,226,324,550
8935,-1.350869376,0.68018326,070-AAY,-0.335343058,431,316,747
8936,-1.350869376,0.68018326,070-ABA,-0.335343058,379,301,680
8937,-1.350869376,0.68018326,070-ABB,-0.335343058,302,322,624
8938,-1.350869376,0.68018326,070-ABD,-0.335343058,280,402,682
8939,-1.350869376,0.68018326,070-ABF,-0.335343058,215,238,453
8940,-1.350869376,0.68018326,070-ABG,-0.335343058,132,316,448
8941,-1.350869376,0.68018326,070-ABH,-0.335343058,57,346,403
8942,-1.350869376,0.68018326,070-ABI,-0.335343058,93,222,315
8943,-1.350869376,0.68018326,070-ABJ,-0.335343058,96,533,629
8944,-1.350869376,0.68018326,070-ABL,-0.335343058,51,365,416
8945,-1.350869376,0.68018326,070-ABN,-0.335343058,109,472,581
8946,-1.350869376,0.68018326,070-ABO,-0.335343058,53,235,288
8947,-1.350869376,0.68018326,070-ABP,-0.335343058,170,251,421
8948,-1.350869376,0.68018326,070-ABQ,-0.335343058,106,319,425
8949,-1.350869376,0.68018326,070-ABR,-0.335343058,106,257,363
8950,-1.350869376,0.68018326,070-ABS,-0.335343058,336,356,692
8951,-1.350869376,0.68018326,070-ABT,-0.335343058,72,587,659
8952,-1.350869376,0.68018326,070-ABW,-0.335343058,166,306,472
8953,-1.350869376,0.68018326,070-ADH,-0.335343058,308,227,535
8954,-1.350869376,0.68018326,070-ADI,-0.335343058,398,246,644
8955,-1.350869376,0.68018326,070-ADJ,-0.335343058,322,254,576
8956,-1.350869376,0.68018326,070-ADK,-0.335343058,316,190,506
8957,-1.350869376,0.68018326,070-ADL,-0.335343058,293,209,502
8958,-1.350869376,0.68018326,070-ADM,-0.335343058,293,240,533
8959,-1.350869376,0.68018326,070-ADN,-0.335343058,529,255,784
8960,-1.350869376,0.68018326,070-ADP,-0.335343058,555,252,807
8961,-1.350869376,0.68018326,070-AFB,-0.335343058,426,351,777
8962,-1.350869376,0.68018326,070-AFD,-0.335343058,385,286,671
8963,-1.350869376,0.68018326,070-AFF,-0.335343058,564,367,931
8964,-1.350869376,0.68018326,070-AFH,-0.335343058,619,322,941
8965,-1.350869376,0.68018326,070-ADQ,-0.335343058,452,210,662
8966,-1.350869376,0.68018326,070-ADR,-0.335343058,324,192,516
8967,-1.350869376,0.68018326,070-ADS,-0.335343058,187,151,338
8968,-1.350869376,0.68018326,070-ADT,-0.335343058,327,249,576
8969,-1.350869376,0.68018326,070-ADU,-0.335343058,356,174,530
8970,-1.350869376,0.68018326,070-ABX,-0.335343058,420,339,759
8971,-1.350869376,0.68018326,070-ABY,-0.335343058,250,149,399
8972,-1.350869376,0.68018326,070-ACA,-0.335343058,242,210,452
8973,-1.350869376,0.68018326,070-ACB,-0.335343058,329,214,543
8974,-1.350869376,0.68018326,070-ACC,-0.335343058,221,198,419
8975,-1.350869376,0.68018326,070-ACD,-0.335343058,166,123,289
8976,-1.350869376,0.68018326,070-ACE,-0.335343058,518,356,874
8977,-1.350869376,0.68018326,070-ACF,-0.335343058,436,232,668
8978,-1.350869376,0.68018326,070-ADV,-0.335343058,330,170,500
8979,-1.350869376,0.68018326,070-ADW,-0.335343058,651,299,950
8980,-1.350869376,0.68018326,070-ADX,-0.335343058,403,281,684
8981,-1.350869376,0.68018326,070-ADY,-0.335343058,417,211,628
8982,-1.350869376,0.68018326,070-AEF,-0.335343058,486,238,724
8983,-1.350869376,0.68018326,070-AEG,-0.335343058,585,303,888
8984,-1.350869376,0.68018326,070-AEM,-0.335343058,381,240,621
8985,-1.350869376,0.68018326,070-AEN,-0.335343058,274,162,436
8986,-1.350869376,0.68018326,070-AEO,-0.335343058,487,267,754
8987,-1.350869376,0.68018326,070-AEP,-0.335343058,431,208,639
8988,-1.350869376,0.68018326,070-AEQ,-0.335343058,343,168,511
8989,-1.350869376,0.68018326,070-AER,-0.335343058,291,124,415
8990,-1.350869376,0.68018326,070-AFA,-0.335343058,376,138,514
8991,-1.350869376,0.68018326,070-AET,-0.335343058,652,323,975
8992,-1.350869376,0.68018326,070-AEV,-0.335343058,309,228,537
8993,-1.350869376,0.68018326,070-AEX,-0.335343058,291,153,444
8994,-1.350869376,0.68018326,070-AEW,-0.335343058,308,159,467
8995,-1.350869376,0.68018326,071-ABE,-0.335343058,222,145,367
8996,-1.350869376,0.68018326,071-ABF,-0.335343058,168,181,349
8997,-1.350869376,0.68018326,071-ABG,-0.335343058,39,53,92
8998,-1.350869376,0.68018326,071-AAA,-0.335343058,209,172,381
8999,-1.350869376,0.68018326,071-AAB,-0.335343058,276,193,469
9000,-1.350869376,0.68018326,071-AAC,-0.335343058,339,255,594
9001,-1.350869376,0.68018326,071-AAD,-0.335343058,255,187,442
9002,-1.350869376,0.68018326,071-AAE,-0.335343058,203,209,412
9003,-1.350869376,0.68018326,071-AAG,-0.335343058,78,122,200
9004,-1.350869376,0.68018326,071-AAH,-0.335343058,254,249,503
9005,-1.350869376,0.68018326,071-AAI,-0.335343058,184,228,412
9006,-1.350869376,0.68018326,071-AAJ,-0.335343058,279,220,499
9007,-1.350869376,0.68018326,071-AAK,-0.335343058,284,275,559
9008,-1.350869376,0.68018326,071-AAL,-0.335343058,173,204,377
9009,-1.350869376,0.68018326,071-AAM,-0.335343058,143,264,407
9010,-1.350869376,0.68018326,071-AAN,-0.335343058,80,90,170
9011,-1.350869376,0.68018326,071-AAO,-0.335343058,197,217,414
9012,-1.350869376,0.68018326,071-AAP,-0.335343058,101,87,188
9013,-1.350869376,0.68018326,071-AAQ,-0.335343058,112,166,278
9014,-1.350869376,0.68018326,071-AAR,-0.335343058,107,184,291
9015,-1.350869376,0.68018326,071-AAS,-0.335343058,61,126,187
9016,-1.350869376,0.68018326,071-AAT,-0.335343058,155,212,367
9017,-1.350869376,0.68018326,071-AAU,-0.335343058,64,78,142
9018,-1.350869376,0.68018326,071-AAV,-0.335343058,151,201,352
9019,-1.350869376,0.68018326,071-AAW,-0.335343058,42,108,150
9020,-1.350869376,0.68018326,071-AAX,-0.335343058,181,109,290
9021,-1.350869376,0.68018326,071-AAY,-0.335343058,270,228,498
9022,-1.350869376,0.68018326,071-AAZ,-0.335343058,121,155,276
9023,-1.350869376,0.68018326,071-ABA,-0.335343058,159,219,378
9024,-1.350869376,0.68018326,071-ABB,-0.335343058,136,129,265
9025,-1.350869376,0.68018326,071-ABC,-0.335343058,146,154,300
9026,-1.350869376,0.68018326,071-ABD,-0.335343058,64,94,158
9027,-1.350869376,0.68018326,071-ABH,-0.335343058,62,68,130
9028,-1.350869376,0.68018326,071-ABI,-0.335343058,140,142,282
9029,-1.350869376,0.68018326,071-ABJ,-0.335343058,292,159,451
9030,-1.350869376,0.68018326,071-ABK,-0.335343058,178,131,309
9031,-1.350869376,0.68018326,071-ABL,-0.335343058,263,203,466
9032,-1.350869376,0.68018326,071-ABM,-0.335343058,340,221,561
9033,-1.350869376,0.68018326,071-ABN,-0.335343058,321,218,539
9034,-1.350869376,0.68018326,071-ABO,-0.335343058,83,70,153
9035,-1.350869376,0.68018326,071-ABP,-0.335343058,163,115,278
9036,-1.350869376,0.68018326,071-ABQ,-0.335343058,154,99,253
9037,-1.350869376,0.68018326,071-ABR,-0.335343058,183,144,327
9038,-1.350869376,0.68018326,071-ABS,-0.335343058,245,203,448
9039,-1.350869376,0.68018326,071-ABT,-0.335343058,315,199,514
9040,-1.350869376,0.68018326,071-ABU,-0.335343058,405,306,711
9041,-1.350869376,0.68018326,071-ADA,-0.335343058,445,284,729
9042,-1.350869376,0.68018326,071-ABV,-0.335343058,313,230,543
9043,-1.350869376,0.68018326,071-ABW,-0.335343058,390,332,722
9044,-1.350869376,0.68018326,071-ABX,-0.335343058,380,294,674
9045,-1.350869376,0.68018326,071-ABY,-0.335343058,228,203,431
9046,-1.350869376,0.68018326,071-ABZ,-0.335343058,262,217,479
9047,-1.350869376,0.68018326,071-ACA,-0.335343058,249,218,467
9048,-1.350869376,0.68018326,071-ACB,-0.335343058,282,233,515
9049,-1.350869376,0.68018326,071-ACC,-0.335343058,322,327,649
9050,-1.350869376,0.68018326,071-ACD,-0.335343058,305,194,499
9051,-1.350869376,0.68018326,071-ACE,-0.335343058,168,150,318
9052,-1.350869376,0.68018326,071-ACF,-0.335343058,261,209,470
9053,-1.350869376,0.68018326,071-ACI,-0.335343058,192,154,346
9054,-1.350869376,0.68018326,071-ACJ,-0.335343058,51,72,123
9055,-1.350869376,0.68018326,071-ACG,-0.335343058,270,240,510
9056,-1.350869376,0.68018326,071-ACK,-0.335343058,199,132,331
9057,-1.350869376,0.68018326,071-ACL,-0.335343058,239,245,484
9058,-1.350869376,0.68018326,071-ACM,-0.335343058,251,256,507
9059,-1.350869376,0.68018326,071-ACN,-0.335343058,462,352,814
9060,-1.350869376,0.68018326,071-ACO,-0.335343058,211,191,402
9061,-1.350869376,0.68018326,071-ACP,-0.335343058,231,197,428
9062,-1.350869376,0.68018326,071-ACQ,-0.335343058,158,114,272
9063,-1.350869376,0.68018326,071-ACR,-0.335343058,229,184,413
9064,-1.350869376,0.68018326,071-ACS,-0.335343058,282,161,443
9065,-1.350869376,0.68018326,071-ACT,-0.335343058,269,179,448
9066,-1.350869376,0.68018326,071-ACU,-0.335343058,316,232,548
9067,-1.350869376,0.68018326,071-ACV,-0.335343058,114,109,223
9068,-1.350869376,0.68018326,071-ACW,-0.335343058,478,368,846
9069,-1.350869376,0.68018326,071-ACX,-0.335343058,346,287,633
9070,-1.350869376,0.68018326,071-ACY,-0.335343058,459,299,758
9071,-1.350869376,0.68018326,072-ABN,-0.335343058,187,103,290
9072,-1.350869376,0.68018326,072-ABO,-0.335343058,251,142,393
9073,-1.350869376,0.68018326,072-ABP,-0.335343058,252,214,466
9074,-1.350869376,0.68018326,072-ABR,-0.335343058,398,312,710
9075,-1.350869376,0.68018326,072-ABS,-0.335343058,293,300,593
9076,-1.350869376,0.68018326,072-ABU,-0.335343058,221,216,437
9077,-1.350869376,0.68018326,072-ABV,-0.335343058,298,197,495
9078,-1.350869376,0.68018326,072-ABW,-0.335343058,244,216,460
9079,-1.350869376,0.68018326,072-AAA,-0.335343058,183,131,314
9080,-1.350869376,0.68018326,072-AAB,-0.335343058,222,201,423
9081,-1.350869376,0.68018326,072-AAC,-0.335343058,188,270,458
9082,-1.350869376,0.68018326,072-AAD,-0.335343058,150,164,314
9083,-1.350869376,0.68018326,072-AAE,-0.335343058,168,206,374
9084,-1.350869376,0.68018326,072-AAF,-0.335343058,109,147,256
9085,-1.350869376,0.68018326,072-AAG,-0.335343058,157,185,342
9086,-1.350869376,0.68018326,072-AAH,-0.335343058,145,148,293
9087,-1.350869376,0.68018326,072-AAI,-0.335343058,212,267,479
9088,-1.350869376,0.68018326,072-AAJ,-0.335343058,181,237,418
9089,-1.350869376,0.68018326,072-AAK,-0.335343058,186,272,458
9090,-1.350869376,0.68018326,072-AAL,-0.335343058,365,402,767
9091,-1.350869376,0.68018326,072-AAM,-0.335343058,153,328,481
9092,-1.350869376,0.68018326,072-AAO,-0.335343058,145,372,517
9093,-1.350869376,0.68018326,072-AAQ,-0.335343058,130,194,324
9094,-1.350869376,0.68018326,072-AAR,-0.335343058,265,203,468
9095,-1.350869376,0.68018326,072-AAT,-0.335343058,179,254,433
9096,-1.350869376,0.68018326,072-AAU,-0.335343058,131,295,426
9097,-1.350869376,0.68018326,072-AAW,-0.335343058,99,135,234
9098,-1.350869376,0.68018326,072-AAX,-0.335343058,123,187,310
9099,-1.350869376,0.68018326,072-AAY,-0.335343058,119,243,362
9100,-1.350869376,0.68018326,072-ABA,-0.335343058,147,361,508
9101,-1.350869376,0.68018326,072-ABC,-0.335343058,157,180,337
9102,-1.350869376,0.68018326,072-ABD,-0.335343058,162,249,411
9103,-1.350869376,0.68018326,072-ABE,-0.335343058,223,341,564
9104,-1.350869376,0.68018326,072-ABH,-0.335343058,141,167,308
9105,-1.350869376,0.68018326,072-ABI,-0.335343058,104,116,220
9106,-1.350869376,0.68018326,072-ABJ,-0.335343058,114,158,272
9107,-1.350869376,0.68018326,072-ABK,-0.335343058,115,152,267
9108,-1.350869376,0.68018326,072-ABL,-0.335343058,78,186,264
9109,-1.350869376,0.68018326,072-ABM,-0.335343058,136,248,384
9110,-1.350869376,0.68018326,072-ACG,-0.335343058,101,144,245
9111,-1.350869376,0.68018326,072-ACH,-0.335343058,139,197,336
9112,-1.350869376,0.68018326,072-ACI,-0.335343058,118,168,286
9113,-1.350869376,0.68018326,072-ACJ,-0.335343058,163,168,331
9114,-1.350869376,0.68018326,072-ABY,-0.335343058,183,210,393
9115,-1.350869376,0.68018326,072-ABZ,-0.335343058,259,175,434
9116,-1.350869376,0.68018326,072-ACA,-0.335343058,244,237,481
9117,-1.350869376,0.68018326,072-ACB,-0.335343058,243,200,443
9118,-1.350869376,0.68018326,072-ABX,-0.335343058,121,147,268
9119,-1.350869376,0.68018326,072-ACZ,-0.335343058,54,55,109
9120,-1.350869376,0.68018326,072-ACC,-0.335343058,289,232,521
9121,-1.350869376,0.68018326,072-ACD,-0.335343058,185,144,329
9122,-1.350869376,0.68018326,072-ADA,-0.335343058,135,111,246
9123,-1.350869376,0.68018326,072-ACE,-0.335343058,335,306,641
9124,-1.350869376,0.68018326,072-ACK,-0.335343058,279,342,621
9125,-1.350869376,0.68018326,072-ACM,-0.335343058,357,324,681
9126,-1.350869376,0.68018326,072-ACO,-0.335343058,257,257,514
9127,-1.350869376,0.68018326,072-ACP,-0.335343058,175,151,326
9128,-1.350869376,0.68018326,072-ACQ,-0.335343058,207,355,562
9129,-1.350869376,0.68018326,072-ACS,-0.335343058,352,301,653
9130,-1.350869376,0.68018326,072-ACV,-0.335343058,129,164,293
9131,-1.350869376,0.68018326,072-ACW,-0.335343058,241,182,423
9132,-1.350869376,0.68018326,072-ACX,-0.335343058,225,202,427
9133,-1.350869376,0.68018326,072-ACY,-0.335343058,150,184,334
9134,-1.350869376,0.68018326,072-ADB,-0.335343058,205,156,361
9135,-1.350869376,0.68018326,072-ADC,-0.335343058,306,269,575
9136,-1.350869376,0.68018326,072-ADE,-0.335343058,370,334,704
9137,-1.350869376,0.68018326,072-ADG,-0.335343058,217,195,412
9138,-1.350869376,0.68018326,072-ADH,-0.335343058,143,160,303
9139,-1.350869376,0.68018326,072-ADI,-0.335343058,188,263,451
9140,-1.350869376,0.68018326,072-ADJ,-0.335343058,302,252,554
9141,-1.350869376,0.68018326,072-ADK,-0.335343058,235,191,426
9142,-1.350869376,0.68018326,072-ADL,-0.335343058,152,126,278
9143,-1.350869376,0.68018326,073-ABQ,-0.335343058,251,192,443
9144,-1.350869376,0.68018326,073-ABR,-0.335343058,207,195,402
9145,-1.350869376,0.68018326,073-ABV,-0.335343058,167,91,258
9146,-1.350869376,0.68018326,073-ABW,-0.335343058,165,143,308
9147,-1.350869376,0.68018326,073-ABX,-0.335343058,199,101,300
9148,-1.350869376,0.68018326,073-ABY,-0.335343058,248,160,408
9149,-1.350869376,0.68018326,073-ABZ,-0.335343058,58,72,130
9150,-1.350869376,0.68018326,073-ACA,-0.335343058,180,155,335
9151,-1.350869376,0.68018326,073-ACB,-0.335343058,217,214,431
9152,-1.350869376,0.68018326,073-ACC,-0.335343058,183,140,323
9153,-1.350869376,0.68018326,073-ACD,-0.335343058,235,152,387
9154,-1.350869376,0.68018326,073-ACE,-0.335343058,161,145,306
9155,-1.350869376,0.68018326,073-ACF,-0.335343058,228,230,458
9156,-1.350869376,0.68018326,073-ACG,-0.335343058,223,172,395
9157,-1.350869376,0.68018326,073-ACH,-0.335343058,271,152,423
9158,-1.350869376,0.68018326,073-ACI,-0.335343058,220,175,395
9159,-1.350869376,0.68018326,073-ACJ,-0.335343058,184,143,327
9160,-1.350869376,0.68018326,073-ACK,-0.335343058,210,109,319
9161,-1.350869376,0.68018326,073-ACL,-0.335343058,291,199,490
9162,-1.350869376,0.68018326,073-ACM,-0.335343058,153,123,276
9163,-1.350869376,0.68018326,073-ACN,-0.335343058,271,121,392
9164,-1.350869376,0.68018326,073-ACO,-0.335343058,262,168,430
9165,-1.350869376,0.68018326,073-ACP,-0.335343058,258,150,408
9166,-1.350869376,0.68018326,073-ACQ,-0.335343058,261,143,404
9167,-1.350869376,0.68018326,073-ACR,-0.335343058,351,192,543
9168,-1.350869376,0.68018326,073-ACS,-0.335343058,195,246,441
9169,-1.350869376,0.68018326,073-ACT,-0.335343058,205,256,461
9170,-1.350869376,0.68018326,073-ACU,-0.335343058,181,235,416
9171,-1.350869376,0.68018326,073-ACW,-0.335343058,154,240,394
9172,-1.350869376,0.68018326,073-ADC,-0.335343058,221,205,426
9173,-1.350869376,0.68018326,073-ADD,-0.335343058,242,167,409
9174,-1.350869376,0.68018326,073-ADE,-0.335343058,151,143,294
9175,-1.350869376,0.68018326,073-ABU,-0.335343058,283,211,494
9176,-1.350869376,0.68018326,073-ADF,-0.335343058,112,91,203
9177,-1.350869376,0.68018326,073-ADG,-0.335343058,241,225,466
9178,-1.350869376,0.68018326,073-ADH,-0.335343058,85,79,164
9179,-1.350869376,0.68018326,073-ADI,-0.335343058,137,136,273
9180,-1.350869376,0.68018326,073-ADJ,-0.335343058,174,128,302
9181,-1.350869376,0.68018326,073-ADK,-0.335343058,345,204,549
9182,-1.350869376,0.68018326,073-ADL,-0.335343058,158,141,299
9183,-1.350869376,0.68018326,073-ADM,-0.335343058,201,128,329
9184,-1.350869376,0.68018326,073-ADN,-0.335343058,336,220,556
9185,-1.350869376,0.68018326,073-ADO,-0.335343058,368,270,638
9186,-1.350869376,0.68018326,073-ADP,-0.335343058,148,132,280
9187,-1.350869376,0.68018326,073-ADQ,-0.335343058,177,106,283
9188,-1.350869376,0.68018326,073-AAA,-0.335343058,190,247,437
9189,-1.350869376,0.68018326,073-AAB,-0.335343058,78,117,195
9190,-1.350869376,0.68018326,073-AAC,-0.335343058,58,109,167
9191,-1.350869376,0.68018326,073-AAD,-0.335343058,179,195,374
9192,-1.350869376,0.68018326,073-AAE,-0.335343058,79,128,207
9193,-1.350869376,0.68018326,073-AAI,-0.335343058,101,149,250
9194,-1.350869376,0.68018326,073-AAJ,-0.335343058,25,225,250
9195,-1.350869376,0.68018326,073-AAK,-0.335343058,158,239,397
9196,-1.350869376,0.68018326,073-AAO,-0.335343058,232,119,351
9197,-1.350869376,0.68018326,073-AAP,-0.335343058,119,225,344
9198,-1.350869376,0.68018326,073-AAQ,-0.335343058,191,178,369
9199,-1.350869376,0.68018326,073-AAR,-0.335343058,343,284,627
9200,-1.350869376,0.68018326,073-AAS,-0.335343058,114,91,205
9201,-1.350869376,0.68018326,073-AAX,-0.335343058,120,162,282
9202,-1.350869376,0.68018326,073-AAY,-0.335343058,108,203,311
9203,-1.350869376,0.68018326,073-AAZ,-0.335343058,64,108,172
9204,-1.350869376,0.68018326,073-ABA,-0.335343058,49,101,150
9205,-1.350869376,0.68018326,073-ABD,-0.335343058,141,139,280
9206,-1.350869376,0.68018326,073-ABE,-0.335343058,225,180,405
9207,-1.350869376,0.68018326,073-ABF,-0.335343058,251,88,339
9208,-1.350869376,0.68018326,073-ABG,-0.335343058,177,185,362
9209,-1.350869376,0.68018326,073-ABJ,-0.335343058,155,218,373
9210,-1.350869376,0.68018326,073-ABK,-0.335343058,182,210,392
9211,-1.350869376,0.68018326,073-ABL,-0.335343058,220,259,479
9212,-1.350869376,0.68018326,073-ADR,-0.335343058,226,178,404
9213,-1.350869376,0.68018326,073-ADT,-0.335343058,190,166,356
9214,-1.350869376,0.68018326,073-ADU,-0.335343058,209,166,375
9215,-1.350869376,0.68018326,073-ADV,-0.335343058,345,303,648
9216,-1.350869376,0.68018326,073-ABS,-0.335343058,199,178,377
9217,-1.350869376,0.68018326,073-ADW,-0.335343058,303,284,587
9218,-1.350869376,0.68018326,073-ADX,-0.335343058,184,160,344
9219,-1.350869376,0.68018326,073-ADY,-0.335343058,352,164,516
9220,-1.350869376,0.68018326,073-ADZ,-0.335343058,78,95,173
9221,-1.350869376,0.68018326,073-AEA,-0.335343058,201,89,290
9222,-1.350869376,0.68018326,073-AEB,-0.335343058,100,75,175
9223,-1.350869376,0.68018326,073-AEC,-0.335343058,129,185,314
9224,-1.350869376,0.68018326,073-AED,-0.335343058,318,215,533
9225,-1.350869376,0.68018326,073-AEE,-0.335343058,151,112,263
9226,-1.350869376,0.68018326,073-AEF,-0.335343058,93,88,181
9227,-1.350869376,0.68018326,073-AEG,-0.335343058,206,175,381
9228,-1.350869376,0.68018326,073-AEH,-0.335343058,154,132,286
9229,-1.350869376,0.68018326,073-AEI,-0.335343058,116,145,261
9230,-1.350869376,0.68018326,073-AEJ,-0.335343058,106,143,249
9231,-1.350869376,0.68018326,073-AEK,-0.335343058,125,222,347
9232,-1.350869376,0.68018326,073-AEN,-0.335343058,82,92,174
9233,-1.350869376,0.68018326,074-ABJ,-0.335343058,365,304,669
9234,-1.350869376,0.68018326,074-ACT,-0.335343058,244,168,412
9235,-1.350869376,0.68018326,074-ACD,-0.335343058,140,179,319
9236,-1.350869376,0.68018326,074-ABM,-0.335343058,500,272,772
9237,-1.350869376,0.68018326,074-ABO,-0.335343058,259,185,444
9238,-1.350869376,0.68018326,074-ABP,-0.335343058,189,174,363
9239,-1.350869376,0.68018326,074-ABQ,-0.335343058,241,187,428
9240,-1.350869376,0.68018326,074-ABR,-0.335343058,224,191,415
9241,-1.350869376,0.68018326,074-ABS,-0.335343058,403,271,674
9242,-1.350869376,0.68018326,074-ABT,-0.335343058,305,212,517
9243,-1.350869376,0.68018326,074-ABU,-0.335343058,210,121,331
9244,-1.350869376,0.68018326,074-ABV,-0.335343058,461,261,722
9245,-1.350869376,0.68018326,074-ABX,-0.335343058,253,191,444
9246,-1.350869376,0.68018326,074-AAA,-0.335343058,272,432,704
9247,-1.350869376,0.68018326,074-AAC,-0.335343058,181,408,589
9248,-1.350869376,0.68018326,074-AAE,-0.335343058,171,344,515
9249,-1.350869376,0.68018326,074-AAF,-0.335343058,139,350,489
9250,-1.350869376,0.68018326,074-AAI,-0.335343058,214,438,652
9251,-1.350869376,0.68018326,074-AAL,-0.335343058,134,305,439
9252,-1.350869376,0.68018326,074-ABI,-0.335343058,120,132,252
9253,-1.350869376,0.68018326,074-ABY,-0.335343058,309,261,570
9254,-1.350869376,0.68018326,074-ABZ,-0.335343058,321,209,530
9255,-1.350869376,0.68018326,074-ACA,-0.335343058,274,175,449
9256,-1.350869376,0.68018326,074-ACB,-0.335343058,391,366,757
9257,-1.350869376,0.68018326,074-ACE,-0.335343058,249,169,418
9258,-1.350869376,0.68018326,074-ACF,-0.335343058,174,183,357
9259,-1.350869376,0.68018326,074-ACG,-0.335343058,358,398,756
9260,-1.350869376,0.68018326,074-ACH,-0.335343058,210,158,368
9261,-1.350869376,0.68018326,074-ABL,-0.335343058,81,54,135
9262,-1.350869376,0.68018326,074-ACJ,-0.335343058,490,374,864
9263,-1.350869376,0.68018326,074-ACL,-0.335343058,267,195,462
9264,-1.350869376,0.68018326,074-ACN,-0.335343058,143,113,256
9265,-1.350869376,0.68018326,074-ACM,-0.335343058,397,271,668
9266,-1.350869376,0.68018326,074-ACP,-0.335343058,329,194,523
9267,-1.350869376,0.68018326,074-ACQ,-0.335343058,211,91,302
9268,-1.350869376,0.68018326,074-ACR,-0.335343058,386,306,692
9269,-1.350869376,0.68018326,074-AAM,-0.335343058,117,166,283
9270,-1.350869376,0.68018326,074-AAN,-0.335343058,284,390,674
9271,-1.350869376,0.68018326,074-AAO,-0.335343058,285,315,600
9272,-1.350869376,0.68018326,074-AAR,-0.335343058,349,427,776
9273,-1.350869376,0.68018326,074-AAS,-0.335343058,180,274,454
9274,-1.350869376,0.68018326,074-AAT,-0.335343058,340,432,772
9275,-1.350869376,0.68018326,074-AAW,-0.335343058,284,441,725
9276,-1.350869376,0.68018326,074-AAX,-0.335343058,211,274,485
9277,-1.350869376,0.68018326,074-AAY,-0.335343058,210,250,460
9278,-1.350869376,0.68018326,074-AAZ,-0.335343058,203,226,429
9279,-1.350869376,0.68018326,074-ABB,-0.335343058,400,217,617
9280,-1.350869376,0.68018326,074-ABC,-0.335343058,547,391,938
9281,-1.350869376,0.68018326,074-ABE,-0.335343058,289,318,607
9282,-1.350869376,0.68018326,074-ABG,-0.335343058,228,184,412
9283,-1.350869376,0.68018326,074-ACU,-0.335343058,281,140,421
9284,-1.350869376,0.68018326,075-ABE,-0.335343058,451,246,697
9285,-1.350869376,0.68018326,075-ABH,-0.335343058,491,150,641
9286,-1.350869376,0.68018326,075-AAZ,-0.335343058,341,172,513
9287,-1.350869376,0.68018326,075-ABC,-0.335343058,353,124,477
9288,-1.350869376,0.68018326,075-ABD,-0.335343058,428,179,607
9289,-1.350869376,0.68018326,075-ABF,-0.335343058,604,165,769
9290,-1.350869376,0.68018326,075-ABX,-0.335343058,623,212,835
9291,-1.350869376,0.68018326,075-ABK,-0.335343058,729,194,923
9292,-1.350869376,0.68018326,075-ABM,-0.335343058,377,122,499
9293,-1.350869376,0.68018326,075-ABO,-0.335343058,388,132,520
9294,-1.350869376,0.68018326,075-ABQ,-0.335343058,418,204,622
9295,-1.350869376,0.68018326,075-ABS,-0.335343058,419,179,598
9296,-1.350869376,0.68018326,075-ABU,-0.335343058,597,134,731
9297,-1.350869376,0.68018326,075-ABV,-0.335343058,661,234,895
9298,-1.350869376,0.68018326,075-ABZ,-0.335343058,508,202,710
9299,-1.350869376,0.68018326,075-ACB,-0.335343058,369,167,536
9300,-1.350869376,0.68018326,075-ACD,-0.335343058,390,204,594
9301,-1.350869376,0.68018326,075-ACF,-0.335343058,417,164,581
9302,-1.350869376,0.68018326,075-AAB,-0.335343058,393,262,655
9303,-1.350869376,0.68018326,075-AAA,-0.335343058,569,291,860
9304,-1.350869376,0.68018326,075-AAF,-0.335343058,541,242,783
9305,-1.350869376,0.68018326,075-AAH,-0.335343058,294,267,561
9306,-1.350869376,0.68018326,075-AAJ,-0.335343058,417,210,627
9307,-1.350869376,0.68018326,075-AAL,-0.335343058,239,170,409
9308,-1.350869376,0.68018326,075-AAM,-0.335343058,435,275,710
9309,-1.350869376,0.68018326,075-AAN,-0.335343058,356,419,775
9310,-1.350869376,0.68018326,075-AAQ,-0.335343058,526,418,944
9311,-1.350869376,0.68018326,075-AAS,-0.335343058,223,190,413
9312,-1.350869376,0.68018326,075-AAT,-0.335343058,283,206,489
9313,-1.350869376,0.68018326,075-AAU,-0.335343058,341,262,603
9314,-1.350869376,0.68018326,075-AAY,-0.335343058,483,208,691
9315,-1.350869376,0.68018326,075-ACG,-0.335343058,635,193,828
9316,-1.350869376,0.68018326,075-ACJ,-0.335343058,482,78,560
9317,-1.350869376,0.68018326,075-ACL,-0.335343058,505,140,645
9318,-1.350869376,0.68018326,075-ACN,-0.335343058,638,302,940
9319,-1.350869376,0.68018326,076-AAA,-0.335343058,119,273,392
9320,-1.350869376,0.68018326,076-AAB,-0.335343058,144,241,385
9321,-1.350869376,0.68018326,076-AAC,-0.335343058,174,301,475
9322,-1.350869376,0.68018326,076-AAD,-0.335343058,41,340,381
9323,-1.350869376,0.68018326,076-AAE,-0.335343058,131,212,343
9324,-1.350869376,0.68018326,076-AAF,-0.335343058,80,228,308
9325,-1.350869376,0.68018326,076-AAG,-0.335343058,81,256,337
9326,-1.350869376,0.68018326,076-AAH,-0.335343058,58,320,378
9327,-1.350869376,0.68018326,076-AAI,-0.335343058,199,265,464
9328,-1.350869376,0.68018326,076-AAJ,-0.335343058,222,283,505
9329,-1.350869376,0.68018326,076-AAK,-0.335343058,130,283,413
9330,-1.350869376,0.68018326,076-AAL,-0.335343058,110,142,252
9331,-1.350869376,0.68018326,076-AAM,-0.335343058,255,312,567
9332,-1.350869376,0.68018326,076-AAN,-0.335343058,376,318,694
9333,-1.350869376,0.68018326,076-AAO,-0.335343058,198,257,455
9334,-1.350869376,0.68018326,076-AAP,-0.335343058,333,331,664
9335,-1.350869376,0.68018326,076-AAQ,-0.335343058,259,246,505
9336,-1.350869376,0.68018326,076-AAR,-0.335343058,226,210,436
9337,-1.350869376,0.68018326,076-AAS,-0.335343058,219,217,436
9338,-1.350869376,0.68018326,076-AFL,-0.335343058,105,122,227
9339,-1.350869376,0.68018326,076-AFM,-0.335343058,366,253,619
9340,-1.350869376,0.68018326,076-AFN,-0.335343058,356,287,643
9341,-1.350869376,0.68018326,076-AFO,-0.335343058,180,209,389
9342,-1.350869376,0.68018326,076-AIX,-0.335343058,309,279,588
9343,-1.350869376,0.68018326,076-AIY,-0.335343058,269,309,578
9344,-1.350869376,0.68018326,076-AIZ,-0.335343058,331,346,677
9345,-1.350869376,0.68018326,076-AJA,-0.335343058,438,389,827
9346,-1.350869376,0.68018326,076-AAT,-0.335343058,36,183,219
9347,-1.350869376,0.68018326,076-AAU,-0.335343058,137,229,366
9348,-1.350869376,0.68018326,076-AAV,-0.335343058,91,211,302
9349,-1.350869376,0.68018326,076-AAW,-0.335343058,80,281,361
9350,-1.350869376,0.68018326,076-AAX,-0.335343058,117,222,339
9351,-1.350869376,0.68018326,076-AAY,-0.335343058,102,303,405
9352,-1.350869376,0.68018326,076-AAZ,-0.335343058,111,361,472
9353,-1.350869376,0.68018326,076-ABA,-0.335343058,58,242,300
9354,-1.350869376,0.68018326,076-ABB,-0.335343058,73,231,304
9355,-1.350869376,0.68018326,076-ABC,-0.335343058,82,268,350
9356,-1.350869376,0.68018326,076-ABD,-0.335343058,19,350,369
9357,-1.350869376,0.68018326,076-ABE,-0.335343058,85,433,518
9358,-1.350869376,0.68018326,076-ABF,-0.335343058,26,388,414
9359,-1.350869376,0.68018326,076-ABG,-0.335343058,186,231,417
9360,-1.350869376,0.68018326,076-ABH,-0.335343058,126,218,344
9361,-1.350869376,0.68018326,076-ABI,-0.335343058,160,317,477
9362,-1.350869376,0.68018326,076-ABJ,-0.335343058,68,185,253
9363,-1.350869376,0.68018326,076-ABK,-0.335343058,87,220,307
9364,-1.350869376,0.68018326,076-ABL,-0.335343058,148,254,402
9365,-1.350869376,0.68018326,076-ABM,-0.335343058,109,221,330
9366,-1.350869376,0.68018326,076-ABN,-0.335343058,175,265,440
9367,-1.350869376,0.68018326,076-ABO,-0.335343058,161,279,440
9368,-1.350869376,0.68018326,076-ABP,-0.335343058,36,411,447
9369,-1.350869376,0.68018326,076-ABQ,-0.335343058,30,391,421
9370,-1.350869376,0.68018326,076-ABR,-0.335343058,39,600,639
9371,-1.350869376,0.68018326,076-ABS,-0.335343058,14,407,421
9372,-1.350869376,0.68018326,076-ABT,-0.335343058,15,276,291
9373,-1.350869376,0.68018326,076-ABU,-0.335343058,54,502,556
9374,-1.350869376,0.68018326,076-ABV,-0.335343058,70,262,332
9375,-1.350869376,0.68018326,076-ABW,-0.335343058,131,291,422
9376,-1.350869376,0.68018326,076-ABX,-0.335343058,118,294,412
9377,-1.350869376,0.68018326,076-ABY,-0.335343058,92,291,383
9378,-1.350869376,0.68018326,076-ABZ,-0.335343058,122,251,373
9379,-1.350869376,0.68018326,076-ACA,-0.335343058,74,189,263
9380,-1.350869376,0.68018326,076-ACB,-0.335343058,92,240,332
9381,-1.350869376,0.68018326,076-ACC,-0.335343058,108,284,392
9382,-1.350869376,0.68018326,076-ACD,-0.335343058,59,456,515
9383,-1.350869376,0.68018326,076-ACE,-0.335343058,86,299,385
9384,-1.350869376,0.68018326,076-ACF,-0.335343058,50,352,402
9385,-1.350869376,0.68018326,076-ACG,-0.335343058,59,346,405
9386,-1.350869376,0.68018326,076-ACH,-0.335343058,107,310,417
9387,-1.350869376,0.68018326,076-ACI,-0.335343058,69,307,376
9388,-1.350869376,0.68018326,076-ACJ,-0.335343058,44,305,349
9389,-1.350869376,0.68018326,076-ACK,-0.335343058,143,289,432
9390,-1.350869376,0.68018326,076-ACL,-0.335343058,116,221,337
9391,-1.350869376,0.68018326,076-ACM,-0.335343058,156,351,507
9392,-1.350869376,0.68018326,076-ACN,-0.335343058,91,177,268
9393,-1.350869376,0.68018326,076-ACO,-0.335343058,161,237,398
9394,-1.350869376,0.68018326,076-ACP,-0.335343058,242,250,492
9395,-1.350869376,0.68018326,076-ACQ,-0.335343058,265,327,592
9396,-1.350869376,0.68018326,076-ACR,-0.335343058,145,223,368
9397,-1.350869376,0.68018326,076-ACS,-0.335343058,121,225,346
9398,-1.350869376,0.68018326,076-ACT,-0.335343058,131,264,395
9399,-1.350869376,0.68018326,076-ACU,-0.335343058,170,314,484
9400,-1.350869376,0.68018326,076-ACV,-0.335343058,208,215,423
9401,-1.350869376,0.68018326,076-ACW,-0.335343058,141,267,408
9402,-1.350869376,0.68018326,076-ACX,-0.335343058,169,261,430
9403,-1.350869376,0.68018326,076-ACY,-0.335343058,372,369,741
9404,-1.350869376,0.68018326,076-ACZ,-0.335343058,179,251,430
9405,-1.350869376,0.68018326,076-ADA,-0.335343058,97,209,306
9406,-1.350869376,0.68018326,076-ADB,-0.335343058,343,504,847
9407,-1.350869376,0.68018326,076-ADC,-0.335343058,138,221,359
9408,-1.350869376,0.68018326,076-ADD,-0.335343058,255,255,510
9409,-1.350869376,0.68018326,076-ADE,-0.335343058,55,378,433
9410,-1.350869376,0.68018326,076-ADF,-0.335343058,150,361,511
9411,-1.350869376,0.68018326,076-ADG,-0.335343058,109,385,494
9412,-1.350869376,0.68018326,076-ADH,-0.335343058,152,300,452
9413,-1.350869376,0.68018326,076-ADI,-0.335343058,53,284,337
9414,-1.350869376,0.68018326,076-ADJ,-0.335343058,119,336,455
9415,-1.350869376,0.68018326,076-ADK,-0.335343058,107,374,481
9416,-1.350869376,0.68018326,076-ADL,-0.335343058,244,313,557
9417,-1.350869376,0.68018326,076-AFS,-0.335343058,131,250,381
9418,-1.350869376,0.68018326,076-AFT,-0.335343058,243,313,556
9419,-1.350869376,0.68018326,076-AFU,-0.335343058,211,223,434
9420,-1.350869376,0.68018326,076-AFV,-0.335343058,168,304,472
9421,-1.350869376,0.68018326,076-AFW,-0.335343058,212,266,478
9422,-1.350869376,0.68018326,076-AFX,-0.335343058,258,324,582
9423,-1.350869376,0.68018326,076-AFY,-0.335343058,172,292,464
9424,-1.350869376,0.68018326,076-AFZ,-0.335343058,155,246,401
9425,-1.350869376,0.68018326,076-AGA,-0.335343058,313,342,655
9426,-1.350869376,0.68018326,076-AGB,-0.335343058,132,278,410
9427,-1.350869376,0.68018326,076-AGC,-0.335343058,208,196,404
9428,-1.350869376,0.68018326,076-AGD,-0.335343058,142,246,388
9429,-1.350869376,0.68018326,076-AGE,-0.335343058,245,268,513
9430,-1.350869376,0.68018326,076-AGG,-0.335343058,255,242,497
9431,-1.350869376,0.68018326,076-AGH,-0.335343058,300,343,643
9432,-1.350869376,0.68018326,076-AGI,-0.335343058,258,291,549
9433,-1.350869376,0.68018326,076-AGJ,-0.335343058,169,184,353
9434,-1.350869376,0.68018326,076-AGK,-0.335343058,256,249,505
9435,-1.350869376,0.68018326,076-AGL,-0.335343058,211,305,516
9436,-1.350869376,0.68018326,076-AGM,-0.335343058,176,206,382
9437,-1.350869376,0.68018326,076-AGN,-0.335343058,446,313,759
9438,-1.350869376,0.68018326,076-AGO,-0.335343058,274,159,433
9439,-1.350869376,0.68018326,076-AGP,-0.335343058,332,219,551
9440,-1.350869376,0.68018326,076-AGQ,-0.335343058,260,152,412
9441,-1.350869376,0.68018326,076-AGR,-0.335343058,343,219,562
9442,-1.350869376,0.68018326,076-AGS,-0.335343058,386,221,607
9443,-1.350869376,0.68018326,076-AGT,-0.335343058,272,210,482
9444,-1.350869376,0.68018326,076-AGU,-0.335343058,328,296,624
9445,-1.350869376,0.68018326,076-AGV,-0.335343058,335,330,665
9446,-1.350869376,0.68018326,076-AGW,-0.335343058,572,381,953
9447,-1.350869376,0.68018326,076-AGX,-0.335343058,507,449,956
9448,-1.350869376,0.68018326,076-AGY,-0.335343058,682,387,1069
9449,-1.350869376,0.68018326,076-AGZ,-0.335343058,251,159,410
9450,-1.350869376,0.68018326,076-AHA,-0.335343058,260,254,514
9451,-1.350869376,0.68018326,076-AHB,-0.335343058,263,187,450
9452,-1.350869376,0.68018326,076-AHC,-0.335343058,254,308,562
9453,-1.350869376,0.68018326,076-AHD,-0.335343058,343,346,689
9454,-1.350869376,0.68018326,076-AHE,-0.335343058,364,273,637
9455,-1.350869376,0.68018326,076-AHF,-0.335343058,263,242,505
9456,-1.350869376,0.68018326,076-AHG,-0.335343058,346,240,586
9457,-1.350869376,0.68018326,076-AHH,-0.335343058,334,323,657
9458,-1.350869376,0.68018326,076-AHI,-0.335343058,306,241,547
9459,-1.350869376,0.68018326,076-AHJ,-0.335343058,436,200,636
9460,-1.350869376,0.68018326,076-AHK,-0.335343058,627,416,1043
9461,-1.350869376,0.68018326,076-AOO,-0.335343058,478,305,783
9462,-1.350869376,0.68018326,076-AOR,-0.335343058,338,234,572
9463,-1.350869376,0.68018326,076-AHL,-0.335343058,219,208,427
9464,-1.350869376,0.68018326,076-AHM,-0.335343058,488,284,772
9465,-1.350869376,0.68018326,076-AHN,-0.335343058,249,267,516
9466,-1.350869376,0.68018326,076-AHO,-0.335343058,221,213,434
9467,-1.350869376,0.68018326,076-AHP,-0.335343058,245,213,458
9468,-1.350869376,0.68018326,076-AHQ,-0.335343058,290,280,570
9469,-1.350869376,0.68018326,076-AHR,-0.335343058,120,56,176
9470,-1.350869376,0.68018326,076-AHS,-0.335343058,368,203,571
9471,-1.350869376,0.68018326,076-AHT,-0.335343058,248,212,460
9472,-1.350869376,0.68018326,076-AHU,-0.335343058,237,194,431
9473,-1.350869376,0.68018326,076-AHV,-0.335343058,258,234,492
9474,-1.350869376,0.68018326,076-AHW,-0.335343058,282,246,528
9475,-1.350869376,0.68018326,076-AHX,-0.335343058,607,334,941
9476,-1.350869376,0.68018326,076-AHY,-0.335343058,434,292,726
9477,-1.350869376,0.68018326,076-AHZ,-0.335343058,329,99,428
9478,-1.350869376,0.68018326,076-AIA,-0.335343058,240,210,450
9479,-1.350869376,0.68018326,076-AIB,-0.335343058,173,120,293
9480,-1.350869376,0.68018326,076-AIC,-0.335343058,497,370,867
9481,-1.350869376,0.68018326,076-AID,-0.335343058,342,217,559
9482,-1.350869376,0.68018326,076-AIE,-0.335343058,590,359,949
9483,-1.350869376,0.68018326,076-AOS,-0.335343058,487,280,767
9484,-1.350869376,0.68018326,076-AOV,-0.335343058,389,222,611
9485,-1.350869376,0.68018326,076-AOW,-0.335343058,327,205,532
9486,-1.350869376,0.68018326,076-AIF,-0.335343058,350,180,530
9487,-1.350869376,0.68018326,076-AIG,-0.335343058,590,414,1004
9488,-1.350869376,0.68018326,076-AIH,-0.335343058,442,276,718
9489,-1.350869376,0.68018326,076-AII,-0.335343058,519,292,811
9490,-1.350869376,0.68018326,076-AIJ,-0.335343058,288,185,473
9491,-1.350869376,0.68018326,076-AIK,-0.335343058,345,250,595
9492,-1.350869376,0.68018326,076-AIL,-0.335343058,334,215,549
9493,-1.350869376,0.68018326,076-AIM,-0.335343058,251,163,414
9494,-1.350869376,0.68018326,076-AIN,-0.335343058,295,183,478
9495,-1.350869376,0.68018326,076-AOU,-0.335343058,387,163,550
9496,-1.350869376,0.68018326,076-AIO,-0.335343058,310,204,514
9497,-1.350869376,0.68018326,076-AIP,-0.335343058,235,217,452
9498,-1.350869376,0.68018326,076-AIQ,-0.335343058,292,290,582
9499,-1.350869376,0.68018326,076-AIR,-0.335343058,238,199,437
9500,-1.350869376,0.68018326,076-AIS,-0.335343058,368,271,639
9501,-1.350869376,0.68018326,076-AIT,-0.335343058,409,327,736
9502,-1.350869376,0.68018326,076-AIU,-0.335343058,337,272,609
9503,-1.350869376,0.68018326,076-AIV,-0.335343058,292,240,532
9504,-1.350869376,0.68018326,076-AJB,-0.335343058,235,244,479
9505,-1.350869376,0.68018326,076-AJC,-0.335343058,329,266,595
9506,-1.350869376,0.68018326,076-AJD,-0.335343058,320,225,545
9507,-1.350869376,0.68018326,076-AJE,-0.335343058,216,316,532
9508,-1.350869376,0.68018326,076-AJF,-0.335343058,119,126,245
9509,-1.350869376,0.68018326,076-ADM,-0.335343058,347,295,642
9510,-1.350869376,0.68018326,076-ADN,-0.335343058,210,240,450
9511,-1.350869376,0.68018326,076-ADO,-0.335343058,162,174,336
9512,-1.350869376,0.68018326,076-ADP,-0.335343058,341,343,684
9513,-1.350869376,0.68018326,076-ADQ,-0.335343058,373,329,702
9514,-1.350869376,0.68018326,076-ADR,-0.335343058,235,257,492
9515,-1.350869376,0.68018326,076-ADS,-0.335343058,238,249,487
9516,-1.350869376,0.68018326,076-AOP,-0.335343058,306,379,685
9517,-1.350869376,0.68018326,076-AJJ,-0.335343058,405,219,624
9518,-1.350869376,0.68018326,076-AJK,-0.335343058,461,304,765
9519,-1.350869376,0.68018326,076-AJL,-0.335343058,411,236,647
9520,-1.350869376,0.68018326,076-AJM,-0.335343058,292,123,415
9521,-1.350869376,0.68018326,076-ADT,-0.335343058,286,334,620
9522,-1.350869376,0.68018326,076-ADU,-0.335343058,175,308,483
9523,-1.350869376,0.68018326,076-ADV,-0.335343058,198,305,503
9524,-1.350869376,0.68018326,076-ADW,-0.335343058,271,245,516
9525,-1.350869376,0.68018326,076-ADX,-0.335343058,255,289,544
9526,-1.350869376,0.68018326,076-ADY,-0.335343058,225,317,542
9527,-1.350869376,0.68018326,076-ADZ,-0.335343058,212,306,518
9528,-1.350869376,0.68018326,076-AEA,-0.335343058,156,295,451
9529,-1.350869376,0.68018326,076-AEB,-0.335343058,176,314,490
9530,-1.350869376,0.68018326,076-AEC,-0.335343058,120,258,378
9531,-1.350869376,0.68018326,076-AED,-0.335343058,234,267,501
9532,-1.350869376,0.68018326,076-AEE,-0.335343058,182,306,488
9533,-1.350869376,0.68018326,076-AEF,-0.335343058,162,277,439
9534,-1.350869376,0.68018326,076-AEG,-0.335343058,379,322,701
9535,-1.350869376,0.68018326,076-AEH,-0.335343058,106,302,408
9536,-1.350869376,0.68018326,076-AEI,-0.335343058,63,447,510
9537,-1.350869376,0.68018326,076-AEJ,-0.335343058,64,495,559
9538,-1.350869376,0.68018326,076-AOQ,-0.335343058,427,358,785
9539,-1.350869376,0.68018326,076-AEK,-0.335343058,132,278,410
9540,-1.350869376,0.68018326,076-AEL,-0.335343058,166,234,400
9541,-1.350869376,0.68018326,076-AEM,-0.335343058,141,216,357
9542,-1.350869376,0.68018326,076-AEN,-0.335343058,136,249,385
9543,-1.350869376,0.68018326,076-AOT,-0.335343058,264,305,569
9544,-1.350869376,0.68018326,076-AEO,-0.335343058,430,381,811
9545,-1.350869376,0.68018326,076-AEP,-0.335343058,176,237,413
9546,-1.350869376,0.68018326,076-AEQ,-0.335343058,210,433,643
9547,-1.350869376,0.68018326,076-AER,-0.335343058,288,355,643
9548,-1.350869376,0.68018326,076-AGF,-0.335343058,229,195,424
9549,-1.350869376,0.68018326,076-AFQ,-0.335343058,170,187,357
9550,-1.350869376,0.68018326,076-AFR,-0.335343058,229,291,520
9551,-1.350869376,0.68018326,076-AJO,-0.335343058,235,252,487
9552,-1.350869376,0.68018326,076-AJP,-0.335343058,301,206,507
9553,-1.350869376,0.68018326,076-AJQ,-0.335343058,432,334,766
9554,-1.350869376,0.68018326,076-AJR,-0.335343058,273,231,504
9555,-1.350869376,0.68018326,076-AJS,-0.335343058,330,225,555
9556,-1.350869376,0.68018326,076-AJT,-0.335343058,251,254,505
9557,-1.350869376,0.68018326,076-AJU,-0.335343058,359,292,651
9558,-1.350869376,0.68018326,076-AJV,-0.335343058,238,182,420
9559,-1.350869376,0.68018326,076-AJW,-0.335343058,331,388,719
9560,-1.350869376,0.68018326,076-AET,-0.335343058,270,252,522
9561,-1.350869376,0.68018326,076-AEU,-0.335343058,235,225,460
9562,-1.350869376,0.68018326,076-AEV,-0.335343058,279,229,508
9563,-1.350869376,0.68018326,076-AEW,-0.335343058,226,276,502
9564,-1.350869376,0.68018326,076-AEX,-0.335343058,220,208,428
9565,-1.350869376,0.68018326,076-AEY,-0.335343058,235,235,470
9566,-1.350869376,0.68018326,076-AEZ,-0.335343058,384,267,651
9567,-1.350869376,0.68018326,076-AFA,-0.335343058,282,229,511
9568,-1.350869376,0.68018326,076-AFB,-0.335343058,327,282,609
9569,-1.350869376,0.68018326,076-AFC,-0.335343058,219,200,419
9570,-1.350869376,0.68018326,076-AFD,-0.335343058,489,407,896
9571,-1.350869376,0.68018326,076-AFE,-0.335343058,248,235,483
9572,-1.350869376,0.68018326,076-AFF,-0.335343058,523,379,902
9573,-1.350869376,0.68018326,076-AFG,-0.335343058,209,190,399
9574,-1.350869376,0.68018326,076-AFH,-0.335343058,262,190,452
9575,-1.350869376,0.68018326,076-AFI,-0.335343058,448,390,838
9576,-1.350869376,0.68018326,076-AFJ,-0.335343058,181,186,367
9577,-1.350869376,0.68018326,076-AFK,-0.335343058,297,301,598
9578,-1.350869376,0.68018326,076-AJX,-0.335343058,251,206,457
9579,-1.350869376,0.68018326,076-AJY,-0.335343058,227,192,419
9580,-1.350869376,0.68018326,076-AJZ,-0.335343058,275,256,531
9581,-1.350869376,0.68018326,076-AKA,-0.335343058,142,165,307
9582,-1.350869376,0.68018326,076-AKB,-0.335343058,194,147,341
9583,-1.350869376,0.68018326,076-AKD,-0.335343058,191,215,406
9584,-1.350869376,0.68018326,076-AKE,-0.335343058,151,212,363
9585,-1.350869376,0.68018326,076-AKF,-0.335343058,241,202,443
9586,-1.350869376,0.68018326,076-AKG,-0.335343058,384,306,690
9587,-1.350869376,0.68018326,076-AKH,-0.335343058,386,309,695
9588,-1.350869376,0.68018326,076-AKK,-0.335343058,186,190,376
9589,-1.350869376,0.68018326,076-AKL,-0.335343058,277,245,522
9590,-1.350869376,0.68018326,076-AKO,-0.335343058,174,295,469
9591,-1.350869376,0.68018326,076-AKP,-0.335343058,182,257,439
9592,-1.350869376,0.68018326,076-AKQ,-0.335343058,184,228,412
9593,-1.350869376,0.68018326,076-AKR,-0.335343058,192,259,451
9594,-1.350869376,0.68018326,076-AKS,-0.335343058,187,270,457
9595,-1.350869376,0.68018326,076-AKT,-0.335343058,291,270,561
9596,-1.350869376,0.68018326,076-AKU,-0.335343058,240,299,539
9597,-1.350869376,0.68018326,076-AKV,-0.335343058,185,305,490
9598,-1.350869376,0.68018326,076-AKW,-0.335343058,215,204,419
9599,-1.350869376,0.68018326,076-AKX,-0.335343058,227,294,521
9600,-1.350869376,0.68018326,076-AKY,-0.335343058,177,280,457
9601,-1.350869376,0.68018326,076-AKZ,-0.335343058,216,295,511
9602,-1.350869376,0.68018326,076-ALA,-0.335343058,197,235,432
9603,-1.350869376,0.68018326,076-ALB,-0.335343058,282,315,597
9604,-1.350869376,0.68018326,076-ALC,-0.335343058,206,278,484
9605,-1.350869376,0.68018326,076-ALD,-0.335343058,265,282,547
9606,-1.350869376,0.68018326,076-ALE,-0.335343058,150,236,386
9607,-1.350869376,0.68018326,076-ALF,-0.335343058,268,378,646
9608,-1.350869376,0.68018326,076-ALG,-0.335343058,286,195,481
9609,-1.350869376,0.68018326,076-ALH,-0.335343058,282,312,594
9610,-1.350869376,0.68018326,076-ALI,-0.335343058,214,288,502
9611,-1.350869376,0.68018326,076-ALJ,-0.335343058,149,199,348
9612,-1.350869376,0.68018326,076-ALK,-0.335343058,212,260,472
9613,-1.350869376,0.68018326,076-ALL,-0.335343058,146,221,367
9614,-1.350869376,0.68018326,076-ALM,-0.335343058,201,243,444
9615,-1.350869376,0.68018326,076-ALN,-0.335343058,269,251,520
9616,-1.350869376,0.68018326,076-ALO,-0.335343058,201,235,436
9617,-1.350869376,0.68018326,076-ALP,-0.335343058,243,255,498
9618,-1.350869376,0.68018326,076-ALQ,-0.335343058,181,230,411
9619,-1.350869376,0.68018326,076-ALR,-0.335343058,136,195,331
9620,-1.350869376,0.68018326,076-ALS,-0.335343058,181,199,380
9621,-1.350869376,0.68018326,076-ALT,-0.335343058,108,142,250
9622,-1.350869376,0.68018326,076-ALU,-0.335343058,177,222,399
9623,-1.350869376,0.68018326,076-ALV,-0.335343058,142,147,289
9624,-1.350869376,0.68018326,076-ALW,-0.335343058,149,140,289
9625,-1.350869376,0.68018326,076-ALX,-0.335343058,143,158,301
9626,-1.350869376,0.68018326,076-ALY,-0.335343058,173,217,390
9627,-1.350869376,0.68018326,076-AMA,-0.335343058,179,249,428
9628,-1.350869376,0.68018326,076-AMB,-0.335343058,196,247,443
9629,-1.350869376,0.68018326,076-AMC,-0.335343058,350,318,668
9630,-1.350869376,0.68018326,076-AMD,-0.335343058,331,335,666
9631,-1.350869376,0.68018326,076-AME,-0.335343058,191,351,542
9632,-1.350869376,0.68018326,076-AMF,-0.335343058,323,230,553
9633,-1.350869376,0.68018326,076-AMG,-0.335343058,244,240,484
9634,-1.350869376,0.68018326,076-AMH,-0.335343058,147,215,362
9635,-1.350869376,0.68018326,076-AMI,-0.335343058,413,256,669
9636,-1.350869376,0.68018326,076-AMJ,-0.335343058,184,404,588
9637,-1.350869376,0.68018326,076-AMK,-0.335343058,110,142,252
9638,-1.350869376,0.68018326,076-AML,-0.335343058,95,143,238
9639,-1.350869376,0.68018326,076-AMM,-0.335343058,368,269,637
9640,-1.350869376,0.68018326,076-AMN,-0.335343058,328,229,557
9641,-1.350869376,0.68018326,076-AMO,-0.335343058,248,270,518
9642,-1.350869376,0.68018326,076-AMP,-0.335343058,449,407,856
9643,-1.350869376,0.68018326,076-AMQ,-0.335343058,206,298,504
9644,-1.350869376,0.68018326,076-AMR,-0.335343058,224,240,464
9645,-1.350869376,0.68018326,076-AMS,-0.335343058,212,172,384
9646,-1.350869376,0.68018326,076-AMT,-0.335343058,324,325,649
9647,-1.350869376,0.68018326,076-AMU,-0.335343058,386,355,741
9648,-1.350869376,0.68018326,076-AMV,-0.335343058,129,358,487
9649,-1.350869376,0.68018326,076-AMW,-0.335343058,141,266,407
9650,-1.350869376,0.68018326,076-AMX,-0.335343058,335,270,605
9651,-1.350869376,0.68018326,076-AMY,-0.335343058,359,345,704
9652,-1.350869376,0.68018326,076-AMZ,-0.335343058,269,241,510
9653,-1.350869376,0.68018326,076-ANA,-0.335343058,314,357,671
9654,-1.350869376,0.68018326,076-ANB,-0.335343058,374,311,685
9655,-1.350869376,0.68018326,076-ANC,-0.335343058,265,188,453
9656,-1.350869376,0.68018326,076-AND,-0.335343058,247,296,543
9657,-1.350869376,0.68018326,076-ANF,-0.335343058,352,216,568
9658,-1.350869376,0.68018326,076-ANG,-0.335343058,206,236,442
9659,-1.350869376,0.68018326,076-ANH,-0.335343058,176,259,435
9660,-1.350869376,0.68018326,076-ANI,-0.335343058,224,292,516
9661,-1.350869376,0.68018326,076-ANJ,-0.335343058,284,179,463
9662,-1.350869376,0.68018326,076-ANK,-0.335343058,573,436,1009
9663,-1.350869376,0.68018326,076-ANL,-0.335343058,202,226,428
9664,-1.350869376,0.68018326,076-ANM,-0.335343058,179,238,417
9665,-1.350869376,0.68018326,076-ANN,-0.335343058,195,145,340
9666,-1.350869376,0.68018326,076-ANO,-0.335343058,143,257,400
9667,-1.350869376,0.68018326,076-ANP,-0.335343058,384,235,619
9668,-1.350869376,0.68018326,076-ANQ,-0.335343058,377,295,672
9669,-1.350869376,0.68018326,076-ANT,-0.335343058,213,222,435
9670,-1.350869376,0.68018326,076-ANU,-0.335343058,229,206,435
9671,-1.350869376,0.68018326,076-ANV,-0.335343058,246,280,526
9672,-1.350869376,0.68018326,076-ANW,-0.335343058,94,36,130
9673,-1.350869376,0.68018326,076-ANX,-0.335343058,368,231,599
9674,-1.350869376,0.68018326,076-ANY,-0.335343058,249,249,498
9675,-1.350869376,0.68018326,076-ANZ,-0.335343058,203,142,345
9676,-1.350869376,0.68018326,076-AOA,-0.335343058,269,194,463
9677,-1.350869376,0.68018326,076-AOB,-0.335343058,345,196,541
9678,-1.350869376,0.68018326,076-AOC,-0.335343058,325,265,590
9679,-1.350869376,0.68018326,076-AOG,-0.335343058,219,184,403
9680,-1.350869376,0.68018326,076-AOH,-0.335343058,526,295,821
9681,-1.350869376,0.68018326,076-AOI,-0.335343058,425,273,698
9682,-1.350869376,0.68018326,076-AOJ,-0.335343058,330,229,559
9683,-1.350869376,0.68018326,077-AAA,-0.335343058,108,435,543
9684,-1.350869376,0.68018326,077-AAC,-0.335343058,121,423,544
9685,-1.350869376,0.68018326,077-AAE,-0.335343058,159,391,550
9686,-1.350869376,0.68018326,077-AAF,-0.335343058,111,516,627
9687,-1.350869376,0.68018326,077-AAG,-0.335343058,268,452,720
9688,-1.350869376,0.68018326,077-AAH,-0.335343058,401,510,911
9689,-1.350869376,0.68018326,077-AAI,-0.335343058,162,390,552
9690,-1.350869376,0.68018326,077-AAJ,-0.335343058,195,510,705
9691,-1.350869376,0.68018326,077-AAK,-0.335343058,149,327,476
9692,-1.350869376,0.68018326,077-AAL,-0.335343058,278,409,687
9693,-1.350869376,0.68018326,077-AAM,-0.335343058,181,444,625
9694,-1.350869376,0.68018326,077-AAN,-0.335343058,161,423,584
9695,-1.350869376,0.68018326,077-AAO,-0.335343058,132,383,515
9696,-1.350869376,0.68018326,077-AAP,-0.335343058,151,463,614
9697,-1.350869376,0.68018326,077-AAQ,-0.335343058,298,470,768
9698,-1.350869376,0.68018326,077-AAR,-0.335343058,171,361,532
9699,-1.350869376,0.68018326,077-AAS,-0.335343058,139,410,549
9700,-1.350869376,0.68018326,077-AIF,-0.335343058,181,326,507
9701,-1.350869376,0.68018326,077-AIG,-0.335343058,214,446,660
9702,-1.350869376,0.68018326,077-AIH,-0.335343058,89,509,598
9703,-1.350869376,0.68018326,077-AII,-0.335343058,109,362,471
9704,-1.350869376,0.68018326,077-AIJ,-0.335343058,78,463,541
9705,-1.350869376,0.68018326,077-AIK,-0.335343058,97,409,506
9706,-1.350869376,0.68018326,077-AIL,-0.335343058,160,365,525
9707,-1.350869376,0.68018326,077-AIM,-0.335343058,177,382,559
9708,-1.350869376,0.68018326,077-AIN,-0.335343058,126,460,586
9709,-1.350869376,0.68018326,077-AIO,-0.335343058,166,371,537
9710,-1.350869376,0.68018326,077-AIP,-0.335343058,122,478,600
9711,-1.350869376,0.68018326,077-AIQ,-0.335343058,192,344,536
9712,-1.350869376,0.68018326,077-AIR,-0.335343058,129,489,618
9713,-1.350869376,0.68018326,077-ABC,-0.335343058,162,433,595
9714,-1.350869376,0.68018326,077-ABD,-0.335343058,159,363,522
9715,-1.350869376,0.68018326,077-ABE,-0.335343058,90,304,394
9716,-1.350869376,0.68018326,077-ABF,-0.335343058,73,241,314
9717,-1.350869376,0.68018326,077-ABG,-0.335343058,137,472,609
9718,-1.350869376,0.68018326,077-ABH,-0.335343058,111,326,437
9719,-1.350869376,0.68018326,077-ABI,-0.335343058,140,436,576
9720,-1.350869376,0.68018326,077-ABJ,-0.335343058,122,434,556
9721,-1.350869376,0.68018326,077-ABK,-0.335343058,214,417,631
9722,-1.350869376,0.68018326,077-ABL,-0.335343058,169,361,530
9723,-1.350869376,0.68018326,077-ABM,-0.335343058,95,317,412
9724,-1.350869376,0.68018326,077-ABN,-0.335343058,147,378,525
9725,-1.350869376,0.68018326,077-ABU,-0.335343058,9,641,650
9726,-1.350869376,0.68018326,077-ABV,-0.335343058,63,557,620
9727,-1.350869376,0.68018326,077-ABW,-0.335343058,19,565,584
9728,-1.350869376,0.68018326,077-ABX,-0.335343058,45,562,607
9729,-1.350869376,0.68018326,077-ABY,-0.335343058,58,527,585
9730,-1.350869376,0.68018326,077-ABZ,-0.335343058,35,549,584
9731,-1.350869376,0.68018326,077-ACA,-0.335343058,83,441,524
9732,-1.350869376,0.68018326,077-ACB,-0.335343058,26,423,449
9733,-1.350869376,0.68018326,077-ACC,-0.335343058,10,633,643
9734,-1.350869376,0.68018326,077-ACD,-0.335343058,12,585,597
9735,-1.350869376,0.68018326,077-ACE,-0.335343058,14,491,505
9736,-1.350869376,0.68018326,077-ACF,-0.335343058,10,718,728
9737,-1.350869376,0.68018326,077-ACG,-0.335343058,52,507,559
9738,-1.350869376,0.68018326,077-ACH,-0.335343058,43,618,661
9739,-1.350869376,0.68018326,077-ACN,-0.335343058,158,444,602
9740,-1.350869376,0.68018326,077-ACO,-0.335343058,18,625,643
9741,-1.350869376,0.68018326,077-ACP,-0.335343058,113,501,614
9742,-1.350869376,0.68018326,077-ACQ,-0.335343058,26,573,599
9743,-1.350869376,0.68018326,077-ACR,-0.335343058,58,563,621
9744,-1.350869376,0.68018326,077-ACS,-0.335343058,6,572,578
9745,-1.350869376,0.68018326,077-ACT,-0.335343058,11,543,554
9746,-1.350869376,0.68018326,077-ACU,-0.335343058,45,608,653
9747,-1.350869376,0.68018326,077-ACV,-0.335343058,38,627,665
9748,-1.350869376,0.68018326,077-ACW,-0.335343058,82,536,618
9749,-1.350869376,0.68018326,077-ACX,-0.335343058,94,468,562
9750,-1.350869376,0.68018326,077-ACY,-0.335343058,100,522,622
9751,-1.350869376,0.68018326,077-ACZ,-0.335343058,12,671,683
9752,-1.350869376,0.68018326,077-ADA,-0.335343058,196,376,572
9753,-1.350869376,0.68018326,077-ADB,-0.335343058,9,620,629
9754,-1.350869376,0.68018326,077-ADC,-0.335343058,8,616,624
9755,-1.350869376,0.68018326,077-ADD,-0.335343058,8,638,646
9756,-1.350869376,0.68018326,077-ADE,-0.335343058,105,370,475
9757,-1.350869376,0.68018326,077-ADN,-0.335343058,68,360,428
9758,-1.350869376,0.68018326,077-ADO,-0.335343058,39,698,737
9759,-1.350869376,0.68018326,077-ADP,-0.335343058,47,513,560
9760,-1.350869376,0.68018326,077-ADQ,-0.335343058,25,544,569
9761,-1.350869376,0.68018326,077-ADR,-0.335343058,23,520,543
9762,-1.350869376,0.68018326,077-ADS,-0.335343058,58,564,622
9763,-1.350869376,0.68018326,077-ADT,-0.335343058,73,480,553
9764,-1.350869376,0.68018326,077-ADU,-0.335343058,115,484,599
9765,-1.350869376,0.68018326,077-ADV,-0.335343058,36,588,624
9766,-1.350869376,0.68018326,077-ADW,-0.335343058,47,556,603
9767,-1.350869376,0.68018326,077-ADX,-0.335343058,48,476,524
9768,-1.350869376,0.68018326,077-ADY,-0.335343058,12,651,663
9769,-1.350869376,0.68018326,077-AEF,-0.335343058,219,362,581
9770,-1.350869376,0.68018326,077-AEG,-0.335343058,214,289,503
9771,-1.350869376,0.68018326,077-AEH,-0.335343058,216,339,555
9772,-1.350869376,0.68018326,077-AEI,-0.335343058,215,364,579
9773,-1.350869376,0.68018326,077-AEJ,-0.335343058,228,322,550
9774,-1.350869376,0.68018326,077-AEK,-0.335343058,267,287,554
9775,-1.350869376,0.68018326,077-AEL,-0.335343058,237,321,558
9776,-1.350869376,0.68018326,077-AEM,-0.335343058,226,388,614
9777,-1.350869376,0.68018326,077-AEN,-0.335343058,314,304,618
9778,-1.350869376,0.68018326,077-AEO,-0.335343058,252,343,595
9779,-1.350869376,0.68018326,077-AEP,-0.335343058,221,318,539
9780,-1.350869376,0.68018326,077-AEQ,-0.335343058,245,308,553
9781,-1.350869376,0.68018326,077-AER,-0.335343058,232,351,583
9782,-1.350869376,0.68018326,077-AES,-0.335343058,268,331,599
9783,-1.350869376,0.68018326,077-AET,-0.335343058,234,341,575
9784,-1.350869376,0.68018326,077-AEU,-0.335343058,269,317,586
9785,-1.350869376,0.68018326,077-AEV,-0.335343058,247,332,579
9786,-1.350869376,0.68018326,077-AFE,-0.335343058,132,364,496
9787,-1.350869376,0.68018326,077-AFF,-0.335343058,215,380,595
9788,-1.350869376,0.68018326,077-AFG,-0.335343058,218,323,541
9789,-1.350869376,0.68018326,077-AFH,-0.335343058,178,392,570
9790,-1.350869376,0.68018326,077-AFI,-0.335343058,223,337,560
9791,-1.350869376,0.68018326,077-AFJ,-0.335343058,159,351,510
9792,-1.350869376,0.68018326,077-AFK,-0.335343058,202,317,519
9793,-1.350869376,0.68018326,077-AFL,-0.335343058,119,429,548
9794,-1.350869376,0.68018326,077-AFM,-0.335343058,94,480,574
9795,-1.350869376,0.68018326,077-AFN,-0.335343058,158,411,569
9796,-1.350869376,0.68018326,077-AFO,-0.335343058,221,311,532
9797,-1.350869376,0.68018326,077-AFP,-0.335343058,166,391,557
9798,-1.350869376,0.68018326,077-AFQ,-0.335343058,134,441,575
9799,-1.350869376,0.68018326,077-AFR,-0.335343058,320,366,686
9800,-1.350869376,0.68018326,077-AFS,-0.335343058,221,369,590
9801,-1.350869376,0.68018326,077-AFT,-0.335343058,126,452,578
9802,-1.350869376,0.68018326,077-AGD,-0.335343058,189,403,592
9803,-1.350869376,0.68018326,077-AGF,-0.335343058,289,377,666
9804,-1.350869376,0.68018326,077-AGH,-0.335343058,265,385,650
9805,-1.350869376,0.68018326,077-AGJ,-0.335343058,196,435,631
9806,-1.350869376,0.68018326,077-AGL,-0.335343058,299,311,610
9807,-1.350869376,0.68018326,077-AGN,-0.335343058,248,329,577
9808,-1.350869376,0.68018326,077-AGP,-0.335343058,202,487,689
9809,-1.350869376,0.68018326,077-AGQ,-0.335343058,165,468,633
9810,-1.350869376,0.68018326,077-AGR,-0.335343058,230,381,611
9811,-1.350869376,0.68018326,077-AGS,-0.335343058,405,402,807
9812,-1.350869376,0.68018326,077-AGT,-0.335343058,183,590,773
9813,-1.350869376,0.68018326,077-AGU,-0.335343058,307,312,619
9814,-1.350869376,0.68018326,077-AGV,-0.335343058,161,422,583
9815,-1.350869376,0.68018326,077-AGW,-0.335343058,302,358,660
9816,-1.350869376,0.68018326,077-AGX,-0.335343058,343,310,653
9817,-1.350869376,0.68018326,077-AGY,-0.335343058,179,477,656
9818,-1.350869376,0.68018326,077-AGZ,-0.335343058,217,354,571
9819,-1.350869376,0.68018326,077-AHA,-0.335343058,299,359,658
9820,-1.350869376,0.68018326,077-AHB,-0.335343058,254,392,646
9821,-1.350869376,0.68018326,077-AHC,-0.335343058,329,295,624
9822,-1.350869376,0.68018326,077-AHD,-0.335343058,150,441,591
9823,-1.350869376,0.68018326,077-AHJ,-0.335343058,196,371,567
9824,-1.350869376,0.68018326,077-AHK,-0.335343058,165,499,664
9825,-1.350869376,0.68018326,077-AHL,-0.335343058,165,389,554
9826,-1.350869376,0.68018326,077-AHM,-0.335343058,183,382,565
9827,-1.350869376,0.68018326,077-AHN,-0.335343058,221,330,551
9828,-1.350869376,0.68018326,077-AHO,-0.335343058,202,368,570
9829,-1.350869376,0.68018326,077-AHP,-0.335343058,151,370,521
9830,-1.350869376,0.68018326,077-AHQ,-0.335343058,249,310,559
9831,-1.350869376,0.68018326,077-AHR,-0.335343058,210,348,558
9832,-1.350869376,0.68018326,077-AHS,-0.335343058,178,306,484
9833,-1.350869376,0.68018326,077-AHT,-0.335343058,209,294,503
9834,-1.350869376,0.68018326,077-AHU,-0.335343058,223,324,547
9835,-1.350869376,0.68018326,077-AHV,-0.335343058,162,424,586
9836,-1.350869376,0.68018326,077-AJA,-0.335343058,143,255,398
9837,-1.350869376,0.68018326,077-AJB,-0.335343058,173,217,390
9838,-1.350869376,0.68018326,077-AJC,-0.335343058,186,246,432
9839,-1.350869376,0.68018326,077-AJD,-0.335343058,187,247,434
9840,-1.350869376,0.68018326,077-AJF,-0.335343058,231,294,525
9841,-1.350869376,0.68018326,077-AJG,-0.335343058,186,330,516
9842,-1.350869376,0.68018326,077-AJH,-0.335343058,208,306,514
9843,-1.350869376,0.68018326,077-AJI,-0.335343058,231,291,522
9844,-1.350869376,0.68018326,077-AJL,-0.335343058,142,401,543
9845,-1.350869376,0.68018326,077-AJM,-0.335343058,248,302,550
9846,-1.350869376,0.68018326,077-AJN,-0.335343058,139,483,622
9847,-1.350869376,0.68018326,077-AJO,-0.335343058,367,395,762
9848,-1.350869376,0.68018326,077-AJR,-0.335343058,150,244,394
9849,-1.350869376,0.68018326,077-AJS,-0.335343058,151,317,468
9850,-1.350869376,0.68018326,077-AJT,-0.335343058,182,261,443
9851,-1.350869376,0.68018326,077-AJV,-0.335343058,183,237,420
9852,-1.350869376,0.68018326,077-AJW,-0.335343058,153,261,414
9853,-1.350869376,0.68018326,077-AJX,-0.335343058,173,272,445
9854,-1.350869376,0.68018326,077-AJY,-0.335343058,174,269,443
9855,-1.350869376,0.68018326,077-AKA,-0.335343058,267,257,524
9856,-1.350869376,0.68018326,077-AKB,-0.335343058,204,256,460
9857,-1.350869376,0.68018326,077-AKC,-0.335343058,174,233,407
9858,-1.350869376,0.68018326,077-AKD,-0.335343058,163,255,418
9859,-1.350869376,0.68018326,077-ARA,-0.335343058,325,270,595
9860,-1.350869376,0.68018326,077-ARB,-0.335343058,401,254,655
9861,-1.350869376,0.68018326,077-ARC,-0.335343058,320,221,541
9862,-1.350869376,0.68018326,077-ARD,-0.335343058,350,200,550
9863,-1.350869376,0.68018326,077-ARE,-0.335343058,529,318,847
9864,-1.350869376,0.68018326,077-ARF,-0.335343058,341,223,564
9865,-1.350869376,0.68018326,077-ARG,-0.335343058,281,222,503
9866,-1.350869376,0.68018326,077-ARH,-0.335343058,231,240,471
9867,-1.350869376,0.68018326,077-ARI,-0.335343058,344,235,579
9868,-1.350869376,0.68018326,077-ARJ,-0.335343058,333,232,565
9869,-1.350869376,0.68018326,077-ARK,-0.335343058,247,298,545
9870,-1.350869376,0.68018326,077-ARR,-0.335343058,458,322,780
9871,-1.350869376,0.68018326,077-ARP,-0.335343058,189,244,433
9872,-1.350869376,0.68018326,077-.00,-0.335343058,363,272,635
9873,-1.350869376,0.68018326,077-ARU,-0.335343058,281,268,549
9874,-1.350869376,0.68018326,077-ARV,-0.335343058,221,297,518
9875,-1.350869376,0.68018326,077-ARW,-0.335343058,386,362,748
9876,-1.350869376,0.68018326,077-ARX,-0.335343058,161,315,476
9877,-1.350869376,0.68018326,077-ARY,-0.335343058,155,290,445
9878,-1.350869376,0.68018326,077-ARZ,-0.335343058,485,395,880
9879,-1.350869376,0.68018326,077-ASA,-0.335343058,205,311,516
9880,-1.350869376,0.68018326,077-ASB,-0.335343058,185,327,512
9881,-1.350869376,0.68018326,077-ASC,-0.335343058,245,260,505
9882,-1.350869376,0.68018326,077-ASD,-0.335343058,295,205,500
9883,-1.350869376,0.68018326,077-ASE,-0.335343058,304,252,556
9884,-1.350869376,0.68018326,077-ASF,-0.335343058,391,370,761
9885,-1.350869376,0.68018326,077-ASG,-0.335343058,449,387,836
9886,-1.350869376,0.68018326,077-ASH,-0.335343058,204,277,481
9887,-1.350869376,0.68018326,077-AYH,-0.335343058,375,361,736
9888,-1.350869376,0.68018326,077-ASI,-0.335343058,324,446,770
9889,-1.350869376,0.68018326,077-ASJ,-0.335343058,259,271,530
9890,-1.350869376,0.68018326,077-ASK,-0.335343058,268,303,571
9891,-1.350869376,0.68018326,077-ASL,-0.335343058,193,295,488
9892,-1.350869376,0.68018326,077-ASM,-0.335343058,199,243,442
9893,-1.350869376,0.68018326,077-ASN,-0.335343058,215,261,476
9894,-1.350869376,0.68018326,077-ASO,-0.335343058,228,272,500
9895,-1.350869376,0.68018326,077-ASP,-0.335343058,302,303,605
9896,-1.350869376,0.68018326,077-ASQ,-0.335343058,253,262,515
9897,-1.350869376,0.68018326,077-ASR,-0.335343058,181,306,487
9898,-1.350869376,0.68018326,077-AKF,-0.335343058,256,333,589
9899,-1.350869376,0.68018326,077-AKG,-0.335343058,208,325,533
9900,-1.350869376,0.68018326,077-AKH,-0.335343058,229,353,582
9901,-1.350869376,0.68018326,077-AKI,-0.335343058,183,323,506
9902,-1.350869376,0.68018326,077-AKJ,-0.335343058,196,377,573
9903,-1.350869376,0.68018326,077-AKN,-0.335343058,157,310,467
9904,-1.350869376,0.68018326,077-AKO,-0.335343058,187,308,495
9905,-1.350869376,0.68018326,077-AKP,-0.335343058,225,283,508
9906,-1.350869376,0.68018326,077-AKQ,-0.335343058,197,318,515
9907,-1.350869376,0.68018326,077-AKR,-0.335343058,218,305,523
9908,-1.350869376,0.68018326,077-AKS,-0.335343058,257,281,538
9909,-1.350869376,0.68018326,077-AKV,-0.335343058,268,250,518
9910,-1.350869376,0.68018326,077-AKW,-0.335343058,273,281,554
9911,-1.350869376,0.68018326,077-AKX,-0.335343058,221,269,490
9912,-1.350869376,0.68018326,077-AKY,-0.335343058,241,275,516
9913,-1.350869376,0.68018326,077-AKZ,-0.335343058,200,299,499
9914,-1.350869376,0.68018326,077-ALA,-0.335343058,262,287,549
9915,-1.350869376,0.68018326,077-ALB,-0.335343058,239,266,505
9916,-1.350869376,0.68018326,077-ALE,-0.335343058,197,243,440
9917,-1.350869376,0.68018326,077-ALF,-0.335343058,238,309,547
9918,-1.350869376,0.68018326,077-ALG,-0.335343058,233,337,570
9919,-1.350869376,0.68018326,077-ALH,-0.335343058,224,313,537
9920,-1.350869376,0.68018326,077-ALI,-0.335343058,224,304,528
9921,-1.350869376,0.68018326,077-ALJ,-0.335343058,161,334,495
9922,-1.350869376,0.68018326,077-ALM,-0.335343058,210,319,529
9923,-1.350869376,0.68018326,077-ALN,-0.335343058,180,331,511
9924,-1.350869376,0.68018326,077-ALO,-0.335343058,404,524,928
9925,-1.350869376,0.68018326,077-ALP,-0.335343058,261,360,621
9926,-1.350869376,0.68018326,077-ALQ,-0.335343058,173,288,461
9927,-1.350869376,0.68018326,077-ALR,-0.335343058,252,262,514
9928,-1.350869376,0.68018326,077-ALU,-0.335343058,195,315,510
9929,-1.350869376,0.68018326,077-ALV,-0.335343058,244,277,521
9930,-1.350869376,0.68018326,077-ALW,-0.335343058,240,276,516
9931,-1.350869376,0.68018326,077-ALX,-0.335343058,206,310,516
9932,-1.350869376,0.68018326,077-ALY,-0.335343058,183,295,478
9933,-1.350869376,0.68018326,077-ALZ,-0.335343058,218,280,498
9934,-1.350869376,0.68018326,077-AMC,-0.335343058,194,316,510
9935,-1.350869376,0.68018326,077-AMD,-0.335343058,217,284,501
9936,-1.350869376,0.68018326,077-AME,-0.335343058,157,268,425
9937,-1.350869376,0.68018326,077-AMF,-0.335343058,216,261,477
9938,-1.350869376,0.68018326,077-AMG,-0.335343058,273,254,527
9939,-1.350869376,0.68018326,077-AMH,-0.335343058,198,271,469
9940,-1.350869376,0.68018326,077-AMJ,-0.335343058,234,410,644
9941,-1.350869376,0.68018326,077-AMK,-0.335343058,256,250,506
9942,-1.350869376,0.68018326,077-AML,-0.335343058,377,254,631
9943,-1.350869376,0.68018326,077-AMM,-0.335343058,394,310,704
9944,-1.350869376,0.68018326,077-AMN,-0.335343058,272,293,565
9945,-1.350869376,0.68018326,077-AMO,-0.335343058,506,374,880
9946,-1.350869376,0.68018326,077-AMS,-0.335343058,440,336,776
9947,-1.350869376,0.68018326,077-AMU,-0.335343058,440,432,872
9948,-1.350869376,0.68018326,077-AMW,-0.335343058,307,406,713
9949,-1.350869376,0.68018326,077-AMY,-0.335343058,217,438,655
9950,-1.350869376,0.68018326,077-ANA,-0.335343058,318,368,686
9951,-1.350869376,0.68018326,077-ANC,-0.335343058,277,400,677
9952,-1.350869376,0.68018326,077-AVZ,-0.335343058,563,358,921
9953,-1.350869376,0.68018326,077-AWA,-0.335343058,426,344,770
9954,-1.350869376,0.68018326,077-AWB,-0.335343058,242,281,523
9955,-1.350869376,0.68018326,077-AWC,-0.335343058,287,261,548
9956,-1.350869376,0.68018326,077-AWD,-0.335343058,477,370,847
9957,-1.350869376,0.68018326,077-AWF,-0.335343058,275,256,531
9958,-1.350869376,0.68018326,077-AWG,-0.335343058,199,223,422
9959,-1.350869376,0.68018326,077-AWH,-0.335343058,387,262,649
9960,-1.350869376,0.68018326,077-AWI,-0.335343058,304,262,566
9961,-1.350869376,0.68018326,077-AWJ,-0.335343058,144,142,286
9962,-1.350869376,0.68018326,077-AWK,-0.335343058,292,278,570
9963,-1.350869376,0.68018326,077-AWM,-0.335343058,275,214,489
9964,-1.350869376,0.68018326,077-AWN,-0.335343058,391,289,680
9965,-1.350869376,0.68018326,077-AWO,-0.335343058,332,235,567
9966,-1.350869376,0.68018326,077-AWP,-0.335343058,396,296,692
9967,-1.350869376,0.68018326,077-AWQ,-0.335343058,284,298,582
9968,-1.350869376,0.68018326,077-AWR,-0.335343058,288,280,568
9969,-1.350869376,0.68018326,077-AWT,-0.335343058,300,240,540
9970,-1.350869376,0.68018326,077-AWU,-0.335343058,249,275,524
9971,-1.350869376,0.68018326,077-AWV,-0.335343058,295,229,524
9972,-1.350869376,0.68018326,077-AWW,-0.335343058,317,314,631
9973,-1.350869376,0.68018326,077-AWX,-0.335343058,284,243,527
9974,-1.350869376,0.68018326,077-AWY,-0.335343058,305,295,600
9975,-1.350869376,0.68018326,077-AXA,-0.335343058,320,256,576
9976,-1.350869376,0.68018326,077-AXB,-0.335343058,345,253,598
9977,-1.350869376,0.68018326,077-AXC,-0.335343058,301,274,575
9978,-1.350869376,0.68018326,077-AXD,-0.335343058,329,253,582
9979,-1.350869376,0.68018326,077-AXE,-0.335343058,277,307,584
9980,-1.350869376,0.68018326,077-AYI,-0.335343058,368,264,632
9981,-1.350869376,0.68018326,077-AXG,-0.335343058,368,255,623
9982,-1.350869376,0.68018326,077-AXH,-0.335343058,397,201,598
9983,-1.350869376,0.68018326,077-AXI,-0.335343058,433,250,683
9984,-1.350869376,0.68018326,077-AXJ,-0.335343058,472,313,785
9985,-1.350869376,0.68018326,077-AXK,-0.335343058,361,295,656
9986,-1.350869376,0.68018326,077-AXO,-0.335343058,318,212,530
9987,-1.350869376,0.68018326,077-AXP,-0.335343058,355,191,546
9988,-1.350869376,0.68018326,077-AXQ,-0.335343058,312,237,549
9989,-1.350869376,0.68018326,077-AXR,-0.335343058,305,286,591
9990,-1.350869376,0.68018326,077-AXS,-0.335343058,401,195,596
9991,-1.350869376,0.68018326,077-AXT,-0.335343058,352,240,592
9992,-1.350869376,0.68018326,077-AXV,-0.335343058,467,193,660
9993,-1.350869376,0.68018326,077-AXW,-0.335343058,351,192,543
9994,-1.350869376,0.68018326,077-AXX,-0.335343058,355,204,559
9995,-1.350869376,0.68018326,077-AXY,-0.335343058,354,215,569
9996,-1.350869376,0.68018326,077-AXZ,-0.335343058,326,245,571
9997,-1.350869376,0.68018326,077-AYA,-0.335343058,319,252,571
9998,-1.350869376,0.68018326,077-ATK,-0.335343058,203,253,456
9999,-1.350869376,0.68018326,077-ATL,-0.335343058,344,430,774
10000,-1.350869376,0.68018326,077-ANE,-0.335343058,424,535,959
10001,-1.350869376,0.68018326,077-ANF,-0.335343058,335,463,798
10002,-1.350869376,0.68018326,077-ANG,-0.335343058,190,283,473
10003,-1.350869376,0.68018326,077-ANH,-0.335343058,299,352,651
10004,-1.350869376,0.68018326,077-ANI,-0.335343058,284,332,616
10005,-1.350869376,0.68018326,077-ANJ,-0.335343058,316,386,702
10006,-1.350869376,0.68018326,077-ANK,-0.335343058,259,250,509
10007,-1.350869376,0.68018326,077-ANL,-0.335343058,265,246,511
10008,-1.350869376,0.68018326,077-ANM,-0.335343058,228,303,531
10009,-1.350869376,0.68018326,077-ANN,-0.335343058,298,225,523
10010,-1.350869376,0.68018326,077-ATN,-0.335343058,213,258,471
10011,-1.350869376,0.68018326,077-ATO,-0.335343058,212,238,450
10012,-1.350869376,0.68018326,077-ATP,-0.335343058,250,262,512
10013,-1.350869376,0.68018326,077-ATR,-0.335343058,248,238,486
10014,-1.350869376,0.68018326,077-ATS,-0.335343058,258,281,539
10015,-1.350869376,0.68018326,077-ATT,-0.335343058,178,284,462
10016,-1.350869376,0.68018326,077-ATU,-0.335343058,202,279,481
10017,-1.350869376,0.68018326,077-ATV,-0.335343058,267,309,576
10018,-1.350869376,0.68018326,077-ATW,-0.335343058,326,271,597
10019,-1.350869376,0.68018326,077-ASV,-0.335343058,275,293,568
10020,-1.350869376,0.68018326,077-ASW,-0.335343058,285,310,595
10021,-1.350869376,0.68018326,077-ASX,-0.335343058,319,388,707
10022,-1.350869376,0.68018326,077-ASY,-0.335343058,273,261,534
10023,-1.350869376,0.68018326,077-ASZ,-0.335343058,247,259,506
10024,-1.350869376,0.68018326,077-ATA,-0.335343058,258,229,487
10025,-1.350869376,0.68018326,077-ATB,-0.335343058,280,244,524
10026,-1.350869376,0.68018326,077-ATC,-0.335343058,320,285,605
10027,-1.350869376,0.68018326,077-ATD,-0.335343058,268,242,510
10028,-1.350869376,0.68018326,077-ATE,-0.335343058,270,189,459
10029,-1.350869376,0.68018326,077-ATF,-0.335343058,287,254,541
10030,-1.350869376,0.68018326,077-ATG,-0.335343058,321,306,627
10031,-1.350869376,0.68018326,077-AYD,-0.335343058,291,308,599
10032,-1.350869376,0.68018326,077-AYE,-0.335343058,306,223,529
10033,-1.350869376,0.68018326,077-AUC,-0.335343058,280,273,553
10034,-1.350869376,0.68018326,077-AUD,-0.335343058,228,261,489
10035,-1.350869376,0.68018326,077-AUE,-0.335343058,518,699,1217
10036,-1.350869376,0.68018326,077-AUF,-0.335343058,323,243,566
10037,-1.350869376,0.68018326,077-AUG,-0.335343058,261,265,526
10038,-1.350869376,0.68018326,077-ATY,-0.335343058,171,257,428
10039,-1.350869376,0.68018326,077-ATZ,-0.335343058,185,253,438
10040,-1.350869376,0.68018326,077-AUA,-0.335343058,158,210,368
10041,-1.350869376,0.68018326,077-AUB,-0.335343058,184,253,437
10042,-1.350869376,0.68018326,077-ANO,-0.335343058,302,210,512
10043,-1.350869376,0.68018326,077-ANP,-0.335343058,280,268,548
10044,-1.350869376,0.68018326,077-ANQ,-0.335343058,251,250,501
10045,-1.350869376,0.68018326,077-ANS,-0.335343058,224,283,507
10046,-1.350869376,0.68018326,077-ANT,-0.335343058,313,296,609
10047,-1.350869376,0.68018326,077-ANU,-0.335343058,357,368,725
10048,-1.350869376,0.68018326,077-ANW,-0.335343058,267,286,553
10049,-1.350869376,0.68018326,077-ANX,-0.335343058,249,246,495
10050,-1.350869376,0.68018326,077-ANY,-0.335343058,256,262,518
10051,-1.350869376,0.68018326,077-AOA,-0.335343058,236,247,483
10052,-1.350869376,0.68018326,077-AOB,-0.335343058,263,281,544
10053,-1.350869376,0.68018326,077-AOC,-0.335343058,216,276,492
10054,-1.350869376,0.68018326,077-ARO,-0.335343058,146,210,356
10055,-1.350869376,0.68018326,077-AUI,-0.335343058,423,609,1032
10056,-1.350869376,0.68018326,077-AUJ,-0.335343058,358,330,688
10057,-1.350869376,0.68018326,077-AUL,-0.335343058,550,393,943
10058,-1.350869376,0.68018326,077-AUM,-0.335343058,358,296,654
10059,-1.350869376,0.68018326,077-AUN,-0.335343058,476,251,727
10060,-1.350869376,0.68018326,077-AUO,-0.335343058,264,199,463
10061,-1.350869376,0.68018326,077-AUP,-0.335343058,224,222,446
10062,-1.350869376,0.68018326,077-AUQ,-0.335343058,259,218,477
10063,-1.350869376,0.68018326,077-AUS,-0.335343058,426,334,760
10064,-1.350869376,0.68018326,077-AUT,-0.335343058,305,263,568
10065,-1.350869376,0.68018326,077-AUU,-0.335343058,294,238,532
10066,-1.350869376,0.68018326,077-AUV,-0.335343058,289,236,525
10067,-1.350869376,0.68018326,077-AUW,-0.335343058,328,285,613
10068,-1.350869376,0.68018326,077-AUX,-0.335343058,357,312,669
10069,-1.350869376,0.68018326,077-AUY,-0.335343058,446,540,986
10070,-1.350869376,0.68018326,077-AUZ,-0.335343058,10,30,40
10071,-1.350869376,0.68018326,077-AVA,-0.335343058,235,341,576
10072,-1.350869376,0.68018326,077-AVB,-0.335343058,320,325,645
10073,-1.350869376,0.68018326,077-AVC,-0.335343058,316,260,576
10074,-1.350869376,0.68018326,077-AVD,-0.335343058,228,206,434
10075,-1.350869376,0.68018326,077-AVE,-0.335343058,238,183,421
10076,-1.350869376,0.68018326,077-AVF,-0.335343058,243,205,448
10077,-1.350869376,0.68018326,077-AVG,-0.335343058,252,214,466
10078,-1.350869376,0.68018326,077-AVH,-0.335343058,212,216,428
10079,-1.350869376,0.68018326,077-AVI,-0.335343058,217,261,478
10080,-1.350869376,0.68018326,077-AVJ,-0.335343058,268,222,490
10081,-1.350869376,0.68018326,077-AVK,-0.335343058,263,237,500
10082,-1.350869376,0.68018326,077-AVL,-0.335343058,233,267,500
10083,-1.350869376,0.68018326,077-AVM,-0.335343058,174,250,424
10084,-1.350869376,0.68018326,077-AVN,-0.335343058,294,202,496
10085,-1.350869376,0.68018326,077-AVO,-0.335343058,276,238,514
10086,-1.350869376,0.68018326,077-AVP,-0.335343058,215,227,442
10087,-1.350869376,0.68018326,077-AVQ,-0.335343058,289,272,561
10088,-1.350869376,0.68018326,077-AVR,-0.335343058,195,230,425
10089,-1.350869376,0.68018326,077-AVS,-0.335343058,199,240,439
10090,-1.350869376,0.68018326,077-AVT,-0.335343058,321,278,599
10091,-1.350869376,0.68018326,077-AVU,-0.335343058,242,270,512
10092,-1.350869376,0.68018326,077-AOD,-0.335343058,289,348,637
10093,-1.350869376,0.68018326,077-AOE,-0.335343058,270,323,593
10094,-1.350869376,0.68018326,077-AOF,-0.335343058,314,352,666
10095,-1.350869376,0.68018326,077-AOG,-0.335343058,373,437,810
10096,-1.350869376,0.68018326,077-AOH,-0.335343058,277,350,627
10097,-1.350869376,0.68018326,077-AOI,-0.335343058,481,416,897
10098,-1.350869376,0.68018326,077-AOJ,-0.335343058,360,380,740
10099,-1.350869376,0.68018326,077-AOM,-0.335343058,375,345,720
10100,-1.350869376,0.68018326,077-AON,-0.335343058,318,250,568
10101,-1.350869376,0.68018326,077-AOO,-0.335343058,313,288,601
10102,-1.350869376,0.68018326,077-AOP,-0.335343058,461,442,903
10103,-1.350869376,0.68018326,077-AOQ,-0.335343058,423,304,727
10104,-1.350869376,0.68018326,077-AOR,-0.335343058,339,308,647
10105,-1.350869376,0.68018326,077-AOS,-0.335343058,313,269,582
10106,-1.350869376,0.68018326,077-AOT,-0.335343058,278,282,560
10107,-1.350869376,0.68018326,077-AOX,-0.335343058,289,262,551
10108,-1.350869376,0.68018326,077-AOY,-0.335343058,336,428,764
10109,-1.350869376,0.68018326,077-AOZ,-0.335343058,274,295,569
10110,-1.350869376,0.68018326,077-APA,-0.335343058,201,275,476
10111,-1.350869376,0.68018326,077-APB,-0.335343058,219,302,521
10112,-1.350869376,0.68018326,077-APC,-0.335343058,201,289,490
10113,-1.350869376,0.68018326,077-APD,-0.335343058,225,285,510
10114,-1.350869376,0.68018326,077-APG,-0.335343058,308,306,614
10115,-1.350869376,0.68018326,077-APH,-0.335343058,290,325,615
10116,-1.350869376,0.68018326,077-API,-0.335343058,344,255,599
10117,-1.350869376,0.68018326,077-APJ,-0.335343058,290,284,574
10118,-1.350869376,0.68018326,077-APK,-0.335343058,304,289,593
10119,-1.350869376,0.68018326,077-APL,-0.335343058,333,341,674
10120,-1.350869376,0.68018326,077-APM,-0.335343058,264,384,648
10121,-1.350869376,0.68018326,077-APN,-0.335343058,321,325,646
10122,-1.350869376,0.68018326,077-APQ,-0.335343058,461,499,960
10123,-1.350869376,0.68018326,077-APR,-0.335343058,233,270,503
10124,-1.350869376,0.68018326,077-APS,-0.335343058,181,366,547
10125,-1.350869376,0.68018326,077-APT,-0.335343058,216,282,498
10126,-1.350869376,0.68018326,077-APV,-0.335343058,219,208,427
10127,-1.350869376,0.68018326,077-APW,-0.335343058,266,303,569
10128,-1.350869376,0.68018326,077-APX,-0.335343058,324,252,576
10129,-1.350869376,0.68018326,077-APY,-0.335343058,315,291,606
10130,-1.350869376,0.68018326,077-APZ,-0.335343058,266,234,500
10131,-1.350869376,0.68018326,077-AQB,-0.335343058,253,256,509
10132,-1.350869376,0.68018326,077-AQC,-0.335343058,273,277,550
10133,-1.350869376,0.68018326,077-AQD,-0.335343058,232,304,536
10134,-1.350869376,0.68018326,077-AQE,-0.335343058,267,226,493
10135,-1.350869376,0.68018326,077-AQF,-0.335343058,297,267,564
10136,-1.350869376,0.68018326,077-AQG,-0.335343058,277,286,563
10137,-1.350869376,0.68018326,077-AQH,-0.335343058,207,276,483
10138,-1.350869376,0.68018326,077-AQI,-0.335343058,269,284,553
10139,-1.350869376,0.68018326,077-AQJ,-0.335343058,299,354,653
10140,-1.350869376,0.68018326,077-AVX,-0.335343058,527,459,986
10141,-1.350869376,0.68018326,077-AVY,-0.335343058,64,583,647
10142,-1.350869376,0.68018326,077-AQL,-0.335343058,286,374,660
10143,-1.350869376,0.68018326,077-AQM,-0.335343058,276,348,624
10144,-1.350869376,0.68018326,077-AQN,-0.335343058,245,313,558
10145,-1.350869376,0.68018326,077-AQO,-0.335343058,234,332,566
10146,-1.350869376,0.68018326,077-AQP,-0.335343058,253,339,592
10147,-1.350869376,0.68018326,077-AQQ,-0.335343058,319,468,787
10148,-1.350869376,0.68018326,077-AQR,-0.335343058,200,217,417
10149,-1.350869376,0.68018326,077-AQS,-0.335343058,352,479,831
10150,-1.350869376,0.68018326,077-AQT,-0.335343058,331,392,723
10151,-1.350869376,0.68018326,077-AYG,-0.335343058,220,264,484
10152,-1.350869376,0.68018326,077-AQU,-0.335343058,199,374,573
10153,-1.350869376,0.68018326,077-AQV,-0.335343058,300,281,581
10154,-1.350869376,0.68018326,077-AQW,-0.335343058,298,345,643
10155,-1.350869376,0.68018326,077-AQX,-0.335343058,323,428,751
10156,-1.350869376,0.68018326,077-AQY,-0.335343058,264,496,760
10157,-1.350869376,0.68018326,077-AQZ,-0.335343058,232,273,505
10158,-1.350869376,0.68018326,078-AEQ,-0.335343058,244,278,522
10159,-1.350869376,0.68018326,078-AER,-0.335343058,200,356,556
10160,-1.350869376,0.68018326,078-AES,-0.335343058,106,176,282
10161,-1.350869376,0.68018326,078-AET,-0.335343058,363,234,597
10162,-1.350869376,0.68018326,078-AEU,-0.335343058,214,243,457
10163,-1.350869376,0.68018326,078-AEV,-0.335343058,332,354,686
10164,-1.350869376,0.68018326,078-AEW,-0.335343058,188,232,420
10165,-1.350869376,0.68018326,078-AEX,-0.335343058,293,178,471
10166,-1.350869376,0.68018326,078-AEY,-0.335343058,243,299,542
10167,-1.350869376,0.68018326,078-AEZ,-0.335343058,159,257,416
10168,-1.350869376,0.68018326,078-AFA,-0.335343058,161,263,424
10169,-1.350869376,0.68018326,078-AFB,-0.335343058,197,223,420
10170,-1.350869376,0.68018326,078-AFC,-0.335343058,262,256,518
10171,-1.350869376,0.68018326,078-AFD,-0.335343058,282,231,513
10172,-1.350869376,0.68018326,078-AFQ,-0.335343058,128,152,280
10173,-1.350869376,0.68018326,078-AFE,-0.335343058,141,167,308
10174,-1.350869376,0.68018326,078-AFF,-0.335343058,83,175,258
10175,-1.350869376,0.68018326,078-AFG,-0.335343058,74,206,280
10176,-1.350869376,0.68018326,078-AFH,-0.335343058,132,251,383
10177,-1.350869376,0.68018326,078-AFI,-0.335343058,94,178,272
10178,-1.350869376,0.68018326,078-AFJ,-0.335343058,81,236,317
10179,-1.350869376,0.68018326,078-AFK,-0.335343058,173,224,397
10180,-1.350869376,0.68018326,078-AFL,-0.335343058,222,259,481
10181,-1.350869376,0.68018326,078-AFM,-0.335343058,115,217,332
10182,-1.350869376,0.68018326,078-AFN,-0.335343058,152,286,438
10183,-1.350869376,0.68018326,078-AFO,-0.335343058,89,189,278
10184,-1.350869376,0.68018326,078-AFP,-0.335343058,204,271,475
10185,-1.350869376,0.68018326,078-AFR,-0.335343058,214,286,500
10186,-1.350869376,0.68018326,078-AFS,-0.335343058,181,203,384
10187,-1.350869376,0.68018326,078-AFT,-0.335343058,168,244,412
10188,-1.350869376,0.68018326,078-AFU,-0.335343058,195,250,445
10189,-1.350869376,0.68018326,078-AFV,-0.335343058,338,398,736
10190,-1.350869376,0.68018326,078-AFW,-0.335343058,169,262,431
10191,-1.350869376,0.68018326,078-AFX,-0.335343058,204,219,423
10192,-1.350869376,0.68018326,078-AFY,-0.335343058,184,195,379
10193,-1.350869376,0.68018326,078-AFZ,-0.335343058,117,167,284
10194,-1.350869376,0.68018326,078-AGA,-0.335343058,249,260,509
10195,-1.350869376,0.68018326,078-AGB,-0.335343058,198,215,413
10196,-1.350869376,0.68018326,078-AKY,-0.335343058,173,189,362
10197,-1.350869376,0.68018326,078-AKQ,-0.335343058,233,263,496
10198,-1.350869376,0.68018326,078-AKR,-0.335343058,215,247,462
10199,-1.350869376,0.68018326,078-AKS,-0.335343058,268,256,524
10200,-1.350869376,0.68018326,078-AKT,-0.335343058,212,296,508
10201,-1.350869376,0.68018326,078-AKU,-0.335343058,170,232,402
10202,-1.350869376,0.68018326,078-AKV,-0.335343058,250,301,551
10203,-1.350869376,0.68018326,078-AKW,-0.335343058,243,220,463
10204,-1.350869376,0.68018326,078-AKX,-0.335343058,346,335,681
10205,-1.350869376,0.68018326,078-AGC,-0.335343058,360,268,628
10206,-1.350869376,0.68018326,078-AGE,-0.335343058,355,298,653
10207,-1.350869376,0.68018326,078-AGF,-0.335343058,153,204,357
10208,-1.350869376,0.68018326,078-AGG,-0.335343058,202,160,362
10209,-1.350869376,0.68018326,078-AAA,-0.335343058,235,336,571
10210,-1.350869376,0.68018326,078-AAB,-0.335343058,121,219,340
10211,-1.350869376,0.68018326,078-AAC,-0.335343058,100,319,419
10212,-1.350869376,0.68018326,078-AAE,-0.335343058,135,252,387
10213,-1.350869376,0.68018326,078-AAF,-0.335343058,95,287,382
10214,-1.350869376,0.68018326,078-AAG,-0.335343058,74,243,317
10215,-1.350869376,0.68018326,078-AAH,-0.335343058,81,196,277
10216,-1.350869376,0.68018326,078-AAI,-0.335343058,50,190,240
10217,-1.350869376,0.68018326,078-AAJ,-0.335343058,118,268,386
10218,-1.350869376,0.68018326,078-AAK,-0.335343058,116,191,307
10219,-1.350869376,0.68018326,078-AAL,-0.335343058,98,213,311
10220,-1.350869376,0.68018326,078-AAM,-0.335343058,91,254,345
10221,-1.350869376,0.68018326,078-AAN,-0.335343058,61,266,327
10222,-1.350869376,0.68018326,078-AAO,-0.335343058,78,231,309
10223,-1.350869376,0.68018326,078-AGH,-0.335343058,234,209,443
10224,-1.350869376,0.68018326,078-AGI,-0.335343058,242,234,476
10225,-1.350869376,0.68018326,078-AGK,-0.335343058,131,137,268
10226,-1.350869376,0.68018326,078-AGL,-0.335343058,252,232,484
10227,-1.350869376,0.68018326,078-AGM,-0.335343058,197,228,425
10228,-1.350869376,0.68018326,078-AGN,-0.335343058,100,200,300
10229,-1.350869376,0.68018326,078-AGO,-0.335343058,72,155,227
10230,-1.350869376,0.68018326,078-AGP,-0.335343058,185,140,325
10231,-1.350869376,0.68018326,078-AGQ,-0.335343058,258,301,559
10232,-1.350869376,0.68018326,078-AGR,-0.335343058,144,246,390
10233,-1.350869376,0.68018326,078-AGS,-0.335343058,105,207,312
10234,-1.350869376,0.68018326,078-AGT,-0.335343058,153,225,378
10235,-1.350869376,0.68018326,078-AGU,-0.335343058,368,278,646
10236,-1.350869376,0.68018326,078-AGV,-0.335343058,322,333,655
10237,-1.350869376,0.68018326,078-AKZ,-0.335343058,255,268,523
10238,-1.350869376,0.68018326,078-AGW,-0.335343058,166,275,441
10239,-1.350869376,0.68018326,078-AGX,-0.335343058,124,148,272
10240,-1.350869376,0.68018326,078-AGY,-0.335343058,292,240,532
10241,-1.350869376,0.68018326,078-AGZ,-0.335343058,108,171,279
10242,-1.350869376,0.68018326,078-AHA,-0.335343058,162,239,401
10243,-1.350869376,0.68018326,078-AHB,-0.335343058,205,315,520
10244,-1.350869376,0.68018326,078-AHC,-0.335343058,210,258,468
10245,-1.350869376,0.68018326,078-AHD,-0.335343058,119,171,290
10246,-1.350869376,0.68018326,078-AHE,-0.335343058,335,252,587
10247,-1.350869376,0.68018326,078-AHF,-0.335343058,153,234,387
10248,-1.350869376,0.68018326,078-AHG,-0.335343058,234,274,508
10249,-1.350869376,0.68018326,078-AHH,-0.335343058,232,229,461
10250,-1.350869376,0.68018326,078-AHI,-0.335343058,254,316,570
10251,-1.350869376,0.68018326,078-AAQ,-0.335343058,214,242,456
10252,-1.350869376,0.68018326,078-AAR,-0.335343058,177,264,441
10253,-1.350869376,0.68018326,078-AAS,-0.335343058,150,229,379
10254,-1.350869376,0.68018326,078-AAT,-0.335343058,166,226,392
10255,-1.350869376,0.68018326,078-AAU,-0.335343058,149,171,320
10256,-1.350869376,0.68018326,078-AAV,-0.335343058,150,172,322
10257,-1.350869376,0.68018326,078-AAW,-0.335343058,147,276,423
10258,-1.350869376,0.68018326,078-AAX,-0.335343058,164,243,407
10259,-1.350869376,0.68018326,078-AAZ,-0.335343058,90,205,295
10260,-1.350869376,0.68018326,078-ABA,-0.335343058,129,256,385
10261,-1.350869376,0.68018326,078-ABB,-0.335343058,106,222,328
10262,-1.350869376,0.68018326,078-AHJ,-0.335343058,178,267,445
10263,-1.350869376,0.68018326,078-AHK,-0.335343058,176,178,354
10264,-1.350869376,0.68018326,078-AHL,-0.335343058,99,259,358
10265,-1.350869376,0.68018326,078-AHM,-0.335343058,159,237,396
10266,-1.350869376,0.68018326,078-AHN,-0.335343058,103,224,327
10267,-1.350869376,0.68018326,078-AHO,-0.335343058,145,211,356
10268,-1.350869376,0.68018326,078-AHP,-0.335343058,180,208,388
10269,-1.350869376,0.68018326,078-AHQ,-0.335343058,176,198,374
10270,-1.350869376,0.68018326,078-AHR,-0.335343058,236,298,534
10271,-1.350869376,0.68018326,078-AHS,-0.335343058,262,217,479
10272,-1.350869376,0.68018326,078-AHT,-0.335343058,160,127,287
10273,-1.350869376,0.68018326,078-AHU,-0.335343058,125,149,274
10274,-1.350869376,0.68018326,078-AHV,-0.335343058,228,147,375
10275,-1.350869376,0.68018326,078-AHW,-0.335343058,158,261,419
10276,-1.350869376,0.68018326,078-AHX,-0.335343058,110,217,327
10277,-1.350869376,0.68018326,078-AHY,-0.335343058,207,299,506
10278,-1.350869376,0.68018326,078-AHZ,-0.335343058,103,269,372
10279,-1.350869376,0.68018326,078-AIA,-0.335343058,171,248,419
10280,-1.350869376,0.68018326,078-AIB,-0.335343058,91,193,284
10281,-1.350869376,0.68018326,078-AIC,-0.335343058,52,274,326
10282,-1.350869376,0.68018326,078-AID,-0.335343058,127,256,383
10283,-1.350869376,0.68018326,078-AIE,-0.335343058,272,315,587
10284,-1.350869376,0.68018326,078-AIF,-0.335343058,40,248,288
10285,-1.350869376,0.68018326,078-AIG,-0.335343058,201,273,474
10286,-1.350869376,0.68018326,078-AIH,-0.335343058,97,178,275
10287,-1.350869376,0.68018326,078-AII,-0.335343058,80,180,260
10288,-1.350869376,0.68018326,078-AIJ,-0.335343058,131,268,399
10289,-1.350869376,0.68018326,078-AIL,-0.335343058,64,213,277
10290,-1.350869376,0.68018326,078-AIM,-0.335343058,133,289,422
10291,-1.350869376,0.68018326,078-AIN,-0.335343058,273,238,511
10292,-1.350869376,0.68018326,078-AIO,-0.335343058,82,174,256
10293,-1.350869376,0.68018326,078-AIP,-0.335343058,229,288,517
10294,-1.350869376,0.68018326,078-AIQ,-0.335343058,212,347,559
10295,-1.350869376,0.68018326,078-AIR,-0.335343058,218,336,554
10296,-1.350869376,0.68018326,078-AIS,-0.335343058,146,168,314
10297,-1.350869376,0.68018326,078-AKM,-0.335343058,228,386,614
10298,-1.350869376,0.68018326,078-AKN,-0.335343058,114,199,313
10299,-1.350869376,0.68018326,078-AKO,-0.335343058,162,270,432
10300,-1.350869376,0.68018326,078-AKP,-0.335343058,142,311,453
10301,-1.350869376,0.68018326,078-AIT,-0.335343058,240,263,503
10302,-1.350869376,0.68018326,078-AIU,-0.335343058,204,241,445
10303,-1.350869376,0.68018326,078-AIV,-0.335343058,183,198,381
10304,-1.350869376,0.68018326,078-AIW,-0.335343058,142,81,223
10305,-1.350869376,0.68018326,078-AIX,-0.335343058,153,83,236
10306,-1.350869376,0.68018326,078-AJD,-0.335343058,224,284,508
10307,-1.350869376,0.68018326,078-AJF,-0.335343058,159,247,406
10308,-1.350869376,0.68018326,078-AJG,-0.335343058,217,342,559
10309,-1.350869376,0.68018326,078-AJH,-0.335343058,214,296,510
10310,-1.350869376,0.68018326,078-AIY,-0.335343058,160,249,409
10311,-1.350869376,0.68018326,078-AIZ,-0.335343058,210,262,472
10312,-1.350869376,0.68018326,078-AJA,-0.335343058,150,197,347
10313,-1.350869376,0.68018326,078-AJB,-0.335343058,243,283,526
10314,-1.350869376,0.68018326,078-AJC,-0.335343058,176,217,393
10315,-1.350869376,0.68018326,078-ABD,-0.335343058,113,262,375
10316,-1.350869376,0.68018326,078-ABE,-0.335343058,97,228,325
10317,-1.350869376,0.68018326,078-ABF,-0.335343058,119,333,452
10318,-1.350869376,0.68018326,078-ABG,-0.335343058,115,269,384
10319,-1.350869376,0.68018326,078-ABH,-0.335343058,116,258,374
10320,-1.350869376,0.68018326,078-ALC,-0.335343058,107,225,332
10321,-1.350869376,0.68018326,078-ABJ,-0.335343058,125,275,400
10322,-1.350869376,0.68018326,078-ABK,-0.335343058,168,244,412
10323,-1.350869376,0.68018326,078-ABL,-0.335343058,151,279,430
10324,-1.350869376,0.68018326,078-ABM,-0.335343058,76,182,258
10325,-1.350869376,0.68018326,078-ABN,-0.335343058,68,237,305
10326,-1.350869376,0.68018326,078-ALA,-0.335343058,112,243,355
10327,-1.350869376,0.68018326,078-ABP,-0.335343058,51,224,275
10328,-1.350869376,0.68018326,078-ABQ,-0.335343058,52,175,227
10329,-1.350869376,0.68018326,078-ABR,-0.335343058,85,232,317
10330,-1.350869376,0.68018326,078-ABS,-0.335343058,128,278,406
10331,-1.350869376,0.68018326,078-ABT,-0.335343058,109,247,356
10332,-1.350869376,0.68018326,078-ABU,-0.335343058,109,222,331
10333,-1.350869376,0.68018326,078-ABV,-0.335343058,156,314,470
10334,-1.350869376,0.68018326,078-ABX,-0.335343058,107,159,266
10335,-1.350869376,0.68018326,078-ABY,-0.335343058,114,225,339
10336,-1.350869376,0.68018326,078-ABZ,-0.335343058,57,146,203
10337,-1.350869376,0.68018326,078-ACA,-0.335343058,54,155,209
10338,-1.350869376,0.68018326,078-ACB,-0.335343058,65,163,228
10339,-1.350869376,0.68018326,078-ACC,-0.335343058,116,290,406
10340,-1.350869376,0.68018326,078-ACD,-0.335343058,60,148,208
10341,-1.350869376,0.68018326,078-ALD,-0.335343058,102,221,323
10342,-1.350869376,0.68018326,078-AGJ,-0.335343058,50,40,90
10343,-1.350869376,0.68018326,078-AJI,-0.335343058,144,167,311
10344,-1.350869376,0.68018326,078-AJJ,-0.335343058,298,299,597
10345,-1.350869376,0.68018326,078-AJK,-0.335343058,208,183,391
10346,-1.350869376,0.68018326,078-AJL,-0.335343058,262,338,600
10347,-1.350869376,0.68018326,078-AJM,-0.335343058,203,199,402
10348,-1.350869376,0.68018326,078-AJN,-0.335343058,179,151,330
10349,-1.350869376,0.68018326,078-AJO,-0.335343058,278,291,569
10350,-1.350869376,0.68018326,078-AJP,-0.335343058,273,285,558
10351,-1.350869376,0.68018326,078-AJQ,-0.335343058,214,254,468
10352,-1.350869376,0.68018326,078-AJR,-0.335343058,178,159,337
10353,-1.350869376,0.68018326,078-AJS,-0.335343058,135,162,297
10354,-1.350869376,0.68018326,078-ACF,-0.335343058,134,246,380
10355,-1.350869376,0.68018326,078-ACG,-0.335343058,75,265,340
10356,-1.350869376,0.68018326,078-ACH,-0.335343058,92,175,267
10357,-1.350869376,0.68018326,078-ACI,-0.335343058,66,192,258
10358,-1.350869376,0.68018326,078-ACJ,-0.335343058,49,265,314
10359,-1.350869376,0.68018326,078-ACL,-0.335343058,68,203,271
10360,-1.350869376,0.68018326,078-ACM,-0.335343058,67,195,262
10361,-1.350869376,0.68018326,078-ACN,-0.335343058,106,200,306
10362,-1.350869376,0.68018326,078-ACO,-0.335343058,104,235,339
10363,-1.350869376,0.68018326,078-ACP,-0.335343058,82,241,323
10364,-1.350869376,0.68018326,078-ACQ,-0.335343058,69,184,253
10365,-1.350869376,0.68018326,078-ACR,-0.335343058,60,178,238
10366,-1.350869376,0.68018326,078-ACS,-0.335343058,124,266,390
10367,-1.350869376,0.68018326,078-ACT,-0.335343058,46,259,305
10368,-1.350869376,0.68018326,078-ACU,-0.335343058,83,164,247
10369,-1.350869376,0.68018326,078-ACV,-0.335343058,68,247,315
10370,-1.350869376,0.68018326,078-ACW,-0.335343058,40,238,278
10371,-1.350869376,0.68018326,078-ACX,-0.335343058,80,154,234
10372,-1.350869376,0.68018326,078-ACY,-0.335343058,64,140,204
10373,-1.350869376,0.68018326,078-ACZ,-0.335343058,135,259,394
10374,-1.350869376,0.68018326,078-ADA,-0.335343058,138,215,353
10375,-1.350869376,0.68018326,078-ADB,-0.335343058,109,175,284
10376,-1.350869376,0.68018326,078-ADC,-0.335343058,149,157,306
10377,-1.350869376,0.68018326,078-ADD,-0.335343058,109,235,344
10378,-1.350869376,0.68018326,078-ADE,-0.335343058,109,165,274
10379,-1.350869376,0.68018326,078-ADF,-0.335343058,135,196,331
10380,-1.350869376,0.68018326,078-ADG,-0.335343058,153,213,366
10381,-1.350869376,0.68018326,078-ADH,-0.335343058,137,212,349
10382,-1.350869376,0.68018326,078-ALB,-0.335343058,225,165,390
10383,-1.350869376,0.68018326,078-ADI,-0.335343058,79,179,258
10384,-1.350869376,0.68018326,078-ADJ,-0.335343058,55,163,218
10385,-1.350869376,0.68018326,078-ADK,-0.335343058,49,185,234
10386,-1.350869376,0.68018326,078-ADL,-0.335343058,64,123,187
10387,-1.350869376,0.68018326,078-ADM,-0.335343058,88,223,311
10388,-1.350869376,0.68018326,078-ADN,-0.335343058,7,270,277
10389,-1.350869376,0.68018326,078-ADO,-0.335343058,43,124,167
10390,-1.350869376,0.68018326,078-ADP,-0.335343058,25,206,231
10391,-1.350869376,0.68018326,078-ADQ,-0.335343058,95,186,281
10392,-1.350869376,0.68018326,078-ADS,-0.335343058,87,142,229
10393,-1.350869376,0.68018326,078-ADT,-0.335343058,141,262,403
10394,-1.350869376,0.68018326,078-ADU,-0.335343058,83,246,329
10395,-1.350869376,0.68018326,078-ADV,-0.335343058,138,228,366
10396,-1.350869376,0.68018326,078-ADW,-0.335343058,48,259,307
10397,-1.350869376,0.68018326,078-ADX,-0.335343058,50,367,417
10398,-1.350869376,0.68018326,078-ADZ,-0.335343058,255,322,577
10399,-1.350869376,0.68018326,078-AEA,-0.335343058,62,159,221
10400,-1.350869376,0.68018326,078-AEB,-0.335343058,28,278,306
10401,-1.350869376,0.68018326,078-AEC,-0.335343058,2,442,444
10402,-1.350869376,0.68018326,078-AED,-0.335343058,14,294,308
10403,-1.350869376,0.68018326,078-AEE,-0.335343058,18,364,382
10404,-1.350869376,0.68018326,078-AEF,-0.335343058,40,358,398
10405,-1.350869376,0.68018326,078-AEH,-0.335343058,22,332,354
10406,-1.350869376,0.68018326,078-AEI,-0.335343058,30,256,286
10407,-1.350869376,0.68018326,078-AEJ,-0.335343058,114,314,428
10408,-1.350869376,0.68018326,078-AEK,-0.335343058,108,279,387
10409,-1.350869376,0.68018326,078-AEL,-0.335343058,74,264,338
10410,-1.350869376,0.68018326,078-AEM,-0.335343058,42,406,448
10411,-1.350869376,0.68018326,078-AEN,-0.335343058,51,195,246
10412,-1.350869376,0.68018326,078-AJT,-0.335343058,109,239,348
10413,-1.350869376,0.68018326,078-AJU,-0.335343058,199,290,489
10414,-1.350869376,0.68018326,078-AJW,-0.335343058,73,392,465
10415,-1.350869376,0.68018326,078-AJX,-0.335343058,99,200,299
10416,-1.350869376,0.68018326,078-AJY,-0.335343058,159,299,458
10417,-1.350869376,0.68018326,078-AJZ,-0.335343058,185,255,440
10418,-1.350869376,0.68018326,078-AKA,-0.335343058,101,203,304
10419,-1.350869376,0.68018326,078-AKB,-0.335343058,220,353,573
10420,-1.350869376,0.68018326,078-AKC,-0.335343058,106,208,314
10421,-1.350869376,0.68018326,078-AKD,-0.335343058,144,219,363
10422,-1.350869376,0.68018326,078-AKE,-0.335343058,140,226,366
10423,-1.350869376,0.68018326,078-AKF,-0.335343058,182,284,466
10424,-1.350869376,0.68018326,078-AKG,-0.335343058,104,186,290
10425,-1.350869376,0.68018326,078-AKH,-0.335343058,71,146,217
10426,-1.350869376,0.68018326,078-AKI,-0.335343058,100,192,292
10427,-1.350869376,0.68018326,078-AKJ,-0.335343058,121,256,377
10428,-1.350869376,0.68018326,078-AKK,-0.335343058,95,174,269
10429,-1.350869376,0.68018326,078-AKL,-0.335343058,127,207,334
10430,-1.350869376,0.68018326,078-AGD,-0.335343058,106,83,189
10431,-1.350869376,0.68018326,079-ABW,-0.335343058,236,132,368
10432,-1.350869376,0.68018326,079-ABX,-0.335343058,167,108,275
10433,-1.350869376,0.68018326,079-ADE,-0.335343058,253,240,493
10434,-1.350869376,0.68018326,079-ABY,-0.335343058,288,103,391
10435,-1.350869376,0.68018326,079-ABZ,-0.335343058,136,188,324
10436,-1.350869376,0.68018326,079-ADI,-0.335343058,175,291,466
10437,-1.350869376,0.68018326,079-ADJ,-0.335343058,130,363,493
10438,-1.350869376,0.68018326,079-AAA,-0.335343058,232,273,505
10439,-1.350869376,0.68018326,079-AAB,-0.335343058,251,281,532
10440,-1.350869376,0.68018326,079-AAC,-0.335343058,320,290,610
10441,-1.350869376,0.68018326,079-AAE,-0.335343058,311,324,635
10442,-1.350869376,0.68018326,079-AAF,-0.335343058,389,282,671
10443,-1.350869376,0.68018326,079-AAG,-0.335343058,405,367,772
10444,-1.350869376,0.68018326,079-AAI,-0.335343058,183,239,422
10445,-1.350869376,0.68018326,079-AAJ,-0.335343058,174,306,480
10446,-1.350869376,0.68018326,079-AAK,-0.335343058,246,295,541
10447,-1.350869376,0.68018326,079-AAM,-0.335343058,119,219,338
10448,-1.350869376,0.68018326,079-AAN,-0.335343058,117,276,393
10449,-1.350869376,0.68018326,079-AAO,-0.335343058,219,274,493
10450,-1.350869376,0.68018326,079-ACD,-0.335343058,384,291,675
10451,-1.350869376,0.68018326,079-ACE,-0.335343058,310,293,603
10452,-1.350869376,0.68018326,079-ACF,-0.335343058,430,342,772
10453,-1.350869376,0.68018326,079-ACG,-0.335343058,242,245,487
10454,-1.350869376,0.68018326,079-ACI,-0.335343058,415,369,784
10455,-1.350869376,0.68018326,079-ACK,-0.335343058,556,414,970
10456,-1.350869376,0.68018326,079-ACA,-0.335343058,291,379,670
10457,-1.350869376,0.68018326,079-ACT,-0.335343058,219,349,568
10458,-1.350869376,0.68018326,079-ACR,-0.335343058,270,288,558
10459,-1.350869376,0.68018326,079-ACS,-0.335343058,270,279,549
10460,-1.350869376,0.68018326,079-ACU,-0.335343058,293,276,569
10461,-1.350869376,0.68018326,079-ACZ,-0.335343058,245,241,486
10462,-1.350869376,0.68018326,079-ADA,-0.335343058,548,355,903
10463,-1.350869376,0.68018326,079-ADB,-0.335343058,257,195,452
10464,-1.350869376,0.68018326,079-ADC,-0.335343058,383,293,676
10465,-1.350869376,0.68018326,079-ACP,-0.335343058,96,179,275
10466,-1.350869376,0.68018326,079-ADG,-0.335343058,327,516,843
10467,-1.350869376,0.68018326,079-ADY,-0.335343058,101,174,275
10468,-1.350869376,0.68018326,079-AAQ,-0.335343058,163,303,466
10469,-1.350869376,0.68018326,079-AAR,-0.335343058,188,255,443
10470,-1.350869376,0.68018326,079-AAS,-0.335343058,237,338,575
10471,-1.350869376,0.68018326,079-AAT,-0.335343058,158,249,407
10472,-1.350869376,0.68018326,079-AAX,-0.335343058,270,320,590
10473,-1.350869376,0.68018326,079-AAY,-0.335343058,289,267,556
10474,-1.350869376,0.68018326,079-AAZ,-0.335343058,346,299,645
10475,-1.350869376,0.68018326,079-ABA,-0.335343058,195,284,479
10476,-1.350869376,0.68018326,079-ABE,-0.335343058,151,281,432
10477,-1.350869376,0.68018326,079-ABF,-0.335343058,146,246,392
10478,-1.350869376,0.68018326,079-ABG,-0.335343058,109,178,287
10479,-1.350869376,0.68018326,079-ABH,-0.335343058,154,289,443
10480,-1.350869376,0.68018326,079-ABK,-0.335343058,290,267,557
10481,-1.350869376,0.68018326,079-ABL,-0.335343058,292,320,612
10482,-1.350869376,0.68018326,079-ABM,-0.335343058,363,389,752
10483,-1.350869376,0.68018326,079-AEU,-0.335343058,254,202,456
10484,-1.350869376,0.68018326,079-ADN,-0.335343058,299,291,590
10485,-1.350869376,0.68018326,079-ADO,-0.335343058,158,282,440
10486,-1.350869376,0.68018326,079-ADP,-0.335343058,170,231,401
10487,-1.350869376,0.68018326,079-ADM,-0.335343058,288,232,520
10488,-1.350869376,0.68018326,079-ADS,-0.335343058,83,111,194
10489,-1.350869376,0.68018326,079-ADW,-0.335343058,102,108,210
10490,-1.350869376,0.68018326,079-ADT,-0.335343058,174,176,350
10491,-1.350869376,0.68018326,079-ADV,-0.335343058,273,251,524
10492,-1.350869376,0.68018326,079-ADZ,-0.335343058,238,271,509
10493,-1.350869376,0.68018326,079-AEA,-0.335343058,241,236,477
10494,-1.350869376,0.68018326,079-ACX,-0.335343058,313,199,512
10495,-1.350869376,0.68018326,079-ACM,-0.335343058,328,325,653
10496,-1.350869376,0.68018326,079-ACN,-0.335343058,322,280,602
10497,-1.350869376,0.68018326,079-AEC,-0.335343058,375,121,496
10498,-1.350869376,0.68018326,079-AED,-0.335343058,464,205,669
10499,-1.350869376,0.68018326,079-AEE,-0.335343058,262,129,391
10500,-1.350869376,0.68018326,079-AEM,-0.335343058,199,319,518
10501,-1.350869376,0.68018326,079-ABO,-0.335343058,166,281,447
10502,-1.350869376,0.68018326,079-ABQ,-0.335343058,152,240,392
10503,-1.350869376,0.68018326,079-ABS,-0.335343058,141,331,472
10504,-1.350869376,0.68018326,079-ABU,-0.335343058,175,364,539
10505,-1.350869376,0.68018326,079-AEG,-0.335343058,260,331,591
10506,-1.350869376,0.68018326,079-AEI,-0.335343058,304,247,551
10507,-1.350869376,0.68018326,079-AEJ,-0.335343058,193,227,420
10508,-1.350869376,0.68018326,079-AEK,-0.335343058,167,233,400
10509,-1.350869376,0.68018326,079-AEN,-0.335343058,193,126,319
10510,-1.350869376,0.68018326,079-AEO,-0.335343058,439,218,657
10511,-1.350869376,0.68018326,079-AEP,-0.335343058,382,317,699
10512,-1.350869376,0.68018326,080-AAN,-0.335343058,366,160,526
10513,-1.350869376,0.68018326,080-ABW,-0.335343058,505,234,739
10514,-1.350869376,0.68018326,080-AAO,-0.335343058,188,118,306
10515,-1.350869376,0.68018326,080-AAP,-0.335343058,238,125,363
10516,-1.350869376,0.68018326,080-AAU,-0.335343058,233,72,305
10517,-1.350869376,0.68018326,080-AAV,-0.335343058,409,186,595
10518,-1.350869376,0.68018326,080-AAW,-0.335343058,213,109,322
10519,-1.350869376,0.68018326,080-AAX,-0.335343058,315,167,482
10520,-1.350869376,0.68018326,080-AAY,-0.335343058,437,233,670
10521,-1.350869376,0.68018326,080-ABX,-0.335343058,190,90,280
10522,-1.350869376,0.68018326,080-ABY,-0.335343058,371,310,681
10523,-1.350869376,0.68018326,080-AAZ,-0.335343058,312,116,428
10524,-1.350869376,0.68018326,080-ABA,-0.335343058,607,255,862
10525,-1.350869376,0.68018326,080-ABB,-0.335343058,173,116,289
10526,-1.350869376,0.68018326,080-ABC,-0.335343058,219,119,338
10527,-1.350869376,0.68018326,080-ABD,-0.335343058,357,148,505
10528,-1.350869376,0.68018326,080-ABF,-0.335343058,374,120,494
10529,-1.350869376,0.68018326,080-ABG,-0.335343058,400,222,622
10530,-1.350869376,0.68018326,080-ABI,-0.335343058,325,165,490
10531,-1.350869376,0.68018326,080-ABJ,-0.335343058,370,218,588
10532,-1.350869376,0.68018326,080-ABH,-0.335343058,56,40,96
10533,-1.350869376,0.68018326,080-AAA,-0.335343058,374,322,696
10534,-1.350869376,0.68018326,080-AAH,-0.335343058,294,196,490
10535,-1.350869376,0.68018326,080-AAI,-0.335343058,605,317,922
10536,-1.350869376,0.68018326,080-AAE,-0.335343058,314,278,592
10537,-1.350869376,0.68018326,080-AAB,-0.335343058,545,372,917
10538,-1.350869376,0.68018326,080-ABV,-0.335343058,562,349,911
10539,-1.350869376,0.68018326,080-AAF,-0.335343058,138,96,234
10540,-1.350869376,0.68018326,080-AAG,-0.335343058,442,292,734
10541,-1.350869376,0.68018326,080-AAC,-0.335343058,300,269,569
10542,-1.350869376,0.68018326,080-AAK,-0.335343058,286,223,509
10543,-1.350869376,0.68018326,080-AAJ,-0.335343058,344,241,585
10544,-1.350869376,0.68018326,080-AAL,-0.335343058,306,162,468
10545,-1.350869376,0.68018326,080-AAM,-0.335343058,422,171,593
10546,-1.350869376,0.68018326,080-AAD,-0.335343058,350,216,566
10547,-1.350869376,0.68018326,080-ABQ,-0.335343058,251,122,373
10548,-1.350869376,0.68018326,080-ABK,-0.335343058,528,229,757
10549,-1.350869376,0.68018326,080-ABL,-0.335343058,416,203,619
10550,-1.350869376,0.68018326,080-ABM,-0.335343058,208,103,311
10551,-1.350869376,0.68018326,080-ABE,-0.335343058,258,117,375
10552,-1.350869376,0.68018326,080-AAQ,-0.335343058,246,163,409
10553,-1.350869376,0.68018326,080-AAS,-0.335343058,237,188,425
10554,-1.350869376,0.68018326,080-ABO,-0.335343058,295,160,455
10555,-1.350869376,0.68018326,080-ABP,-0.335343058,278,130,408
10556,-1.350869376,0.68018326,080-ABR,-0.335343058,222,103,325
10557,-1.350869376,0.68018326,080-ABS,-0.335343058,189,70,259
10558,-1.350869376,0.68018326,080-ABT,-0.335343058,260,130,390
10559,-1.350869376,0.68018326,080-ABU,-0.335343058,416,216,632
10560,-1.350869376,0.68018326,081-ABG,-0.335343058,237,225,462
10561,-1.350869376,0.68018326,081-AAA,-0.335343058,134,66,200
10562,-1.350869376,0.68018326,081-AAB,-0.335343058,163,132,295
10563,-1.350869376,0.68018326,081-AAC,-0.335343058,161,110,271
10564,-1.350869376,0.68018326,081-AAD,-0.335343058,157,110,267
10565,-1.350869376,0.68018326,081-AAE,-0.335343058,237,101,338
10566,-1.350869376,0.68018326,081-AAU,-0.335343058,413,184,597
10567,-1.350869376,0.68018326,081-AAV,-0.335343058,228,124,352
10568,-1.350869376,0.68018326,081-AAW,-0.335343058,179,60,239
10569,-1.350869376,0.68018326,081-AAX,-0.335343058,254,89,343
10570,-1.350869376,0.68018326,081-AAY,-0.335343058,322,132,454
10571,-1.350869376,0.68018326,081-ABL,-0.335343058,144,98,242
10572,-1.350869376,0.68018326,081-AAZ,-0.335343058,188,121,309
10573,-1.350869376,0.68018326,081-ABA,-0.335343058,280,115,395
10574,-1.350869376,0.68018326,081-ABB,-0.335343058,298,171,469
10575,-1.350869376,0.68018326,081-ABC,-0.335343058,224,141,365
10576,-1.350869376,0.68018326,081-ABD,-0.335343058,483,236,719
10577,-1.350869376,0.68018326,081-ABF,-0.335343058,368,171,539
10578,-1.350869376,0.68018326,081-ABI,-0.335343058,317,159,476
10579,-1.350869376,0.68018326,081-AAF,-0.335343058,121,140,261
10580,-1.350869376,0.68018326,081-AAG,-0.335343058,150,130,280
10581,-1.350869376,0.68018326,081-AAH,-0.335343058,126,112,238
10582,-1.350869376,0.68018326,081-AAI,-0.335343058,152,96,248
10583,-1.350869376,0.68018326,081-AAJ,-0.335343058,210,155,365
10584,-1.350869376,0.68018326,081-AAK,-0.335343058,161,160,321
10585,-1.350869376,0.68018326,081-AAL,-0.335343058,185,140,325
10586,-1.350869376,0.68018326,081-AAM,-0.335343058,157,88,245
10587,-1.350869376,0.68018326,081-AAN,-0.335343058,161,93,254
10588,-1.350869376,0.68018326,081-AAO,-0.335343058,285,176,461
10589,-1.350869376,0.68018326,081-AAP,-0.335343058,220,161,381
10590,-1.350869376,0.68018326,081-AAQ,-0.335343058,119,121,240
10591,-1.350869376,0.68018326,081-AAR,-0.335343058,211,161,372
10592,-1.350869376,0.68018326,081-AAS,-0.335343058,256,141,397
10593,-1.350869376,0.68018326,081-AAT,-0.335343058,393,162,555
10594,-1.350869376,0.68018326,081-ABJ,-0.335343058,334,103,437
10595,-1.350869376,0.68018326,081-ABK,-0.335343058,264,82,346
10596,-1.350869376,0.68018326,081-ABM,-0.335343058,315,194,509
10597,-1.350869376,0.68018326,081-ABN,-0.335343058,224,118,342
10598,-1.350869376,0.68018326,081-ABO,-0.335343058,337,100,437
10599,-1.350869376,0.68018326,082-AAA,-0.335343058,71,67,138
10600,-1.350869376,0.68018326,082-AAB,-0.335343058,221,178,399
10601,-1.350869376,0.68018326,082-AAF,-0.335343058,99,126,225
10602,-1.350869376,0.68018326,082-AAG,-0.335343058,312,230,542
10603,-1.350869376,0.68018326,082-AAD,-0.335343058,105,89,194
10604,-1.350869376,0.68018326,082-AAE,-0.335343058,81,58,139
10605,-1.350869376,0.68018326,082-AAK,-0.335343058,266,181,447
10606,-1.350869376,0.68018326,082-AAL,-0.335343058,200,156,356
10607,-1.350869376,0.68018326,082-AAM,-0.335343058,129,152,281
10608,-1.350869376,0.68018326,082-AAN,-0.335343058,74,69,143
10609,-1.350869376,0.68018326,082-AAH,-0.335343058,170,122,292
10610,-1.350869376,0.68018326,082-AAI,-0.335343058,184,120,304
10611,-1.350869376,0.68018326,082-AAJ,-0.335343058,93,61,154
10612,-1.350869376,0.68018326,082-AAP,-0.335343058,215,155,370
10613,-1.350869376,0.68018326,082-AAQ,-0.335343058,156,166,322
10614,-1.350869376,0.68018326,082-AAR,-0.335343058,237,162,399
10615,-1.350869376,0.68018326,082-AAS,-0.335343058,117,143,260
10616,-1.350869376,0.68018326,082-AAW,-0.335343058,38,23,61
10617,-1.350869376,0.68018326,082-AAU,-0.335343058,173,137,310
10618,-1.350869376,0.68018326,082-AAO,-0.335343058,80,68,148
10619,-1.350869376,0.68018326,083-AAA,-0.335343058,297,199,496
10620,-1.350869376,0.68018326,083-AAB,-0.335343058,340,160,500
10621,-1.350869376,0.68018326,083-AAC,-0.335343058,247,149,396
10622,-1.350869376,0.68018326,083-AAD,-0.335343058,335,184,519
10623,-1.350869376,0.68018326,083-AAE,-0.335343058,246,170,416
10624,-1.350869376,0.68018326,083-AAF,-0.335343058,418,233,651
10625,-1.350869376,0.68018326,083-AAG,-0.335343058,496,253,749
10626,-1.350869376,0.68018326,083-AAH,-0.335343058,424,240,664
10627,-1.350869376,0.68018326,083-AAI,-0.335343058,239,149,388
10628,-1.350869376,0.68018326,083-AAJ,-0.335343058,303,160,463
10629,-1.350869376,0.68018326,083-AAK,-0.335343058,354,147,501
10630,-1.350869376,0.68018326,083-AAL,-0.335343058,325,241,566
10631,-1.350869376,0.68018326,083-AAN,-0.335343058,472,221,693
10632,-1.350869376,0.68018326,083-AAM,-0.335343058,392,181,573
10633,-1.350869376,0.68018326,083-AAO,-0.335343058,439,213,652
10634,-1.350869376,0.68018326,083-AAP,-0.335343058,546,232,778
10635,-1.350869376,0.68018326,083-AAR,-0.335343058,358,203,561
10636,-1.350869376,0.68018326,083-AAS,-0.335343058,438,230,668
10637,-1.350869376,0.68018326,083-AAT,-0.335343058,603,254,857
10638,-1.350869376,0.68018326,083-AAU,-0.335343058,298,141,439
10639,-1.350869376,0.68018326,083-AAV,-0.335343058,356,226,582
10640,-1.350869376,0.68018326,083-AAX,-0.335343058,279,141,420
10641,-1.350869376,0.68018326,083-AAZ,-0.335343058,351,175,526
10642,-1.350869376,0.68018326,083-ABB,-0.335343058,412,200,612
10643,-1.350869376,0.68018326,083-ABC,-0.335343058,269,128,397
10644,-1.350869376,0.68018326,083-ABE,-0.335343058,406,210,616
10645,-1.350869376,0.68018326,083-ABI,-0.335343058,482,256,738
10646,-1.350869376,0.68018326,083-AES,-0.335343058,302,125,427
10647,-1.350869376,0.68018326,083-AEW,-0.335343058,245,150,395
10648,-1.350869376,0.68018326,083-AEY,-0.335343058,253,123,376
10649,-1.350869376,0.68018326,083-AFC,-0.335343058,293,153,446
10650,-1.350869376,0.68018326,083-AFD,-0.335343058,261,126,387
10651,-1.350869376,0.68018326,083-ABJ,-0.335343058,732,317,1049
10652,-1.350869376,0.68018326,083-ABK,-0.335343058,547,204,751
10653,-1.350869376,0.68018326,083-ABN,-0.335343058,492,162,654
10654,-1.350869376,0.68018326,083-ABO,-0.335343058,517,204,721
10655,-1.350869376,0.68018326,083-ABP,-0.335343058,392,141,533
10656,-1.350869376,0.68018326,083-ABQ,-0.335343058,568,250,818
10657,-1.350869376,0.68018326,083-ABS,-0.335343058,433,182,615
10658,-1.350869376,0.68018326,083-ABT,-0.335343058,421,214,635
10659,-1.350869376,0.68018326,083-ABW,-0.335343058,336,176,512
10660,-1.350869376,0.68018326,083-ABX,-0.335343058,431,232,663
10661,-1.350869376,0.68018326,083-ACD,-0.335343058,434,272,706
10662,-1.350869376,0.68018326,083-ACH,-0.335343058,495,255,750
10663,-1.350869376,0.68018326,083-ACZ,-0.335343058,382,179,561
10664,-1.350869376,0.68018326,083-ADA,-0.335343058,187,123,310
10665,-1.350869376,0.68018326,083-ADB,-0.335343058,341,170,511
10666,-1.350869376,0.68018326,083-ACM,-0.335343058,311,157,468
10667,-1.350869376,0.68018326,083-ACO,-0.335343058,260,138,398
10668,-1.350869376,0.68018326,083-ACP,-0.335343058,415,209,624
10669,-1.350869376,0.68018326,083-ACR,-0.335343058,224,102,326
10670,-1.350869376,0.68018326,083-ACS,-0.335343058,594,223,817
10671,-1.350869376,0.68018326,083-ACU,-0.335343058,381,203,584
10672,-1.350869376,0.68018326,083-ACV,-0.335343058,255,162,417
10673,-1.350869376,0.68018326,083-ACW,-0.335343058,440,227,667
10674,-1.350869376,0.68018326,083-ACX,-0.335343058,254,101,355
10675,-1.350869376,0.68018326,083-ADE,-0.335343058,360,138,498
10676,-1.350869376,0.68018326,083-ADD,-0.335343058,525,196,721
10677,-1.350869376,0.68018326,083-ADG,-0.335343058,715,281,996
10678,-1.350869376,0.68018326,083-ADH,-0.335343058,578,201,779
10679,-1.350869376,0.68018326,083-ADI,-0.335343058,628,217,845
10680,-1.350869376,0.68018326,083-ADL,-0.335343058,437,141,578
10681,-1.350869376,0.68018326,083-ADM,-0.335343058,342,107,449
10682,-1.350869376,0.68018326,083-ADN,-0.335343058,387,123,510
10683,-1.350869376,0.68018326,083-ADP,-0.335343058,197,93,290
10684,-1.350869376,0.68018326,083-ADQ,-0.335343058,280,103,383
10685,-1.350869376,0.68018326,083-ADU,-0.335343058,157,106,263
10686,-1.350869376,0.68018326,083-ADR,-0.335343058,291,113,404
10687,-1.350869376,0.68018326,083-ADT,-0.335343058,474,180,654
10688,-1.350869376,0.68018326,083-ADY,-0.335343058,454,124,578
10689,-1.350869376,0.68018326,083-ADZ,-0.335343058,427,124,551
10690,-1.350869376,0.68018326,083-AEB,-0.335343058,520,120,640
10691,-1.350869376,0.68018326,083-.00,-0.335343058,310,98,408
10692,-1.350869376,0.68018326,083-AEE,-0.335343058,321,192,513
10693,-1.350869376,0.68018326,083-AEH,-0.335343058,299,123,422
10694,-1.350869376,0.68018326,083-AEI,-0.335343058,640,319,959
10695,-1.350869376,0.68018326,083-AEF,-0.335343058,502,140,642
10696,-1.350869376,0.68018326,083-AEK,-0.335343058,669,173,842
10697,-1.350869376,0.68018326,083-AEQ,-0.335343058,484,248,732
10698,-1.350869376,0.68018326,083-AER,-0.335343058,531,238,769
10699,-1.350869376,0.68018326,083-AEM,-0.335343058,635,200,835
10700,-1.350869376,0.68018326,083-AEN,-0.335343058,543,187,730
10701,-1.350869376,0.68018326,083-AEO,-0.335343058,459,177,636
10702,-1.350869376,0.68018326,083-ABY,-0.335343058,367,223,590
10703,-1.350869376,0.68018326,083-AEJ,-0.335343058,475,195,670
10704,-1.350869376,0.68018326,083-ABZ,-0.335343058,411,263,674
10705,-1.350869376,0.68018326,083-ACK,-0.335343058,422,213,635
10706,-1.350869376,0.68018326,083-ACN,-0.335343058,193,133,326
10707,-1.350869376,0.68018326,083-ACY,-0.335343058,245,212,457
10708,-1.350869376,0.68018326,083-AEA,-0.335343058,620,201,821
10709,-1.350869376,0.68018326,083-ABF,-0.335343058,309,170,479
10710,-1.350869376,0.68018326,083-AET,-0.335343058,506,195,701
10711,-1.350869376,0.68018326,083-AEZ,-0.335343058,247,135,382
10712,-1.350869376,0.68018326,083-ABU,-0.335343058,423,211,634
10713,-1.350869376,0.68018326,083-ADF,-0.335343058,573,232,805
10714,-1.350869376,0.68018326,083-AAW,-0.335343058,322,153,475
10715,-1.350869376,0.68018326,083-ABG,-0.335343058,430,199,629
10716,-1.350869376,0.68018326,083-ABV,-0.335343058,377,261,638
10717,-1.350869376,0.68018326,083-ACJ,-0.335343058,498,356,854
10718,-1.350869376,0.68018326,083-ADC,-0.335343058,585,236,821
10719,-1.350869376,0.68018326,083-ACL,-0.335343058,264,130,394
10720,-1.350869376,0.68018326,083-ACT,-0.335343058,256,145,401
10721,-1.350869376,0.68018326,083-ADJ,-0.335343058,615,291,906
10722,-1.350869376,0.68018326,083-ADO,-0.335343058,438,160,598
10723,-1.350869376,0.68018326,083-ADV,-0.335343058,114,84,198
10724,-1.350869376,0.68018326,083-ADS,-0.335343058,517,199,716
10725,-1.350869376,0.68018326,083-ADX,-0.335343058,393,118,511
10726,-1.350869376,0.68018326,083-AEC,-0.335343058,500,211,711
10727,-1.350869376,0.68018326,083-AEG,-0.335343058,121,94,215
10728,-1.350869376,0.68018326,083-AEL,-0.335343058,440,180,620
10729,-1.350869376,0.68018326,083-AEP,-0.335343058,634,220,854
10730,-1.350869376,0.68018326,083-ABL,-0.335343058,473,148,621
10731,-1.350869376,0.68018326,083-ACQ,-0.335343058,230,142,372
10732,-1.350869376,0.68018326,083-ABR,-0.335343058,293,197,490
10733,-1.350869376,0.68018326,083-ACA,-0.335343058,274,115,389
10734,-1.350869376,0.68018326,083-ACE,-0.335343058,411,247,658
10735,-1.350869376,0.68018326,083-ACI,-0.335343058,358,218,576
10736,-1.350869376,0.68018326,083-ABM,-0.335343058,438,144,582
10737,-1.350869376,0.68018326,083-ACB,-0.335343058,271,246,517
10738,-1.350869376,0.68018326,083-ABD,-0.335343058,591,370,961
10739,-1.350869376,0.68018326,083-ACF,-0.335343058,464,233,697
10740,-1.350869376,0.68018326,083-ADK,-0.335343058,544,202,746
10741,-1.350869376,0.68018326,083-AFB,-0.335343058,461,213,674
10742,-1.350869376,0.68018326,083-AEU,-0.335343058,280,163,443
10743,-1.350869376,0.68018326,083-AFA,-0.335343058,348,131,479
10744,-1.350869376,0.68018326,083-ADW,-0.335343058,561,150,711
10745,-1.350869376,0.68018326,083-AEV,-0.335343058,471,174,645
10746,-1.350869376,0.68018326,083-AAY,-0.335343058,599,368,967
10747,-1.350869376,0.68018326,083-ACC,-0.335343058,253,131,384
10748,-1.350869376,0.68018326,083-AEX,-0.335343058,535,232,767
10749,-1.350869376,0.68018326,083-ABA,-0.335343058,447,269,716
10750,-1.350869376,0.68018326,083-ABH,-0.335343058,454,231,685
10751,-1.350869376,0.68018326,083-ACG,-0.335343058,457,201,658
10752,-1.350869376,0.68018326,083-AAQ,-0.335343058,451,203,654
10753,-1.350869376,0.68018326,083-AFE,-0.335343058,339,210,549
10754,-1.350869376,0.68018326,083-AFF,-0.335343058,415,194,609
10755,-1.350869376,0.68018326,083-AFG,-0.335343058,465,228,693
10756,-1.350869376,0.68018326,083-AFH,-0.335343058,253,252,505
10757,-1.350869376,0.68018326,083-AFK,-0.335343058,621,204,825
10758,-1.350869376,0.68018326,083-AFI,-0.335343058,303,171,474
10759,-1.350869376,0.68018326,083-AFJ,-0.335343058,470,184,654
10760,-1.350869376,0.68018326,083-AFL,-0.335343058,566,248,814
10761,-1.350869376,0.68018326,083-AFM,-0.335343058,249,232,481
10762,-1.350869376,0.68018326,083-AFN,-0.335343058,559,225,784
10763,-1.350869376,0.68018326,083-AFO,-0.335343058,254,132,386
10764,-1.350869376,0.68018326,083-AFP,-0.335343058,514,205,719
10765,-1.350869376,0.68018326,083-AFQ,-0.335343058,574,308,882
10766,-1.350869376,0.68018326,083-AFR,-0.335343058,462,241,703
10767,-1.350869376,0.68018326,083-AFS,-0.335343058,523,305,828
10768,-1.350869376,0.68018326,083-AFT,-0.335343058,441,269,710
10769,-1.350869376,0.68018326,083-AFU,-0.335343058,528,278,806
10770,-1.350869376,0.68018326,083-AFV,-0.335343058,502,224,726
10771,-1.350869376,0.68018326,083-AFW,-0.335343058,293,138,431
10772,-1.350869376,0.68018326,083-AFX,-0.335343058,518,208,726
10773,-1.350869376,0.68018326,083-AFY,-0.335343058,604,253,857
10774,-1.350869376,0.68018326,083-AFZ,-0.335343058,384,153,537
10775,-1.350869376,0.68018326,083-AGA,-0.335343058,569,317,886
10776,-1.350869376,0.68018326,083-AGB,-0.335343058,398,177,575
10777,-1.350869376,0.68018326,083-AGC,-0.335343058,399,184,583
10778,-1.350869376,0.68018326,083-AGD,-0.335343058,416,223,639
10779,-1.350869376,0.68018326,083-AGE,-0.335343058,461,285,746
10780,-1.350869376,0.68018326,083-AGF,-0.335343058,593,182,775
10781,-1.350869376,0.68018326,083-AGG,-0.335343058,531,317,848
10782,-1.350869376,0.68018326,083-AGH,-0.335343058,552,241,793
10783,-1.350869376,0.68018326,083-AGI,-0.335343058,571,223,794
10784,-1.350869376,0.68018326,083-AGJ,-0.335343058,463,230,693
10785,-1.350869376,0.68018326,083-AGK,-0.335343058,526,226,752
10786,-1.350869376,0.68018326,083-AGL,-0.335343058,447,136,583
10787,-1.350869376,0.68018326,083-AGM,-0.335343058,410,122,532
10788,-1.350869376,0.68018326,083-AGN,-0.335343058,235,120,355
10789,-1.350869376,0.68018326,083-AGO,-0.335343058,466,248,714
10790,-1.350869376,0.68018326,083-AGP,-0.335343058,372,119,491
10791,-1.350869376,0.68018326,084-ABE,-0.335343058,340,202,542
10792,-1.350869376,0.68018326,084-ABG,-0.335343058,100,72,172
10793,-1.350869376,0.68018326,084-ACZ,-0.335343058,605,290,895
10794,-1.350869376,0.68018326,084-AAA,-0.335343058,399,230,629
10795,-1.350869376,0.68018326,084-AAC,-0.335343058,426,294,720
10796,-1.350869376,0.68018326,084-AAE,-0.335343058,531,342,873
10797,-1.350869376,0.68018326,084-AAG,-0.335343058,265,139,404
10798,-1.350869376,0.68018326,084-AAH,-0.335343058,305,178,483
10799,-1.350869376,0.68018326,084-ACU,-0.335343058,377,189,566
10800,-1.350869376,0.68018326,084-ABN,-0.335343058,376,234,610
10801,-1.350869376,0.68018326,084-ABP,-0.335343058,407,252,659
10802,-1.350869376,0.68018326,084-ABQ,-0.335343058,367,230,597
10803,-1.350869376,0.68018326,084-ABR,-0.335343058,310,188,498
10804,-1.350869376,0.68018326,084-ABS,-0.335343058,293,178,471
10805,-1.350869376,0.68018326,084-ABT,-0.335343058,166,197,363
10806,-1.350869376,0.68018326,084-ABV,-0.335343058,84,46,130
10807,-1.350869376,0.68018326,084-ABW,-0.335343058,277,146,423
10808,-1.350869376,0.68018326,084-ABX,-0.335343058,116,98,214
10809,-1.350869376,0.68018326,084-ABJ,-0.335343058,283,166,449
10810,-1.350869376,0.68018326,084-ABK,-0.335343058,332,186,518
10811,-1.350869376,0.68018326,084-ABF,-0.335343058,145,120,265
10812,-1.350869376,0.68018326,084-ABY,-0.335343058,110,61,171
10813,-1.350869376,0.68018326,084-AAI,-0.335343058,202,285,487
10814,-1.350869376,0.68018326,084-AAJ,-0.335343058,383,395,778
10815,-1.350869376,0.68018326,084-AAN,-0.335343058,354,476,830
10816,-1.350869376,0.68018326,084-AAO,-0.335343058,302,373,675
10817,-1.350869376,0.68018326,084-AAS,-0.335343058,366,274,640
10818,-1.350869376,0.68018326,084-AAT,-0.335343058,253,315,568
10819,-1.350869376,0.68018326,084-AAU,-0.335343058,180,239,419
10820,-1.350869376,0.68018326,084-AAY,-0.335343058,216,294,510
10821,-1.350869376,0.68018326,084-AAZ,-0.335343058,422,343,765
10822,-1.350869376,0.68018326,084-ABA,-0.335343058,128,171,299
10823,-1.350869376,0.68018326,084-ABZ,-0.335343058,255,208,463
10824,-1.350869376,0.68018326,084-ACA,-0.335343058,339,227,566
10825,-1.350869376,0.68018326,084-ACB,-0.335343058,324,182,506
10826,-1.350869376,0.68018326,084-ACC,-0.335343058,463,289,752
10827,-1.350869376,0.68018326,084-ACD,-0.335343058,15,17,32
10828,-1.350869376,0.68018326,084-ABU,-0.335343058,169,175,344
10829,-1.350869376,0.68018326,084-ACE,-0.335343058,440,294,734
10830,-1.350869376,0.68018326,084-ACF,-0.335343058,315,267,582
10831,-1.350869376,0.68018326,084-ACG,-0.335343058,353,249,602
10832,-1.350869376,0.68018326,084-ADC,-0.335343058,437,295,732
10833,-1.350869376,0.68018326,084-ACJ,-0.335343058,224,223,447
10834,-1.350869376,0.68018326,084-ACL,-0.335343058,298,185,483
10835,-1.350869376,0.68018326,084-ACM,-0.335343058,184,106,290
10836,-1.350869376,0.68018326,084-ABL,-0.335343058,243,162,405
10837,-1.350869376,0.68018326,084-ABM,-0.335343058,414,200,614
10838,-1.350869376,0.68018326,084-ACN,-0.335343058,318,186,504
10839,-1.350869376,0.68018326,084-ABI,-0.335343058,328,161,489
10840,-1.350869376,0.68018326,084-ACO,-0.335343058,371,242,613
10841,-1.350869376,0.68018326,084-ACP,-0.335343058,420,279,699
10842,-1.350869376,0.68018326,084-ADE,-0.335343058,409,252,661
10843,-1.350869376,0.68018326,084-ACR,-0.335343058,467,331,798
10844,-1.350869376,0.68018326,084-ACS,-0.335343058,193,112,305
10845,-1.350869376,0.68018326,084-ACW,-0.335343058,436,315,751
10846,-1.350869376,0.68018326,084-ACY,-0.335343058,184,208,392
10847,-1.350869376,0.68018326,085-ABP,-0.335343058,489,242,731
10848,-1.350869376,0.68018326,085-ABQ,-0.335343058,391,216,607
10849,-1.350869376,0.68018326,085-ABR,-0.335343058,94,125,219
10850,-1.350869376,0.68018326,085-ABS,-0.335343058,329,156,485
10851,-1.350869376,0.68018326,085-ABU,-0.335343058,195,145,340
10852,-1.350869376,0.68018326,085-ABV,-0.335343058,319,240,559
10853,-1.350869376,0.68018326,085-ABT,-0.335343058,351,196,547
10854,-1.350869376,0.68018326,085-ABW,-0.335343058,177,172,349
10855,-1.350869376,0.68018326,085-ABX,-0.335343058,384,198,582
10856,-1.350869376,0.68018326,085-ABY,-0.335343058,251,125,376
10857,-1.350869376,0.68018326,085-ABZ,-0.335343058,330,179,509
10858,-1.350869376,0.68018326,085-ACA,-0.335343058,384,258,642
10859,-1.350869376,0.68018326,085-ACB,-0.335343058,398,270,668
10860,-1.350869376,0.68018326,085-ACG,-0.335343058,170,159,329
10861,-1.350869376,0.68018326,085-ACC,-0.335343058,281,256,537
10862,-1.350869376,0.68018326,085-ACI,-0.335343058,399,255,654
10863,-1.350869376,0.68018326,085-ACD,-0.335343058,192,168,360
10864,-1.350869376,0.68018326,085-ACE,-0.335343058,253,287,540
10865,-1.350869376,0.68018326,085-ACF,-0.335343058,492,383,875
10866,-1.350869376,0.68018326,085-ACH,-0.335343058,272,241,513
10867,-1.350869376,0.68018326,085-ACL,-0.335343058,188,152,340
10868,-1.350869376,0.68018326,085-ACJ,-0.335343058,272,167,439
10869,-1.350869376,0.68018326,085-ACM,-0.335343058,180,134,314
10870,-1.350869376,0.68018326,085-ACK,-0.335343058,256,131,387
10871,-1.350869376,0.68018326,085-ACN,-0.335343058,264,253,517
10872,-1.350869376,0.68018326,085-ACO,-0.335343058,512,310,822
10873,-1.350869376,0.68018326,085-ACP,-0.335343058,399,198,597
10874,-1.350869376,0.68018326,085-ACQ,-0.335343058,463,222,685
10875,-1.350869376,0.68018326,085-ACR,-0.335343058,222,121,343
10876,-1.350869376,0.68018326,085-ACT,-0.335343058,335,190,525
10877,-1.350869376,0.68018326,085-ACS,-0.335343058,455,275,730
10878,-1.350869376,0.68018326,085-ACU,-0.335343058,588,262,850
10879,-1.350869376,0.68018326,085-ACV,-0.335343058,584,274,858
10880,-1.350869376,0.68018326,085-ACW,-0.335343058,310,190,500
10881,-1.350869376,0.68018326,085-ACX,-0.335343058,344,139,483
10882,-1.350869376,0.68018326,085-ACZ,-0.335343058,325,108,433
10883,-1.350869376,0.68018326,085-ADA,-0.335343058,163,95,258
10884,-1.350869376,0.68018326,085-ACY,-0.335343058,524,214,738
10885,-1.350869376,0.68018326,085-ADB,-0.335343058,359,127,486
10886,-1.350869376,0.68018326,085-ADC,-0.335343058,438,120,558
10887,-1.350869376,0.68018326,085-ADD,-0.335343058,260,197,457
10888,-1.350869376,0.68018326,085-AAI,-0.335343058,127,177,304
10889,-1.350869376,0.68018326,085-AAJ,-0.335343058,244,272,516
10890,-1.350869376,0.68018326,085-AAK,-0.335343058,164,158,322
10891,-1.350869376,0.68018326,085-AAL,-0.335343058,228,130,358
10892,-1.350869376,0.68018326,085-AAM,-0.335343058,357,241,598
10893,-1.350869376,0.68018326,085-AAN,-0.335343058,222,250,472
10894,-1.350869376,0.68018326,085-AAA,-0.335343058,127,200,327
10895,-1.350869376,0.68018326,085-AAB,-0.335343058,279,213,492
10896,-1.350869376,0.68018326,085-AAC,-0.335343058,329,350,679
10897,-1.350869376,0.68018326,085-AAE,-0.335343058,322,274,596
10898,-1.350869376,0.68018326,085-AAF,-0.335343058,270,196,466
10899,-1.350869376,0.68018326,085-AAG,-0.335343058,359,229,588
10900,-1.350869376,0.68018326,085-AAH,-0.335343058,266,257,523
10901,-1.350869376,0.68018326,085-ADE,-0.335343058,417,90,507
10902,-1.350869376,0.68018326,085-ADF,-0.335343058,508,283,791
10903,-1.350869376,0.68018326,085-ADG,-0.335343058,496,244,740
10904,-1.350869376,0.68018326,085-ADH,-0.335343058,387,158,545
10905,-1.350869376,0.68018326,085-ADI,-0.335343058,504,146,650
10906,-1.350869376,0.68018326,085-ADJ,-0.335343058,414,184,598
10907,-1.350869376,0.68018326,085-ADL,-0.335343058,170,100,270
10908,-1.350869376,0.68018326,085-ADM,-0.335343058,436,219,655
10909,-1.350869376,0.68018326,085-ADK,-0.335343058,552,186,738
10910,-1.350869376,0.68018326,085-ADN,-0.335343058,322,222,544
10911,-1.350869376,0.68018326,085-ADO,-0.335343058,311,150,461
10912,-1.350869376,0.68018326,085-ADP,-0.335343058,322,220,542
10913,-1.350869376,0.68018326,085-ADQ,-0.335343058,449,244,693
10914,-1.350869376,0.68018326,085-AAO,-0.335343058,144,259,403
10915,-1.350869376,0.68018326,085-AAP,-0.335343058,218,289,507
10916,-1.350869376,0.68018326,085-AAQ,-0.335343058,135,221,356
10917,-1.350869376,0.68018326,085-AAR,-0.335343058,119,194,313
10918,-1.350869376,0.68018326,085-AAS,-0.335343058,134,282,416
10919,-1.350869376,0.68018326,085-AAT,-0.335343058,171,137,308
10920,-1.350869376,0.68018326,085-AAU,-0.335343058,183,273,456
10921,-1.350869376,0.68018326,085-AAV,-0.335343058,144,666,810
10922,-1.350869376,0.68018326,085-AAW,-0.335343058,234,288,522
10923,-1.350869376,0.68018326,085-AAX,-0.335343058,218,447,665
10924,-1.350869376,0.68018326,085-AAY,-0.335343058,142,163,305
10925,-1.350869376,0.68018326,085-AAZ,-0.335343058,414,379,793
10926,-1.350869376,0.68018326,085-ABA,-0.335343058,361,328,689
10927,-1.350869376,0.68018326,085-ABB,-0.335343058,530,462,992
10928,-1.350869376,0.68018326,085-ABC,-0.335343058,280,287,567
10929,-1.350869376,0.68018326,085-ABD,-0.335343058,224,213,437
10930,-1.350869376,0.68018326,085-ABE,-0.335343058,186,178,364
10931,-1.350869376,0.68018326,085-ABH,-0.335343058,239,208,447
10932,-1.350869376,0.68018326,085-ABI,-0.335343058,190,332,522
10933,-1.350869376,0.68018326,085-ABJ,-0.335343058,259,241,500
10934,-1.350869376,0.68018326,085-ABK,-0.335343058,158,186,344
10935,-1.350869376,0.68018326,085-ABL,-0.335343058,145,211,356
10936,-1.350869376,0.68018326,085-ABM,-0.335343058,452,508,960
10937,-1.350869376,0.68018326,085-ABN,-0.335343058,400,350,750
10938,-1.350869376,0.68018326,085-ADR,-0.335343058,244,177,421
10939,-1.350869376,0.68018326,085-ADS,-0.335343058,134,128,262
10940,-1.350869376,0.68018326,085-ADT,-0.335343058,597,398,995
10941,-1.350869376,0.68018326,085-ADU,-0.335343058,235,166,401
10942,-1.350869376,0.68018326,085-ADV,-0.335343058,278,198,476
10943,-1.350869376,0.68018326,086-AAK,-0.335343058,295,155,450
10944,-1.350869376,0.68018326,086-AAN,-0.335343058,152,90,242
10945,-1.350869376,0.68018326,086-AAO,-0.335343058,241,236,477
10946,-1.350869376,0.68018326,086-AAJ,-0.335343058,207,258,465
10947,-1.350869376,0.68018326,086-AAF,-0.335343058,234,156,390
10948,-1.350869376,0.68018326,086-AAB,-0.335343058,196,224,420
10949,-1.350869376,0.68018326,086-AAA,-0.335343058,136,181,317
10950,-1.350869376,0.68018326,086-AAH,-0.335343058,249,159,408
10951,-1.350869376,0.68018326,086-AAG,-0.335343058,300,245,545
10952,-1.350869376,0.68018326,086-AAI,-0.335343058,313,362,675
10953,-1.350869376,0.68018326,086-AAD,-0.335343058,109,116,225
10954,-1.350869376,0.68018326,086-AA3,-0.335343058,143,146,289
10955,-1.350869376,0.68018326,086-AAC,-0.335343058,121,117,238
10956,-1.350869376,0.68018326,086-AAP,-0.335343058,292,192,484
10957,-1.350869376,0.68018326,086-AAQ,-0.335343058,266,199,465
10958,-1.350869376,0.68018326,086-AAR,-0.335343058,222,173,395
10959,-1.350869376,0.68018326,086-AAS,-0.335343058,164,142,306
10960,-1.350869376,0.68018326,086-ABG,-0.335343058,231,220,451
10961,-1.350869376,0.68018326,086-ABH,-0.335343058,261,194,455
10962,-1.350869376,0.68018326,086-AAT,-0.335343058,221,212,433
10963,-1.350869376,0.68018326,086-AAU,-0.335343058,349,265,614
10964,-1.350869376,0.68018326,086-AAV,-0.335343058,323,186,509
10965,-1.350869376,0.68018326,086-AAW,-0.335343058,327,216,543
10966,-1.350869376,0.68018326,086-AAX,-0.335343058,301,184,485
10967,-1.350869376,0.68018326,086-ABA,-0.335343058,233,152,385
10968,-1.350869376,0.68018326,086-ABR,-0.335343058,254,286,540
10969,-1.350869376,0.68018326,086-ABQ,-0.335343058,155,132,287
10970,-1.350869376,0.68018326,086-ABN,-0.335343058,104,155,259
10971,-1.350869376,0.68018326,086-ABP,-0.335343058,159,215,374
10972,-1.350869376,0.68018326,086-ABO,-0.335343058,84,128,212
10973,-1.350869376,0.68018326,086-ABB,-0.335343058,288,286,574
10974,-1.350869376,0.68018326,086-AAY,-0.335343058,128,101,229
10975,-1.350869376,0.68018326,086-AAZ,-0.335343058,263,173,436
10976,-1.350869376,0.68018326,086-ABC,-0.335343058,206,177,383
10977,-1.350869376,0.68018326,086-ABD,-0.335343058,236,192,428
10978,-1.350869376,0.68018326,086-ABE,-0.335343058,247,167,414
10979,-1.350869376,0.68018326,086-ABF,-0.335343058,269,176,445
10980,-1.350869376,0.68018326,086-ABI,-0.335343058,439,214,653
10981,-1.350869376,0.68018326,086-ABJ,-0.335343058,126,151,277
10982,-1.350869376,0.68018326,086-ABK,-0.335343058,186,161,347
10983,-1.350869376,0.68018326,086-ABL,-0.335343058,165,115,280
10984,-1.350869376,0.68018326,086-ABM,-0.335343058,271,232,503
10985,-1.350869376,0.68018326,086-AAL,-0.335343058,228,193,421
10986,-1.350869376,0.68018326,086-AAM,-0.335343058,186,140,326
10987,-1.350869376,0.68018326,087-ABN,-0.335343058,314,220,534
10988,-1.350869376,0.68018326,087-ABO,-0.335343058,160,146,306
10989,-1.350869376,0.68018326,087-ABP,-0.335343058,124,132,256
10990,-1.350869376,0.68018326,087-AAA,-0.335343058,152,323,475
10991,-1.350869376,0.68018326,087-AAB,-0.335343058,170,414,584
10992,-1.350869376,0.68018326,087-AAC,-0.335343058,266,870,1136
10993,-1.350869376,0.68018326,087-AAF,-0.335343058,150,441,591
10994,-1.350869376,0.68018326,087-AEB,-0.335343058,157,455,612
10995,-1.350869376,0.68018326,087-AAG,-0.335343058,200,444,644
10996,-1.350869376,0.68018326,087-AAH,-0.335343058,181,484,665
10997,-1.350869376,0.68018326,087-AAI,-0.335343058,188,470,658
10998,-1.350869376,0.68018326,087-AEC,-0.335343058,89,219,308
10999,-1.350869376,0.68018326,087-AED,-0.335343058,173,487,660
11000,-1.350869376,0.68018326,087-AAK,-0.335343058,301,451,752
11001,-1.350869376,0.68018326,087-AAL,-0.335343058,571,552,1123
11002,-1.350869376,0.68018326,087-AAM,-0.335343058,255,516,771
11003,-1.350869376,0.68018326,087-AAN,-0.335343058,456,488,944
11004,-1.350869376,0.68018326,087-AAO,-0.335343058,208,456,664
11005,-1.350869376,0.68018326,087-AAP,-0.335343058,308,410,718
11006,-1.350869376,0.68018326,087-AAQ,-0.335343058,324,301,625
11007,-1.350869376,0.68018326,087-AAR,-0.335343058,378,496,874
11008,-1.350869376,0.68018326,087-AAS,-0.335343058,331,355,686
11009,-1.350869376,0.68018326,087-ABR,-0.335343058,436,292,728
11010,-1.350869376,0.68018326,087-AAT,-0.335343058,151,262,413
11011,-1.350869376,0.68018326,087-ABS,-0.335343058,497,307,804
11012,-1.350869376,0.68018326,087-ABT,-0.335343058,354,399,753
11013,-1.350869376,0.68018326,087-ABU,-0.335343058,229,266,495
11014,-1.350869376,0.68018326,087-ABV,-0.335343058,189,188,377
11015,-1.350869376,0.68018326,087-ABW,-0.335343058,196,160,356
11016,-1.350869376,0.68018326,087-ABX,-0.335343058,298,308,606
11017,-1.350869376,0.68018326,087-ABY,-0.335343058,370,395,765
11018,-1.350869376,0.68018326,087-ABZ,-0.335343058,208,157,365
11019,-1.350869376,0.68018326,087-ABQ,-0.335343058,98,87,185
11020,-1.350869376,0.68018326,087-ACA,-0.335343058,351,422,773
11021,-1.350869376,0.68018326,087-ACB,-0.335343058,465,576,1041
11022,-1.350869376,0.68018326,087-ACC,-0.335343058,243,395,638
11023,-1.350869376,0.68018326,087-ACE,-0.335343058,255,330,585
11024,-1.350869376,0.68018326,087-ACG,-0.335343058,345,588,933
11025,-1.350869376,0.68018326,087-ACJ,-0.335343058,297,497,794
11026,-1.350869376,0.68018326,087-ACK,-0.335343058,286,493,779
11027,-1.350869376,0.68018326,087-ACL,-0.335343058,388,391,779
11028,-1.350869376,0.68018326,087-ACN,-0.335343058,212,190,402
11029,-1.350869376,0.68018326,087-ACO,-0.335343058,325,288,613
11030,-1.350869376,0.68018326,087-ACP,-0.335343058,593,416,1009
11031,-1.350869376,0.68018326,087-ACQ,-0.335343058,266,192,458
11032,-1.350869376,0.68018326,087-ACR,-0.335343058,115,138,253
11033,-1.350869376,0.68018326,087-ACS,-0.335343058,119,140,259
11034,-1.350869376,0.68018326,087-ACU,-0.335343058,442,482,924
11035,-1.350869376,0.68018326,087-ACT,-0.335343058,165,271,436
11036,-1.350869376,0.68018326,087-ACW,-0.335343058,95,162,257
11037,-1.350869376,0.68018326,087-ACX,-0.335343058,174,215,389
11038,-1.350869376,0.68018326,087-ADW,-0.335343058,352,486,838
11039,-1.350869376,0.68018326,087-ADX,-0.335343058,367,558,925
11040,-1.350869376,0.68018326,087-ADZ,-0.335343058,284,569,853
11041,-1.350869376,0.68018326,087-ACY,-0.335343058,220,182,402
11042,-1.350869376,0.68018326,087-ACZ,-0.335343058,271,253,524
11043,-1.350869376,0.68018326,087-AAU,-0.335343058,337,284,621
11044,-1.350869376,0.68018326,087-AAV,-0.335343058,237,290,527
11045,-1.350869376,0.68018326,087-AAW,-0.335343058,318,314,632
11046,-1.350869376,0.68018326,087-AAX,-0.335343058,377,398,775
11047,-1.350869376,0.68018326,087-AAY,-0.335343058,425,426,851
11048,-1.350869376,0.68018326,087-AAZ,-0.335343058,557,617,1174
11049,-1.350869376,0.68018326,087-ABA,-0.335343058,500,311,811
11050,-1.350869376,0.68018326,087-ABB,-0.335343058,328,358,686
11051,-1.350869376,0.68018326,087-ABC,-0.335343058,370,304,674
11052,-1.350869376,0.68018326,087-ABD,-0.335343058,381,326,707
11053,-1.350869376,0.68018326,087-ABE,-0.335343058,310,259,569
11054,-1.350869376,0.68018326,087-ADA,-0.335343058,391,311,702
11055,-1.350869376,0.68018326,087-ADB,-0.335343058,118,278,396
11056,-1.350869376,0.68018326,087-ADC,-0.335343058,422,307,729
11057,-1.350869376,0.68018326,087-ADD,-0.335343058,174,220,394
11058,-1.350869376,0.68018326,087-ADE,-0.335343058,513,579,1092
11059,-1.350869376,0.68018326,087-ADF,-0.335343058,313,209,522
11060,-1.350869376,0.68018326,087-ADG,-0.335343058,738,642,1380
11061,-1.350869376,0.68018326,087-ADI,-0.335343058,406,407,813
11062,-1.350869376,0.68018326,087-ADJ,-0.335343058,166,307,473
11063,-1.350869376,0.68018326,087-ABF,-0.335343058,364,291,655
11064,-1.350869376,0.68018326,087-ABG,-0.335343058,461,253,714
11065,-1.350869376,0.68018326,087-ABH,-0.335343058,572,314,886
11066,-1.350869376,0.68018326,087-AEE,-0.335343058,368,261,629
11067,-1.350869376,0.68018326,087-AEF,-0.335343058,468,213,681
11068,-1.350869376,0.68018326,087-ADL,-0.335343058,528,456,984
11069,-1.350869376,0.68018326,087-ADM,-0.335343058,354,254,608
11070,-1.350869376,0.68018326,087-ADN,-0.335343058,87,123,210
11071,-1.350869376,0.68018326,087-ABI,-0.335343058,257,522,779
11072,-1.350869376,0.68018326,087-ABJ,-0.335343058,348,400,748
11073,-1.350869376,0.68018326,087-ABK,-0.335343058,229,439,668
11074,-1.350869376,0.68018326,087-ABL,-0.335343058,258,447,705
11075,-1.350869376,0.68018326,087-ABM,-0.335343058,314,385,699
11076,-1.350869376,0.68018326,087-ADO,-0.335343058,267,252,519
11077,-1.350869376,0.68018326,087-ADP,-0.335343058,315,393,708
11078,-1.350869376,0.68018326,087-ADQ,-0.335343058,445,432,877
11079,-1.350869376,0.68018326,087-ADS,-0.335343058,510,429,939
11080,-1.350869376,0.68018326,087-ADR,-0.335343058,89,102,191
11081,-1.350869376,0.68018326,087-ADT,-0.335343058,459,343,802
11082,-1.350869376,0.68018326,087-ADV,-0.335343058,214,203,417
11083,-1.350869376,0.68018326,087-ADU,-0.335343058,248,441,689
11084,-1.350869376,0.68018326,088-AAM,-0.335343058,268,121,389
11085,-1.350869376,0.68018326,088-AAQ,-0.335343058,211,221,432
11086,-1.350869376,0.68018326,088-AAT,-0.335343058,258,239,497
11087,-1.350869376,0.68018326,088-AAS,-0.335343058,254,312,566
11088,-1.350869376,0.68018326,088-AAO,-0.335343058,354,177,531
11089,-1.350869376,0.68018326,088-AAV,-0.335343058,327,229,556
11090,-1.350869376,0.68018326,088-AAX,-0.335343058,284,132,416
11091,-1.350869376,0.68018326,088-AAY,-0.335343058,191,92,283
11092,-1.350869376,0.68018326,088-ABA,-0.335343058,129,75,204
11093,-1.350869376,0.68018326,088-ABC,-0.335343058,241,137,378
11094,-1.350869376,0.68018326,088-AAK,-0.335343058,187,132,319
11095,-1.350869376,0.68018326,088-ABE,-0.335343058,373,194,567
11096,-1.350869376,0.68018326,088-ABF,-0.335343058,319,120,439
11097,-1.350869376,0.68018326,088-ABH,-0.335343058,175,99,274
11098,-1.350869376,0.68018326,088-ABI,-0.335343058,291,204,495
11099,-1.350869376,0.68018326,088-ABL,-0.335343058,208,142,350
11100,-1.350869376,0.68018326,088-ABJ,-0.335343058,216,232,448
11101,-1.350869376,0.68018326,088-ABM,-0.335343058,329,255,584
11102,-1.350869376,0.68018326,088-AAA,-0.335343058,301,230,531
11103,-1.350869376,0.68018326,088-AAB,-0.335343058,233,174,407
11104,-1.350869376,0.68018326,088-AAD,-0.335343058,235,233,468
11105,-1.350869376,0.68018326,088-AAF,-0.335343058,336,275,611
11106,-1.350869376,0.68018326,088-AAG,-0.335343058,271,217,488
11107,-1.350869376,0.68018326,088-AAJ,-0.335343058,279,219,498
